"Datum";"Region";"PCR_Pos";"Ag_Neg";"Ag_Pos";"Total";"Pocet.potvrdenych";"Potvrdenych";"newcases";"date";"positive"
2021-04-29;"Banskobystrický kraj";55;13234;54;13288;37130;81280;109;2021-04-29;81280
2021-04-28;"Banskobystrický kraj";66;17529;67;17596;NA;81280;133;2021-04-28;81171
2021-04-27;"Banskobystrický kraj";70;18992;73;19065;NA;81280;143;2021-04-27;81038
2021-04-26;"Banskobystrický kraj";34;28464;101;28565;NA;81280;135;2021-04-26;80895
2021-04-25;"Banskobystrický kraj";14;39844;106;39950;NA;81280;120;2021-04-25;80760
2021-04-24;"Banskobystrický kraj";40;51623;98;51721;NA;81280;138;2021-04-24;80640
2021-04-23;"Banskobystrický kraj";78;38231;88;38319;NA;81280;166;2021-04-23;80502
2021-04-22;"Banskobystrický kraj";51;17287;57;17344;NA;81280;108;2021-04-22;80336
2021-04-21;"Banskobystrický kraj";76;19188;94;19282;NA;81280;170;2021-04-21;80228
2021-04-20;"Banskobystrický kraj";116;20973;98;21071;NA;81280;214;2021-04-20;80058
2021-04-19;"Banskobystrický kraj";48;31418;105;31523;NA;81280;153;2021-04-19;79844
2021-04-18;"Banskobystrický kraj";16;42910;90;43000;NA;81280;106;2021-04-18;79691
2021-04-17;"Banskobystrický kraj";42;64939;92;65031;NA;81280;134;2021-04-17;79585
2021-04-16;"Banskobystrický kraj";72;37286;100;37386;NA;81280;172;2021-04-16;79451
2021-04-15;"Banskobystrický kraj";67;20117;83;20200;NA;81280;150;2021-04-15;79279
2021-04-14;"Banskobystrický kraj";69;21257;86;21343;NA;81280;155;2021-04-14;79129
2021-04-13;"Banskobystrický kraj";130;22615;76;22691;NA;81280;206;2021-04-13;78974
2021-04-12;"Banskobystrický kraj";60;32245;130;32375;NA;81280;190;2021-04-12;78768
2021-04-11;"Banskobystrický kraj";0;41367;88;41455;NA;81280;88;2021-04-11;78578
2021-04-10;"Banskobystrický kraj";56;65145;143;65288;NA;81280;199;2021-04-10;78490
2021-04-09;"Banskobystrický kraj";106;31462;118;31580;NA;81280;224;2021-04-09;78291
2021-04-08;"Banskobystrický kraj";132;18409;107;18516;NA;81280;239;2021-04-08;78067
2021-04-07;"Banskobystrický kraj";226;25211;95;25306;NA;81280;321;2021-04-07;77828
2021-04-06;"Banskobystrický kraj";93;42484;187;42671;NA;81280;280;2021-04-06;77507
2021-04-05;"Banskobystrický kraj";15;11837;87;11924;NA;81280;102;2021-04-05;77227
2021-04-04;"Banskobystrický kraj";24;19683;79;19762;NA;81280;103;2021-04-04;77125
2021-04-03;"Banskobystrický kraj";5;72391;211;72602;NA;81280;216;2021-04-03;77022
2021-04-02;"Banskobystrický kraj";71;13455;66;13521;NA;81280;137;2021-04-02;76806
2021-04-01;"Banskobystrický kraj";171;38833;200;39033;NA;81280;371;2021-04-01;76669
2021-03-31;"Banskobystrický kraj";147;25543;161;25704;NA;81280;308;2021-03-31;76298
2021-03-30;"Banskobystrický kraj";167;21439;159;21598;NA;81280;326;2021-03-30;75990
2021-03-29;"Banskobystrický kraj";119;29551;218;29769;NA;81280;337;2021-03-29;75664
2021-03-28;"Banskobystrický kraj";25;40610;189;40799;NA;81280;214;2021-03-28;75327
2021-03-27;"Banskobystrický kraj";85;64121;260;64381;NA;81280;345;2021-03-27;75113
2021-03-26;"Banskobystrický kraj";122;43397;240;43637;NA;81280;362;2021-03-26;74768
2021-03-25;"Banskobystrický kraj";120;21589;240;21829;NA;81280;360;2021-03-25;74406
2021-03-24;"Banskobystrický kraj";200;19319;227;19546;NA;81280;427;2021-03-24;74046
2021-03-23;"Banskobystrický kraj";241;21398;257;21655;NA;81280;498;2021-03-23;73619
2021-03-22;"Banskobystrický kraj";65;30418;274;30692;NA;81280;339;2021-03-22;73121
2021-03-21;"Banskobystrický kraj";31;40039;280;40319;NA;81280;311;2021-03-21;72782
2021-03-20;"Banskobystrický kraj";119;67730;383;68113;NA;81280;502;2021-03-20;72471
2021-03-19;"Banskobystrický kraj";240;44041;307;44348;NA;81280;547;2021-03-19;71969
2021-03-18;"Banskobystrický kraj";160;21727;273;22000;NA;81280;433;2021-03-18;71422
2021-03-17;"Banskobystrický kraj";262;21573;245;21818;NA;81280;507;2021-03-17;70989
2021-03-16;"Banskobystrický kraj";340;23595;224;23819;NA;81280;564;2021-03-16;70482
2021-03-15;"Banskobystrický kraj";95;31133;364;31497;NA;81280;459;2021-03-15;69918
2021-03-14;"Banskobystrický kraj";39;40650;229;40879;NA;81280;268;2021-03-14;69459
2021-03-13;"Banskobystrický kraj";209;67167;391;67558;NA;81280;600;2021-03-13;69191
2021-03-12;"Banskobystrický kraj";206;41485;330;41815;NA;81280;536;2021-03-12;68591
2021-03-11;"Banskobystrický kraj";228;21337;272;21609;NA;81280;500;2021-03-11;68055
2021-03-10;"Banskobystrický kraj";260;20381;238;20619;NA;81280;498;2021-03-10;67555
2021-03-09;"Banskobystrický kraj";352;21790;284;22074;NA;81280;636;2021-03-09;67057
2021-03-08;"Banskobystrický kraj";191;31488;427;31915;NA;81280;618;2021-03-08;66421
2021-03-07;"Banskobystrický kraj";60;39083;295;39378;NA;81280;355;2021-03-07;65803
2021-03-06;"Banskobystrický kraj";164;70562;410;70972;NA;81280;574;2021-03-06;65448
2021-03-05;"Banskobystrický kraj";221;42137;388;42525;NA;81280;609;2021-03-05;64874
2021-03-04;"Banskobystrický kraj";226;21607;334;21941;NA;81280;560;2021-03-04;64265
2021-03-03;"Banskobystrický kraj";317;21949;331;22280;NA;81280;648;2021-03-03;63705
2021-03-02;"Banskobystrický kraj";291;22602;354;22956;NA;81280;645;2021-03-02;63057
2021-03-01;"Banskobystrický kraj";151;31773;434;32207;NA;81280;585;2021-03-01;62412
2021-02-28;"Banskobystrický kraj";45;38313;336;38649;NA;81280;381;2021-02-28;61827
2021-02-27;"Banskobystrický kraj";289;66713;529;67242;NA;81280;818;2021-02-27;61446
2021-02-26;"Banskobystrický kraj";326;39553;468;40021;NA;81280;794;2021-02-26;60628
2021-02-25;"Banskobystrický kraj";375;17767;368;18135;NA;81280;743;2021-02-25;59834
2021-02-24;"Banskobystrický kraj";332;16760;374;17134;NA;81280;706;2021-02-24;59091
2021-02-23;"Banskobystrický kraj";462;19528;439;19967;NA;81280;901;2021-02-23;58385
2021-02-22;"Banskobystrický kraj";67;28684;601;29285;NA;81280;668;2021-02-22;57484
2021-02-21;"Banskobystrický kraj";68;37464;437;37901;NA;81280;505;2021-02-21;56816
2021-02-20;"Banskobystrický kraj";280;68890;599;69489;NA;81280;879;2021-02-20;56311
2021-02-19;"Banskobystrický kraj";420;39674;513;40187;NA;81280;933;2021-02-19;55432
2021-02-18;"Banskobystrický kraj";241;18661;398;19059;NA;81280;639;2021-02-18;54499
2021-02-17;"Banskobystrický kraj";415;16338;389;16727;NA;81280;804;2021-02-17;53860
2021-02-16;"Banskobystrický kraj";338;19955;369;20324;NA;81280;707;2021-02-16;53056
2021-02-15;"Banskobystrický kraj";118;35843;591;36434;NA;81280;709;2021-02-15;52349
2021-02-14;"Banskobystrický kraj";60;31894;386;32280;NA;81280;446;2021-02-14;51640
2021-02-13;"Banskobystrický kraj";202;53889;492;54381;NA;81280;694;2021-02-13;51194
2021-02-12;"Banskobystrický kraj";312;36620;533;37153;NA;81280;845;2021-02-12;50500
2021-02-11;"Banskobystrický kraj";305;20743;384;21127;NA;81280;689;2021-02-11;49655
2021-02-10;"Banskobystrický kraj";333;14790;344;15134;NA;81280;677;2021-02-10;48966
2021-02-09;"Banskobystrický kraj";329;18560;362;18922;NA;81280;691;2021-02-09;48289
2021-02-08;"Banskobystrický kraj";103;46675;671;47346;NA;81280;774;2021-02-08;47598
2021-02-07;"Banskobystrický kraj";70;37239;333;37572;NA;81280;403;2021-02-07;46824
2021-02-06;"Banskobystrický kraj";178;69655;570;70225;NA;81280;748;2021-02-06;46421
2021-02-05;"Banskobystrický kraj";282;24252;360;24612;NA;81280;642;2021-02-05;45673
2021-02-04;"Banskobystrický kraj";240;13384;429;13813;NA;81280;669;2021-02-04;45031
2021-02-03;"Banskobystrický kraj";350;9299;253;9552;NA;81280;603;2021-02-03;44362
2021-02-02;"Banskobystrický kraj";277;15572;332;15904;NA;81280;609;2021-02-02;43759
2021-02-01;"Banskobystrický kraj";75;24723;496;25219;NA;81280;571;2021-02-01;43150
2021-01-31;"Banskobystrický kraj";34;19983;201;20184;NA;81280;235;2021-01-31;42579
2021-01-30;"Banskobystrický kraj";163;64086;525;64611;NA;81280;688;2021-01-30;42344
2021-01-29;"Banskobystrický kraj";196;17174;267;17441;NA;81280;463;2021-01-29;41656
2021-01-28;"Banskobystrický kraj";218;14033;368;14401;NA;81280;586;2021-01-28;41193
2021-01-27;"Banskobystrický kraj";191;8010;200;8210;NA;81280;391;2021-01-27;40607
2021-01-26;"Banskobystrický kraj";238;19616;283;19899;NA;81280;521;2021-01-26;40216
2021-01-25;"Banskobystrický kraj";82;33456;412;33868;NA;81280;494;2021-01-25;39695
2021-01-24;"Banskobystrický kraj";38;35586;277;35863;NA;81280;315;2021-01-24;39201
2021-01-23;"Banskobystrický kraj";142;88520;525;89045;NA;81280;667;2021-01-23;38886
2021-01-22;"Banskobystrický kraj";175;26917;359;27276;NA;81280;534;2021-01-22;38219
2021-01-21;"Banskobystrický kraj";194;16851;285;17136;NA;81280;479;2021-01-21;37685
2021-01-20;"Banskobystrický kraj";231;9148;188;9336;NA;81280;419;2021-01-20;37206
2021-01-19;"Banskobystrický kraj";213;10493;308;10801;NA;81280;521;2021-01-19;36787
2021-01-18;"Banskobystrický kraj";94;5870;349;6219;NA;81280;443;2021-01-18;36266
2021-01-17;"Banskobystrický kraj";110;8154;77;8231;NA;81280;187;2021-01-17;35823
2021-01-16;"Banskobystrický kraj";58;2274;57;2331;NA;81280;115;2021-01-16;35636
2021-01-15;"Banskobystrický kraj";164;7673;217;7890;NA;81280;381;2021-01-15;35521
2021-01-14;"Banskobystrický kraj";220;5760;325;6085;NA;81280;545;2021-01-14;35140
2021-01-13;"Banskobystrický kraj";235;5974;217;6191;NA;81280;452;2021-01-13;34595
2021-01-12;"Banskobystrický kraj";194;6808;299;7107;NA;81280;493;2021-01-12;34143
2021-01-11;"Banskobystrický kraj";76;8231;481;8712;NA;81280;557;2021-01-11;33650
2021-01-10;"Banskobystrický kraj";110;233;4;237;NA;81280;114;2021-01-10;33093
2021-01-09;"Banskobystrický kraj";297;2378;81;2459;NA;81280;378;2021-01-09;32979
2021-01-08;"Banskobystrický kraj";435;9677;443;10120;NA;81280;878;2021-01-08;32601
2021-01-07;"Banskobystrický kraj";127;6322;366;6688;NA;81280;493;2021-01-07;31723
2021-01-06;"Banskobystrický kraj";305;3124;185;3309;NA;81280;490;2021-01-06;31230
2021-01-05;"Banskobystrický kraj";372;7349;533;7882;NA;81280;905;2021-01-05;30740
2021-01-04;"Banskobystrický kraj";130;7083;700;7783;NA;81280;830;2021-01-04;29835
2021-01-03;"Banskobystrický kraj";199;320;19;339;NA;81280;218;2021-01-03;29005
2021-01-02;"Banskobystrický kraj";123;702;85;787;NA;81280;208;2021-01-02;28787
2021-01-01;"Banskobystrický kraj";220;1958;132;2090;NA;81280;352;2021-01-01;28579
2020-12-31;"Banskobystrický kraj";499;7379;633;8012;NA;81280;1132;2020-12-31;28227
2020-12-30;"Banskobystrický kraj";593;7670;557;8227;NA;81280;1150;2020-12-30;27095
2020-12-29;"Banskobystrický kraj";240;7955;664;8619;NA;81280;904;2020-12-29;25945
2020-12-28;"Banskobystrický kraj";131;6098;711;6809;NA;81280;842;2020-12-28;25041
2020-12-27;"Banskobystrický kraj";116;541;25;566;NA;81280;141;2020-12-27;24199
2020-12-26;"Banskobystrický kraj";61;295;35;330;NA;81280;96;2020-12-26;24058
2020-12-25;"Banskobystrický kraj";65;313;10;323;NA;81280;75;2020-12-25;23962
2020-12-24;"Banskobystrický kraj";452;3685;135;3820;NA;81280;587;2020-12-24;23887
2020-12-23;"Banskobystrický kraj";368;10116;507;10623;NA;81280;875;2020-12-23;23300
2020-12-22;"Banskobystrický kraj";307;8449;624;9073;NA;81280;931;2020-12-22;22425
2020-12-21;"Banskobystrický kraj";286;4896;448;5344;NA;81280;734;2020-12-21;21494
2020-12-20;"Banskobystrický kraj";155;249;14;263;NA;81280;169;2020-12-20;20760
2020-12-19;"Banskobystrický kraj";170;3059;138;3197;NA;81280;308;2020-12-19;20591
2020-12-18;"Banskobystrický kraj";432;5965;324;6289;NA;81280;756;2020-12-18;20283
2020-12-17;"Banskobystrický kraj";468;8716;656;9372;NA;81280;1124;2020-12-17;19527
2020-12-16;"Banskobystrický kraj";379;10202;560;10762;NA;81280;939;2020-12-16;18403
2020-12-15;"Banskobystrický kraj";336;5425;433;5858;NA;81280;769;2020-12-15;17464
2020-12-14;"Banskobystrický kraj";148;3897;259;4156;NA;81280;407;2020-12-14;16695
2020-12-13;"Banskobystrický kraj";122;142;1;143;NA;81280;123;2020-12-13;16288
2020-12-12;"Banskobystrický kraj";137;2714;138;2852;NA;81280;275;2020-12-12;16165
2020-12-11;"Banskobystrický kraj";468;6587;374;6961;NA;81280;842;2020-12-11;15890
2020-12-10;"Banskobystrický kraj";280;5204;355;5559;NA;81280;635;2020-12-10;15048
2020-12-09;"Banskobystrický kraj";323;3850;213;4063;NA;81280;536;2020-12-09;14413
2020-12-08;"Banskobystrický kraj";256;3787;276;4063;NA;81280;532;2020-12-08;13877
2020-12-07;"Banskobystrický kraj";175;2380;156;2536;NA;81280;331;2020-12-07;13345
2020-12-06;"Banskobystrický kraj";121;507;11;518;NA;81280;132;2020-12-06;13014
2020-12-05;"Banskobystrický kraj";109;1099;34;1133;NA;81280;143;2020-12-05;12882
2020-12-04;"Banskobystrický kraj";339;3828;174;4002;NA;81280;513;2020-12-04;12739
2020-12-03;"Banskobystrický kraj";240;3193;234;3427;NA;81280;474;2020-12-03;12226
2020-12-02;"Banskobystrický kraj";217;4442;186;4628;NA;81280;403;2020-12-02;11752
2020-12-01;"Banskobystrický kraj";215;2702;134;2836;NA;81280;349;2020-12-01;11349
2020-11-30;"Banskobystrický kraj";74;4484;257;4741;NA;81280;331;2020-11-30;11000
2020-11-29;"Banskobystrický kraj";19;208;7;215;NA;81280;26;2020-11-29;10669
2020-11-28;"Banskobystrický kraj";81;1408;55;1463;NA;81280;136;2020-11-28;10643
2020-11-27;"Banskobystrický kraj";219;2266;123;2389;NA;81280;342;2020-11-27;10507
2020-11-26;"Banskobystrický kraj";208;2124;93;2217;NA;81280;301;2020-11-26;10165
2020-11-25;"Banskobystrický kraj";170;1952;86;2038;NA;81280;256;2020-11-25;9864
2020-11-24;"Banskobystrický kraj";166;2566;69;2635;NA;81280;235;2020-11-24;9608
2020-11-23;"Banskobystrický kraj";66;10240;194;10434;NA;81280;260;2020-11-23;9373
2020-11-22;"Banskobystrický kraj";38;104;1;105;NA;81280;39;2020-11-22;9113
2020-11-21;"Banskobystrický kraj";52;904;14;918;NA;81280;66;2020-11-21;9074
2020-11-20;"Banskobystrický kraj";127;2005;107;2112;NA;81280;234;2020-11-20;9008
2020-11-19;"Banskobystrický kraj";170;1218;82;1300;NA;81280;252;2020-11-19;8774
2020-11-18;"Banskobystrický kraj";153;698;65;763;NA;81280;218;2020-11-18;8522
2020-11-17;"Banskobystrický kraj";52;578;35;613;NA;81280;87;2020-11-17;8304
2020-11-16;"Banskobystrický kraj";106;470;25;495;NA;81280;131;2020-11-16;8217
2020-11-15;"Banskobystrický kraj";52;301;4;305;NA;81280;56;2020-11-15;8086
2020-11-14;"Banskobystrický kraj";73;305;2;307;NA;81280;75;2020-11-14;8030
2020-11-13;"Banskobystrický kraj";157;552;11;563;NA;81280;168;2020-11-13;7955
2020-11-12;"Banskobystrický kraj";218;952;44;996;NA;81280;262;2020-11-12;7787
2020-11-11;"Banskobystrický kraj";224;437;9;446;NA;81280;233;2020-11-11;7525
2020-11-10;"Banskobystrický kraj";263;463;18;481;NA;81280;281;2020-11-10;7292
2020-11-09;"Banskobystrický kraj";80;2678;31;2709;NA;81280;111;2020-11-09;7011
2020-11-08;"Banskobystrický kraj";82;981;16;997;NA;81280;98;2020-11-08;6900
2020-11-07;"Banskobystrický kraj";164;8828;94;8922;NA;81280;258;2020-11-07;6802
2020-11-06;"Banskobystrický kraj";227;2496;16;2512;NA;81280;243;2020-11-06;6544
2020-11-05;"Banskobystrický kraj";240;290;33;323;NA;81280;273;2020-11-05;6301
2020-11-04;"Banskobystrický kraj";254;1366;13;1379;NA;81280;267;2020-11-04;6028
2020-11-03;"Banskobystrický kraj";246;1332;4;1336;NA;81280;250;2020-11-03;5761
2020-11-02;"Banskobystrický kraj";90;2909;65;2974;NA;81280;155;2020-11-02;5511
2020-11-01;"Banskobystrický kraj";101;2671;42;2713;NA;81280;143;2020-11-01;5356
2020-10-31;"Banskobystrický kraj";199;13516;116;13632;NA;81280;315;2020-10-31;5213
2020-10-30;"Banskobystrický kraj";254;2829;20;2849;NA;81280;274;2020-10-30;4898
2020-10-29;"Banskobystrický kraj";372;969;42;1011;NA;81280;414;2020-10-29;4624
2020-10-28;"Banskobystrický kraj";285;302;30;332;NA;81280;315;2020-10-28;4210
2020-10-27;"Banskobystrický kraj";266;654;40;694;NA;81280;306;2020-10-27;3895
2020-10-26;"Banskobystrický kraj";38;234;29;263;NA;81280;67;2020-10-26;3589
2020-10-25;"Banskobystrický kraj";50;140;11;151;NA;81280;61;2020-10-25;3522
2020-10-24;"Banskobystrický kraj";315;114;12;126;NA;81280;327;2020-10-24;3461
2020-10-23;"Banskobystrický kraj";231;230;29;259;NA;81280;260;2020-10-23;3134
2020-10-22;"Banskobystrický kraj";264;253;24;277;NA;81280;288;2020-10-22;2874
2020-10-21;"Banskobystrický kraj";209;266;3;269;NA;81280;212;2020-10-21;2586
2020-10-20;"Banskobystrický kraj";210;66;3;69;NA;81280;213;2020-10-20;2374
2020-10-19;"Banskobystrický kraj";27;73;12;85;NA;81280;39;2020-10-19;2161
2020-10-18;"Banskobystrický kraj";49;0;0;0;NA;81280;49;2020-10-18;2122
2020-10-17;"Banskobystrický kraj";91;0;0;0;NA;81280;91;2020-10-17;2073
2020-10-16;"Banskobystrický kraj";224;37;3;40;NA;81280;227;2020-10-16;1982
2020-10-15;"Banskobystrický kraj";133;29;1;30;NA;81280;134;2020-10-15;1755
2020-10-14;"Banskobystrický kraj";139;31;1;32;NA;81280;140;2020-10-14;1621
2020-10-13;"Banskobystrický kraj";151;169;11;180;NA;81280;162;2020-10-13;1481
2020-10-12;"Banskobystrický kraj";11;110;4;114;NA;81280;15;2020-10-12;1319
2020-10-11;"Banskobystrický kraj";14;0;0;0;NA;81280;14;2020-10-11;1304
2020-10-10;"Banskobystrický kraj";53;0;0;0;NA;81280;53;2020-10-10;1290
2020-10-09;"Banskobystrický kraj";128;0;0;0;NA;81280;128;2020-10-09;1237
2020-10-08;"Banskobystrický kraj";99;0;0;0;NA;81280;99;2020-10-08;1109
2020-10-07;"Banskobystrický kraj";124;0;0;0;NA;81280;124;2020-10-07;1010
2020-10-06;"Banskobystrický kraj";68;0;0;0;NA;81280;68;2020-10-06;886
2020-10-05;"Banskobystrický kraj";49;0;0;0;NA;81280;49;2020-10-05;818
2020-10-04;"Banskobystrický kraj";8;0;0;0;NA;81280;8;2020-10-04;769
2020-10-03;"Banskobystrický kraj";37;0;0;0;NA;81280;37;2020-10-03;761
2020-10-02;"Banskobystrický kraj";74;0;0;0;NA;81280;74;2020-10-02;724
2020-10-01;"Banskobystrický kraj";49;0;0;0;NA;81280;49;2020-10-01;650
2020-09-30;"Banskobystrický kraj";60;0;0;0;NA;81280;60;2020-09-30;601
2020-09-29;"Banskobystrický kraj";24;0;0;0;NA;81280;24;2020-09-29;541
2020-09-28;"Banskobystrický kraj";0;0;0;0;NA;81280;0;2020-09-28;517
2020-09-27;"Banskobystrický kraj";20;0;0;0;NA;81280;20;2020-09-27;517
2020-09-26;"Banskobystrický kraj";24;0;0;0;NA;81280;24;2020-09-26;497
2020-09-25;"Banskobystrický kraj";29;0;0;0;NA;81280;29;2020-09-25;473
2020-09-24;"Banskobystrický kraj";25;0;0;0;NA;81280;25;2020-09-24;444
2020-09-23;"Banskobystrický kraj";17;0;0;0;NA;81280;17;2020-09-23;419
2020-09-22;"Banskobystrický kraj";25;0;0;0;NA;81280;25;2020-09-22;402
2020-09-21;"Banskobystrický kraj";3;0;0;0;NA;81280;3;2020-09-21;377
2020-09-20;"Banskobystrický kraj";0;0;0;0;NA;81280;0;2020-09-20;374
2020-09-19;"Banskobystrický kraj";3;0;0;0;NA;81280;3;2020-09-19;374
2020-09-18;"Banskobystrický kraj";24;0;0;0;NA;81280;24;2020-09-18;371
2020-09-17;"Banskobystrický kraj";14;0;0;0;NA;81280;14;2020-09-17;347
2020-09-16;"Banskobystrický kraj";6;0;0;0;NA;81280;6;2020-09-16;333
2020-09-15;"Banskobystrický kraj";2;0;0;0;NA;81280;2;2020-09-15;327
2020-09-14;"Banskobystrický kraj";13;0;0;0;NA;81280;13;2020-09-14;325
2020-09-13;"Banskobystrický kraj";1;0;0;0;NA;81280;1;2020-09-13;312
2020-09-12;"Banskobystrický kraj";5;0;0;0;NA;81280;5;2020-09-12;311
2020-09-11;"Banskobystrický kraj";19;0;0;0;NA;81280;19;2020-09-11;306
2020-09-10;"Banskobystrický kraj";11;0;0;0;NA;81280;11;2020-09-10;287
2020-09-09;"Banskobystrický kraj";13;0;0;0;NA;81280;13;2020-09-09;276
2020-09-08;"Banskobystrický kraj";5;0;0;0;NA;81280;5;2020-09-08;263
2020-09-07;"Banskobystrický kraj";2;0;0;0;NA;81280;2;2020-09-07;258
2020-09-06;"Banskobystrický kraj";0;0;0;0;NA;81280;0;2020-09-06;256
2020-09-05;"Banskobystrický kraj";0;0;0;0;NA;81280;0;2020-09-05;256
2020-09-04;"Banskobystrický kraj";9;0;0;0;NA;81280;9;2020-09-04;256
2020-09-03;"Banskobystrický kraj";5;0;0;0;NA;81280;5;2020-09-03;247
2020-09-02;"Banskobystrický kraj";6;0;0;0;NA;81280;6;2020-09-02;242
2020-09-01;"Banskobystrický kraj";2;0;0;0;NA;81280;2;2020-09-01;236
2020-08-31;"Banskobystrický kraj";6;0;0;0;NA;81280;6;2020-08-31;234
2020-08-30;"Banskobystrický kraj";0;0;0;0;NA;81280;0;2020-08-30;228
2020-08-29;"Banskobystrický kraj";1;0;0;0;NA;81280;1;2020-08-29;228
2020-08-28;"Banskobystrický kraj";3;0;0;0;NA;81280;3;2020-08-28;227
2020-08-27;"Banskobystrický kraj";1;0;0;0;NA;81280;1;2020-08-27;224
2020-08-26;"Banskobystrický kraj";2;0;0;0;NA;81280;2;2020-08-26;223
2020-08-25;"Banskobystrický kraj";2;0;0;0;NA;81280;2;2020-08-25;221
2020-08-24;"Banskobystrický kraj";0;0;0;0;NA;81280;0;2020-08-24;219
2020-08-23;"Banskobystrický kraj";0;0;0;0;NA;81280;0;2020-08-23;219
2020-08-22;"Banskobystrický kraj";0;0;0;0;NA;81280;0;2020-08-22;219
2020-08-21;"Banskobystrický kraj";4;0;0;0;NA;81280;4;2020-08-21;219
2020-08-20;"Banskobystrický kraj";1;0;0;0;NA;81280;1;2020-08-20;215
2020-08-19;"Banskobystrický kraj";4;0;0;0;NA;81280;4;2020-08-19;214
2020-08-18;"Banskobystrický kraj";0;0;0;0;NA;81280;0;2020-08-18;210
2020-08-17;"Banskobystrický kraj";1;0;0;0;NA;81280;1;2020-08-17;210
2020-08-16;"Banskobystrický kraj";0;0;0;0;NA;81280;0;2020-08-16;209
2020-08-15;"Banskobystrický kraj";0;0;0;0;NA;81280;0;2020-08-15;209
2020-08-14;"Banskobystrický kraj";5;0;0;0;NA;81280;5;2020-08-14;209
2020-08-13;"Banskobystrický kraj";0;0;0;0;NA;81280;0;2020-08-13;204
2020-08-12;"Banskobystrický kraj";0;0;0;0;NA;81280;0;2020-08-12;204
2020-08-11;"Banskobystrický kraj";2;0;0;0;NA;81280;2;2020-08-11;204
2020-08-10;"Banskobystrický kraj";3;0;0;0;NA;81280;3;2020-08-10;202
2020-08-09;"Banskobystrický kraj";0;0;0;0;NA;81280;0;2020-08-09;199
2020-08-08;"Banskobystrický kraj";2;0;0;0;NA;81280;2;2020-08-08;199
2020-08-07;"Banskobystrický kraj";1;0;0;0;NA;81280;1;2020-08-07;197
2020-08-06;"Banskobystrický kraj";1;0;0;0;NA;81280;1;2020-08-06;196
2020-08-05;"Banskobystrický kraj";0;0;0;0;NA;81280;0;2020-08-05;195
2020-08-04;"Banskobystrický kraj";3;0;0;0;NA;81280;3;2020-08-04;195
2020-08-03;"Banskobystrický kraj";0;0;0;0;NA;81280;0;2020-08-03;192
2020-08-02;"Banskobystrický kraj";0;0;0;0;NA;81280;0;2020-08-02;192
2020-08-01;"Banskobystrický kraj";1;0;0;0;NA;81280;1;2020-08-01;192
2020-07-31;"Banskobystrický kraj";2;0;0;0;NA;81280;2;2020-07-31;191
2020-07-30;"Banskobystrický kraj";1;0;0;0;NA;81280;1;2020-07-30;189
2020-07-29;"Banskobystrický kraj";0;0;0;0;NA;81280;0;2020-07-29;188
2020-07-28;"Banskobystrický kraj";2;0;0;0;NA;81280;2;2020-07-28;188
2020-07-27;"Banskobystrický kraj";3;0;0;0;NA;81280;3;2020-07-27;186
2020-07-26;"Banskobystrický kraj";0;0;0;0;NA;81280;0;2020-07-26;183
2020-07-25;"Banskobystrický kraj";0;0;0;0;NA;81280;0;2020-07-25;183
2020-07-24;"Banskobystrický kraj";9;0;0;0;NA;81280;9;2020-07-24;183
2020-07-23;"Banskobystrický kraj";0;0;0;0;NA;81280;0;2020-07-23;174
2020-07-22;"Banskobystrický kraj";3;0;0;0;NA;81280;3;2020-07-22;174
2020-07-21;"Banskobystrický kraj";3;0;0;0;NA;81280;3;2020-07-21;171
2020-07-20;"Banskobystrický kraj";1;0;0;0;NA;81280;1;2020-07-20;168
2020-07-19;"Banskobystrický kraj";1;0;0;0;NA;81280;1;2020-07-19;167
2020-07-18;"Banskobystrický kraj";0;0;0;0;NA;81280;0;2020-07-18;166
2020-07-17;"Banskobystrický kraj";2;0;0;0;NA;81280;2;2020-07-17;166
2020-07-16;"Banskobystrický kraj";1;0;0;0;NA;81280;1;2020-07-16;164
2020-07-15;"Banskobystrický kraj";4;0;0;0;NA;81280;4;2020-07-15;163
2020-07-14;"Banskobystrický kraj";2;0;0;0;NA;81280;2;2020-07-14;159
2020-07-13;"Banskobystrický kraj";1;0;0;0;NA;81280;1;2020-07-13;157
2020-07-12;"Banskobystrický kraj";0;0;0;0;NA;81280;0;2020-07-12;156
2020-07-11;"Banskobystrický kraj";0;0;0;0;NA;81280;0;2020-07-11;156
2020-07-10;"Banskobystrický kraj";3;0;0;0;NA;81280;3;2020-07-10;156
2020-07-09;"Banskobystrický kraj";9;0;0;0;NA;81280;9;2020-07-09;153
2020-07-08;"Banskobystrický kraj";0;0;0;0;NA;81280;0;2020-07-08;144
2020-07-07;"Banskobystrický kraj";4;0;0;0;NA;81280;4;2020-07-07;144
2020-07-06;"Banskobystrický kraj";0;0;0;0;NA;81280;0;2020-07-06;140
2020-07-05;"Banskobystrický kraj";0;0;0;0;NA;81280;0;2020-07-05;140
2020-07-04;"Banskobystrický kraj";1;0;0;0;NA;81280;1;2020-07-04;140
2020-07-03;"Banskobystrický kraj";4;0;0;0;NA;81280;4;2020-07-03;139
2020-07-02;"Banskobystrický kraj";0;0;0;0;NA;81280;0;2020-07-02;135
2020-07-01;"Banskobystrický kraj";1;0;0;0;NA;81280;1;2020-07-01;135
2020-06-30;"Banskobystrický kraj";0;0;0;0;NA;81280;0;2020-06-30;134
2020-06-29;"Banskobystrický kraj";0;0;0;0;NA;81280;0;2020-06-29;134
2020-06-28;"Banskobystrický kraj";0;0;0;0;NA;81280;0;2020-06-28;134
2020-06-27;"Banskobystrický kraj";0;0;0;0;NA;81280;0;2020-06-27;134
2020-06-26;"Banskobystrický kraj";0;0;0;0;NA;81280;0;2020-06-26;134
2020-06-25;"Banskobystrický kraj";1;0;0;0;NA;81280;1;2020-06-25;134
2020-06-24;"Banskobystrický kraj";0;0;0;0;NA;81280;0;2020-06-24;133
2020-06-23;"Banskobystrický kraj";6;0;0;0;NA;81280;6;2020-06-23;133
2020-06-22;"Banskobystrický kraj";0;0;0;0;NA;81280;0;2020-06-22;127
2020-06-21;"Banskobystrický kraj";0;0;0;0;NA;81280;0;2020-06-21;127
2020-06-20;"Banskobystrický kraj";0;0;0;0;NA;81280;0;2020-06-20;127
2020-06-19;"Banskobystrický kraj";2;0;0;0;NA;81280;2;2020-06-19;127
2020-06-18;"Banskobystrický kraj";10;0;0;0;NA;81280;10;2020-06-18;125
2020-06-17;"Banskobystrický kraj";1;0;0;0;NA;81280;1;2020-06-17;115
2020-06-16;"Banskobystrický kraj";0;0;0;0;NA;81280;0;2020-06-16;114
2020-06-14;"Banskobystrický kraj";2;0;0;0;NA;81280;2;2020-06-14;114
2020-06-13;"Banskobystrický kraj";2;0;0;0;NA;81280;2;2020-06-13;112
2020-06-12;"Banskobystrický kraj";0;0;0;0;NA;81280;0;2020-06-12;110
2020-06-11;"Banskobystrický kraj";1;0;0;0;NA;81280;1;2020-06-11;110
2020-06-10;"Banskobystrický kraj";0;0;0;0;NA;81280;0;2020-06-10;109
2020-06-09;"Banskobystrický kraj";0;0;0;0;NA;81280;0;2020-06-09;109
2020-06-08;"Banskobystrický kraj";0;0;0;0;NA;81280;0;2020-06-08;109
2020-06-07;"Banskobystrický kraj";0;0;0;0;NA;81280;0;2020-06-07;109
2020-06-05;"Banskobystrický kraj";2;0;0;0;NA;81280;2;2020-06-05;109
2020-06-03;"Banskobystrický kraj";0;0;0;0;NA;81280;0;2020-06-03;107
2020-06-02;"Banskobystrický kraj";0;0;0;0;NA;81280;0;2020-06-02;107
2020-05-31;"Banskobystrický kraj";0;0;0;0;NA;81280;0;2020-05-31;107
2020-05-29;"Banskobystrický kraj";0;0;0;0;NA;81280;0;2020-05-29;107
2020-05-27;"Banskobystrický kraj";1;0;0;0;NA;81280;1;2020-05-27;107
2020-05-26;"Banskobystrický kraj";0;0;0;0;NA;81280;0;2020-05-26;106
2020-05-25;"Banskobystrický kraj";0;0;0;0;NA;81280;0;2020-05-25;106
2020-05-24;"Banskobystrický kraj";0;0;0;0;NA;81280;0;2020-05-24;106
2020-05-23;"Banskobystrický kraj";1;0;0;0;NA;81280;1;2020-05-23;106
2020-05-22;"Banskobystrický kraj";0;0;0;0;NA;81280;0;2020-05-22;105
2020-05-21;"Banskobystrický kraj";0;0;0;0;NA;81280;0;2020-05-21;105
2020-05-20;"Banskobystrický kraj";1;0;0;0;NA;81280;1;2020-05-20;105
2020-05-19;"Banskobystrický kraj";0;0;0;0;NA;81280;0;2020-05-19;104
2020-05-17;"Banskobystrický kraj";0;0;0;0;NA;81280;0;2020-05-17;104
2020-05-16;"Banskobystrický kraj";0;0;0;0;NA;81280;0;2020-05-16;104
2020-05-15;"Banskobystrický kraj";0;0;0;0;NA;81280;0;2020-05-15;104
2020-05-14;"Banskobystrický kraj";0;0;0;0;NA;81280;0;2020-05-14;104
2020-05-13;"Banskobystrický kraj";0;0;0;0;NA;81280;0;2020-05-13;104
2020-05-12;"Banskobystrický kraj";1;0;0;0;NA;81280;1;2020-05-12;104
2020-05-11;"Banskobystrický kraj";0;0;0;0;NA;81280;0;2020-05-11;103
2020-05-09;"Banskobystrický kraj";0;0;0;0;NA;81280;0;2020-05-09;103
2020-05-07;"Banskobystrický kraj";2;0;0;0;NA;81280;2;2020-05-07;103
2020-05-06;"Banskobystrický kraj";1;0;0;0;NA;81280;1;2020-05-06;101
2020-05-05;"Banskobystrický kraj";2;0;0;0;NA;81280;2;2020-05-05;100
2020-05-04;"Banskobystrický kraj";0;0;0;0;NA;81280;0;2020-05-04;98
2020-05-03;"Banskobystrický kraj";0;0;0;0;NA;81280;0;2020-05-03;98
2020-05-02;"Banskobystrický kraj";0;0;0;0;NA;81280;0;2020-05-02;98
2020-05-01;"Banskobystrický kraj";0;0;0;0;NA;81280;0;2020-05-01;98
2020-04-30;"Banskobystrický kraj";1;0;0;0;NA;81280;1;2020-04-30;98
2020-04-29;"Banskobystrický kraj";1;0;0;0;NA;81280;1;2020-04-29;97
2020-04-28;"Banskobystrický kraj";0;0;0;0;NA;81280;0;2020-04-28;96
2020-04-27;"Banskobystrický kraj";0;0;0;0;NA;81280;0;2020-04-27;96
2020-04-26;"Banskobystrický kraj";0;0;0;0;NA;81280;0;2020-04-26;96
2020-04-25;"Banskobystrický kraj";2;0;0;0;NA;81280;2;2020-04-25;96
2020-04-24;"Banskobystrický kraj";3;0;0;0;NA;81280;3;2020-04-24;94
2020-04-23;"Banskobystrický kraj";2;0;0;0;NA;81280;2;2020-04-23;91
2020-04-22;"Banskobystrický kraj";2;0;0;0;NA;81280;2;2020-04-22;89
2020-04-21;"Banskobystrický kraj";2;0;0;0;NA;81280;2;2020-04-21;87
2020-04-20;"Banskobystrický kraj";0;0;0;0;NA;81280;0;2020-04-20;85
2020-04-19;"Banskobystrický kraj";0;0;0;0;NA;81280;0;2020-04-19;85
2020-04-18;"Banskobystrický kraj";8;0;0;0;NA;81280;8;2020-04-18;85
2020-04-17;"Banskobystrický kraj";2;0;0;0;NA;81280;2;2020-04-17;77
2020-04-16;"Banskobystrický kraj";0;0;0;0;NA;81280;0;2020-04-16;75
2020-04-15;"Banskobystrický kraj";10;0;0;0;NA;81280;10;2020-04-15;75
2020-04-14;"Banskobystrický kraj";0;0;0;0;NA;81280;0;2020-04-14;65
2020-04-13;"Banskobystrický kraj";2;0;0;0;NA;81280;2;2020-04-13;65
2020-04-12;"Banskobystrický kraj";4;0;0;0;NA;81280;4;2020-04-12;63
2020-04-11;"Banskobystrický kraj";1;0;0;0;NA;81280;1;2020-04-11;59
2020-04-10;"Banskobystrický kraj";0;0;0;0;NA;81280;0;2020-04-10;58
2020-04-09;"Banskobystrický kraj";2;0;0;0;NA;81280;2;2020-04-09;58
2020-04-08;"Banskobystrický kraj";0;0;0;0;NA;81280;0;2020-04-08;56
2020-04-07;"Banskobystrický kraj";4;0;0;0;NA;81280;4;2020-04-07;56
2020-04-06;"Banskobystrický kraj";10;0;0;0;NA;81280;10;2020-04-06;52
2020-04-05;"Banskobystrický kraj";9;0;0;0;NA;81280;9;2020-04-05;42
2020-04-04;"Banskobystrický kraj";0;0;0;0;NA;81280;0;2020-04-04;33
2020-04-03;"Banskobystrický kraj";2;0;0;0;NA;81280;2;2020-04-03;33
2020-04-02;"Banskobystrický kraj";2;0;0;0;NA;81280;2;2020-04-02;31
2020-04-01;"Banskobystrický kraj";5;0;0;0;NA;81280;5;2020-04-01;29
2020-03-31;"Banskobystrický kraj";3;0;0;0;NA;81280;3;2020-03-31;24
2020-03-30;"Banskobystrický kraj";1;0;0;0;NA;81280;1;2020-03-30;21
2020-03-29;"Banskobystrický kraj";2;0;0;0;NA;81280;2;2020-03-29;20
2020-03-28;"Banskobystrický kraj";1;0;0;0;NA;81280;1;2020-03-28;18
2020-03-27;"Banskobystrický kraj";1;531;4;535;NA;81280;5;2020-03-27;17
2020-03-26;"Banskobystrický kraj";1;0;0;0;NA;81280;1;2020-03-26;12
2020-03-25;"Banskobystrický kraj";0;0;0;0;NA;81280;0;2020-03-25;11
2020-03-24;"Banskobystrický kraj";1;0;0;0;NA;81280;1;2020-03-24;11
2020-03-23;"Banskobystrický kraj";1;0;0;0;NA;81280;1;2020-03-23;10
2020-03-22;"Banskobystrický kraj";0;0;0;0;NA;81280;0;2020-03-22;9
2020-03-21;"Banskobystrický kraj";3;0;0;0;NA;81280;3;2020-03-21;9
2020-03-20;"Banskobystrický kraj";0;0;0;0;NA;81280;0;2020-03-20;6
2020-03-19;"Banskobystrický kraj";2;0;0;0;NA;81280;2;2020-03-19;6
2020-03-18;"Banskobystrický kraj";1;0;0;0;NA;81280;1;2020-03-18;4
2020-03-17;"Banskobystrický kraj";1;0;0;0;NA;81280;1;2020-03-17;3
2020-03-16;"Banskobystrický kraj";0;0;0;0;NA;81280;0;2020-03-16;2
2020-03-15;"Banskobystrický kraj";1;0;0;0;NA;81280;1;2020-03-15;2
2020-03-14;"Banskobystrický kraj";0;0;0;0;NA;81280;0;2020-03-14;1
2020-03-13;"Banskobystrický kraj";1;0;0;0;NA;81280;1;2020-03-13;1
2020-03-12;"Banskobystrický kraj";0;0;0;0;NA;81280;0;2020-03-12;0
2020-03-11;"Banskobystrický kraj";0;0;0;0;NA;81280;0;2020-03-11;0
2020-03-09;"Banskobystrický kraj";0;0;0;0;NA;81280;0;2020-03-09;0
2020-03-08;"Banskobystrický kraj";0;0;0;0;NA;81280;0;2020-03-08;0
2020-03-07;"Banskobystrický kraj";0;0;0;0;NA;81280;0;2020-03-07;0
2020-03-06;"Banskobystrický kraj";0;0;0;0;NA;81280;0;2020-03-06;0
2021-04-29;"Bratislavský kraj";48;21596;79;21675;43638;88759;127;2021-04-29;88759
2021-04-28;"Bratislavský kraj";40;26319;69;26388;NA;88759;109;2021-04-28;88632
2021-04-27;"Bratislavský kraj";41;28055;45;28100;NA;88759;86;2021-04-27;88523
2021-04-26;"Bratislavský kraj";59;32775;91;32866;NA;88759;150;2021-04-26;88437
2021-04-25;"Bratislavský kraj";8;47498;61;47559;NA;88759;69;2021-04-25;88287
2021-04-24;"Bratislavský kraj";28;65836;59;65895;NA;88759;87;2021-04-24;88218
2021-04-23;"Bratislavský kraj";70;46712;63;46775;NA;88759;133;2021-04-23;88131
2021-04-22;"Bratislavský kraj";39;28951;66;29017;NA;88759;105;2021-04-22;87998
2021-04-21;"Bratislavský kraj";48;29717;62;29779;NA;88759;110;2021-04-21;87893
2021-04-20;"Bratislavský kraj";58;34555;62;34617;NA;88759;120;2021-04-20;87783
2021-04-19;"Bratislavský kraj";48;39177;80;39257;NA;88759;128;2021-04-19;87663
2021-04-18;"Bratislavský kraj";35;61935;76;62011;NA;88759;111;2021-04-18;87535
2021-04-17;"Bratislavský kraj";13;78620;111;78731;NA;88759;124;2021-04-17;87424
2021-04-16;"Bratislavský kraj";62;46378;80;46458;NA;88759;142;2021-04-16;87300
2021-04-15;"Bratislavský kraj";34;31599;74;31673;NA;88759;108;2021-04-15;87158
2021-04-14;"Bratislavský kraj";65;33094;88;33182;NA;88759;153;2021-04-14;87050
2021-04-13;"Bratislavský kraj";82;34999;82;35081;NA;88759;164;2021-04-13;86897
2021-04-12;"Bratislavský kraj";77;43408;115;43523;NA;88759;192;2021-04-12;86733
2021-04-11;"Bratislavský kraj";42;59463;123;59586;NA;88759;165;2021-04-11;86541
2021-04-10;"Bratislavský kraj";14;76300;167;76467;NA;88759;181;2021-04-10;86376
2021-04-09;"Bratislavský kraj";72;41759;97;41856;NA;88759;169;2021-04-09;86195
2021-04-08;"Bratislavský kraj";71;29886;94;29980;NA;88759;165;2021-04-08;86026
2021-04-07;"Bratislavský kraj";96;37439;102;37541;NA;88759;198;2021-04-07;85861
2021-04-06;"Bratislavský kraj";94;54956;177;55133;NA;88759;271;2021-04-06;85663
2021-04-05;"Bratislavský kraj";85;18532;87;18619;NA;88759;172;2021-04-05;85392
2021-04-04;"Bratislavský kraj";37;27478;73;27551;NA;88759;110;2021-04-04;85220
2021-04-03;"Bratislavský kraj";52;79544;231;79775;NA;88759;283;2021-04-03;85110
2021-04-02;"Bratislavský kraj";33;23954;104;24058;NA;88759;137;2021-04-02;84827
2021-04-01;"Bratislavský kraj";119;56830;159;56989;NA;88759;278;2021-04-01;84690
2021-03-31;"Bratislavský kraj";105;44966;149;45115;NA;88759;254;2021-03-31;84412
2021-03-30;"Bratislavský kraj";100;38586;142;38728;NA;88759;242;2021-03-30;84158
2021-03-29;"Bratislavský kraj";153;39951;176;40127;NA;88759;329;2021-03-29;83916
2021-03-28;"Bratislavský kraj";59;53341;137;53478;NA;88759;196;2021-03-28;83587
2021-03-27;"Bratislavský kraj";53;78388;238;78626;NA;88759;291;2021-03-27;83391
2021-03-26;"Bratislavský kraj";114;55460;190;55650;NA;88759;304;2021-03-26;83100
2021-03-25;"Bratislavský kraj";76;36175;170;36345;NA;88759;246;2021-03-25;82796
2021-03-24;"Bratislavský kraj";120;30072;200;30272;NA;88759;320;2021-03-24;82550
2021-03-23;"Bratislavský kraj";138;35616;189;35805;NA;88759;327;2021-03-23;82230
2021-03-22;"Bratislavský kraj";110;42188;218;42406;NA;88759;328;2021-03-22;81903
2021-03-21;"Bratislavský kraj";54;61297;212;61509;NA;88759;266;2021-03-21;81575
2021-03-20;"Bratislavský kraj";59;71927;227;72154;NA;88759;286;2021-03-20;81309
2021-03-19;"Bratislavský kraj";139;54135;256;54391;NA;88759;395;2021-03-19;81023
2021-03-18;"Bratislavský kraj";142;33803;190;33993;NA;88759;332;2021-03-18;80628
2021-03-17;"Bratislavský kraj";177;30071;215;30286;NA;88759;392;2021-03-17;80296
2021-03-16;"Bratislavský kraj";258;36306;282;36588;NA;88759;540;2021-03-16;79904
2021-03-15;"Bratislavský kraj";180;37436;251;37687;NA;88759;431;2021-03-15;79364
2021-03-14;"Bratislavský kraj";75;51470;270;51740;NA;88759;345;2021-03-14;78933
2021-03-13;"Bratislavský kraj";110;79609;329;79938;NA;88759;439;2021-03-13;78588
2021-03-12;"Bratislavský kraj";152;54397;301;54698;NA;88759;453;2021-03-12;78149
2021-03-11;"Bratislavský kraj";178;34189;281;34470;NA;88759;459;2021-03-11;77696
2021-03-10;"Bratislavský kraj";164;30815;273;31088;NA;88759;437;2021-03-10;77237
2021-03-09;"Bratislavský kraj";242;37590;267;37857;NA;88759;509;2021-03-09;76800
2021-03-08;"Bratislavský kraj";255;40440;343;40783;NA;88759;598;2021-03-08;76291
2021-03-07;"Bratislavský kraj";142;51537;290;51827;NA;88759;432;2021-03-07;75693
2021-03-06;"Bratislavský kraj";79;71387;412;71799;NA;88759;491;2021-03-06;75261
2021-03-05;"Bratislavský kraj";238;50431;292;50723;NA;88759;530;2021-03-05;74770
2021-03-04;"Bratislavský kraj";204;34503;344;34847;NA;88759;548;2021-03-04;74240
2021-03-03;"Bratislavský kraj";250;30406;364;30770;NA;88759;614;2021-03-03;73692
2021-03-02;"Bratislavský kraj";267;39505;388;39893;NA;88759;655;2021-03-02;73078
2021-03-01;"Bratislavský kraj";320;37793;432;38225;NA;88759;752;2021-03-01;72423
2021-02-28;"Bratislavský kraj";184;49969;323;50292;NA;88759;507;2021-02-28;71671
2021-02-27;"Bratislavský kraj";151;76807;465;77272;NA;88759;616;2021-02-27;71164
2021-02-26;"Bratislavský kraj";277;47198;400;47598;NA;88759;677;2021-02-26;70548
2021-02-25;"Bratislavský kraj";277;28425;405;28830;NA;88759;682;2021-02-25;69871
2021-02-24;"Bratislavský kraj";217;26917;412;27329;NA;88759;629;2021-02-24;69189
2021-02-23;"Bratislavský kraj";257;30781;395;31176;NA;88759;652;2021-02-23;68560
2021-02-22;"Bratislavský kraj";353;36250;480;36730;NA;88759;833;2021-02-22;67908
2021-02-21;"Bratislavský kraj";185;50102;379;50481;NA;88759;564;2021-02-21;67075
2021-02-20;"Bratislavský kraj";167;74750;550;75300;NA;88759;717;2021-02-20;66511
2021-02-19;"Bratislavský kraj";280;44679;415;45094;NA;88759;695;2021-02-19;65794
2021-02-18;"Bratislavský kraj";263;26494;373;26867;NA;88759;636;2021-02-18;65099
2021-02-17;"Bratislavský kraj";264;22231;316;22547;NA;88759;580;2021-02-17;64463
2021-02-16;"Bratislavský kraj";289;27745;354;28099;NA;88759;643;2021-02-16;63883
2021-02-15;"Bratislavský kraj";248;36734;396;37130;NA;88759;644;2021-02-15;63240
2021-02-14;"Bratislavský kraj";153;43274;308;43582;NA;88759;461;2021-02-14;62596
2021-02-13;"Bratislavský kraj";173;68529;515;69044;NA;88759;688;2021-02-13;62135
2021-02-12;"Bratislavský kraj";282;35610;327;35937;NA;88759;609;2021-02-12;61447
2021-02-11;"Bratislavský kraj";337;24183;290;24473;NA;88759;627;2021-02-11;60838
2021-02-10;"Bratislavský kraj";314;22817;359;23176;NA;88759;673;2021-02-10;60211
2021-02-09;"Bratislavský kraj";287;36195;454;36649;NA;88759;741;2021-02-09;59538
2021-02-08;"Bratislavský kraj";484;32153;402;32555;NA;88759;886;2021-02-08;58797
2021-02-07;"Bratislavský kraj";243;46239;398;46637;NA;88759;641;2021-02-07;57911
2021-02-06;"Bratislavský kraj";116;62560;508;63068;NA;88759;624;2021-02-06;57270
2021-02-05;"Bratislavský kraj";327;27071;375;27446;NA;88759;702;2021-02-05;56646
2021-02-04;"Bratislavský kraj";555;16434;348;16782;NA;88759;903;2021-02-04;55944
2021-02-03;"Bratislavský kraj";161;12853;351;13204;NA;88759;512;2021-02-03;55041
2021-02-02;"Bratislavský kraj";397;25627;480;26107;NA;88759;877;2021-02-02;54529
2021-02-01;"Bratislavský kraj";221;35187;513;35700;NA;88759;734;2021-02-01;53652
2021-01-31;"Bratislavský kraj";180;35623;425;36048;NA;88759;605;2021-01-31;52918
2021-01-30;"Bratislavský kraj";310;49564;521;50085;NA;88759;831;2021-01-30;52313
2021-01-29;"Bratislavský kraj";344;16200;341;16541;NA;88759;685;2021-01-29;51482
2021-01-28;"Bratislavský kraj";307;10679;297;10976;NA;88759;604;2021-01-28;50797
2021-01-27;"Bratislavský kraj";336;22093;345;22438;NA;88759;681;2021-01-27;50193
2021-01-26;"Bratislavský kraj";297;22078;308;22386;NA;88759;605;2021-01-26;49512
2021-01-25;"Bratislavský kraj";356;22405;248;22653;NA;88759;604;2021-01-25;48907
2021-01-24;"Bratislavský kraj";175;37754;391;38145;NA;88759;566;2021-01-24;48303
2021-01-23;"Bratislavský kraj";396;79317;703;80020;NA;88759;1099;2021-01-23;47737
2021-01-22;"Bratislavský kraj";199;41866;365;42231;NA;88759;564;2021-01-22;46638
2021-01-21;"Bratislavský kraj";255;105639;1317;106956;NA;88759;1572;2021-01-21;46074
2021-01-20;"Bratislavský kraj";360;26667;450;27117;NA;88759;810;2021-01-20;44502
2021-01-19;"Bratislavský kraj";375;14163;346;14509;NA;88759;721;2021-01-19;43692
2021-01-18;"Bratislavský kraj";357;11977;707;12684;NA;88759;1064;2021-01-18;42971
2021-01-17;"Bratislavský kraj";244;426;26;452;NA;88759;270;2021-01-17;41907
2021-01-16;"Bratislavský kraj";70;2908;156;3064;NA;88759;226;2021-01-16;41637
2021-01-15;"Bratislavský kraj";251;7744;256;8000;NA;88759;507;2021-01-15;41411
2021-01-14;"Bratislavský kraj";363;8316;273;8589;NA;88759;636;2021-01-14;40904
2021-01-13;"Bratislavský kraj";336;8040;329;8369;NA;88759;665;2021-01-13;40268
2021-01-12;"Bratislavský kraj";450;9568;464;10032;NA;88759;914;2021-01-12;39603
2021-01-11;"Bratislavský kraj";397;19291;380;19671;NA;88759;777;2021-01-11;38689
2021-01-10;"Bratislavský kraj";252;1350;79;1429;NA;88759;331;2021-01-10;37912
2021-01-09;"Bratislavský kraj";351;4946;291;5237;NA;88759;642;2021-01-09;37581
2021-01-08;"Bratislavský kraj";556;9882;436;10318;NA;88759;992;2021-01-08;36939
2021-01-07;"Bratislavský kraj";537;7161;412;7573;NA;88759;949;2021-01-07;35947
2021-01-06;"Bratislavský kraj";271;3075;216;3291;NA;88759;487;2021-01-06;34998
2021-01-05;"Bratislavský kraj";619;10730;844;11574;NA;88759;1463;2021-01-05;34511
2021-01-04;"Bratislavský kraj";601;7381;606;7987;NA;88759;1207;2021-01-04;33048
2021-01-03;"Bratislavský kraj";77;394;41;435;NA;88759;118;2021-01-03;31841
2021-01-02;"Bratislavský kraj";185;384;57;441;NA;88759;242;2021-01-02;31723
2021-01-01;"Bratislavský kraj";235;3210;131;3341;NA;88759;366;2021-01-01;31481
2020-12-31;"Bratislavský kraj";925;14633;589;15222;NA;88759;1514;2020-12-31;31115
2020-12-30;"Bratislavský kraj";650;9332;528;9860;NA;88759;1178;2020-12-30;29601
2020-12-29;"Bratislavský kraj";303;10365;776;11141;NA;88759;1079;2020-12-29;28423
2020-12-28;"Bratislavský kraj";255;7687;560;8247;NA;88759;815;2020-12-28;27344
2020-12-27;"Bratislavský kraj";160;659;76;735;NA;88759;236;2020-12-27;26529
2020-12-26;"Bratislavský kraj";75;426;27;453;NA;88759;102;2020-12-26;26293
2020-12-25;"Bratislavský kraj";114;460;38;498;NA;88759;152;2020-12-25;26191
2020-12-24;"Bratislavský kraj";536;3381;102;3483;NA;88759;638;2020-12-24;26039
2020-12-23;"Bratislavský kraj";416;13159;500;13659;NA;88759;916;2020-12-23;25401
2020-12-22;"Bratislavský kraj";327;15248;772;16020;NA;88759;1099;2020-12-22;24485
2020-12-21;"Bratislavský kraj";392;14970;2007;16977;NA;88759;2399;2020-12-21;23386
2020-12-20;"Bratislavský kraj";180;643;54;697;NA;88759;234;2020-12-20;20987
2020-12-19;"Bratislavský kraj";396;3164;130;3294;NA;88759;526;2020-12-19;20753
2020-12-18;"Bratislavský kraj";306;10672;401;11073;NA;88759;707;2020-12-18;20227
2020-12-17;"Bratislavský kraj";502;10217;412;10629;NA;88759;914;2020-12-17;19520
2020-12-16;"Bratislavský kraj";282;10546;452;10998;NA;88759;734;2020-12-16;18606
2020-12-15;"Bratislavský kraj";423;10741;479;11220;NA;88759;902;2020-12-15;17872
2020-12-14;"Bratislavský kraj";279;6526;293;6819;NA;88759;572;2020-12-14;16970
2020-12-13;"Bratislavský kraj";125;123;10;133;NA;88759;135;2020-12-13;16398
2020-12-12;"Bratislavský kraj";361;3863;157;4020;NA;88759;518;2020-12-12;16263
2020-12-11;"Bratislavský kraj";326;7203;289;7492;NA;88759;615;2020-12-11;15745
2020-12-10;"Bratislavský kraj";286;5104;209;5313;NA;88759;495;2020-12-10;15130
2020-12-09;"Bratislavský kraj";382;4712;178;4890;NA;88759;560;2020-12-09;14635
2020-12-08;"Bratislavský kraj";234;5793;207;6000;NA;88759;441;2020-12-08;14075
2020-12-07;"Bratislavský kraj";272;4078;152;4230;NA;88759;424;2020-12-07;13634
2020-12-06;"Bratislavský kraj";61;1586;52;1638;NA;88759;113;2020-12-06;13210
2020-12-05;"Bratislavský kraj";266;2148;41;2189;NA;88759;307;2020-12-05;13097
2020-12-04;"Bratislavský kraj";200;4789;99;4888;NA;88759;299;2020-12-04;12790
2020-12-03;"Bratislavský kraj";213;5071;95;5166;NA;88759;308;2020-12-03;12491
2020-12-02;"Bratislavský kraj";205;2831;95;2926;NA;88759;300;2020-12-02;12183
2020-12-01;"Bratislavský kraj";255;3943;204;4147;NA;88759;459;2020-12-01;11883
2020-11-30;"Bratislavský kraj";152;2153;121;2274;NA;88759;273;2020-11-30;11424
2020-11-29;"Bratislavský kraj";52;201;24;225;NA;88759;76;2020-11-29;11151
2020-11-28;"Bratislavský kraj";232;2624;33;2657;NA;88759;265;2020-11-28;11075
2020-11-27;"Bratislavský kraj";54;2540;64;2604;NA;88759;118;2020-11-27;10810
2020-11-26;"Bratislavský kraj";129;1976;60;2036;NA;88759;189;2020-11-26;10692
2020-11-25;"Bratislavský kraj";140;1770;47;1817;NA;88759;187;2020-11-25;10503
2020-11-24;"Bratislavský kraj";81;2988;67;3055;NA;88759;148;2020-11-24;10316
2020-11-23;"Bratislavský kraj";67;7083;58;7141;NA;88759;125;2020-11-23;10168
2020-11-22;"Bratislavský kraj";36;81;7;88;NA;88759;43;2020-11-22;10043
2020-11-21;"Bratislavský kraj";109;2126;47;2173;NA;88759;156;2020-11-21;10000
2020-11-20;"Bratislavský kraj";118;2876;48;2924;NA;88759;166;2020-11-20;9844
2020-11-19;"Bratislavský kraj";173;987;29;1016;NA;88759;202;2020-11-19;9678
2020-11-18;"Bratislavský kraj";118;616;75;691;NA;88759;193;2020-11-18;9476
2020-11-17;"Bratislavský kraj";108;928;23;951;NA;88759;131;2020-11-17;9283
2020-11-16;"Bratislavský kraj";82;651;9;660;NA;88759;91;2020-11-16;9152
2020-11-15;"Bratislavský kraj";47;236;0;236;NA;88759;47;2020-11-15;9061
2020-11-14;"Bratislavský kraj";53;1834;15;1849;NA;88759;68;2020-11-14;9014
2020-11-13;"Bratislavský kraj";94;2096;21;2117;NA;88759;115;2020-11-13;8946
2020-11-12;"Bratislavský kraj";141;1727;6;1733;NA;88759;147;2020-11-12;8831
2020-11-11;"Bratislavský kraj";159;1429;12;1441;NA;88759;171;2020-11-11;8684
2020-11-10;"Bratislavský kraj";136;805;14;819;NA;88759;150;2020-11-10;8513
2020-11-09;"Bratislavský kraj";70;616;8;624;NA;88759;78;2020-11-09;8363
2020-11-08;"Bratislavský kraj";82;869;6;875;NA;88759;88;2020-11-08;8285
2020-11-07;"Bratislavský kraj";88;4039;17;4056;NA;88759;105;2020-11-07;8197
2020-11-06;"Bratislavský kraj";281;6441;25;6466;NA;88759;306;2020-11-06;8092
2020-11-05;"Bratislavský kraj";175;476;11;487;NA;88759;186;2020-11-05;7786
2020-11-04;"Bratislavský kraj";65;411;10;421;NA;88759;75;2020-11-04;7600
2020-11-03;"Bratislavský kraj";251;1085;12;1097;NA;88759;263;2020-11-03;7525
2020-11-02;"Bratislavský kraj";202;3365;22;3387;NA;88759;224;2020-11-02;7262
2020-11-01;"Bratislavský kraj";227;8694;39;8733;NA;88759;266;2020-11-01;7038
2020-10-31;"Bratislavský kraj";173;22407;123;22530;NA;88759;296;2020-10-31;6772
2020-10-30;"Bratislavský kraj";158;17350;138;17488;NA;88759;296;2020-10-30;6476
2020-10-29;"Bratislavský kraj";262;116;4;120;NA;88759;266;2020-10-29;6180
2020-10-28;"Bratislavský kraj";220;260;15;275;NA;88759;235;2020-10-28;5914
2020-10-27;"Bratislavský kraj";256;145;4;149;NA;88759;260;2020-10-27;5679
2020-10-26;"Bratislavský kraj";123;229;11;240;NA;88759;134;2020-10-26;5419
2020-10-25;"Bratislavský kraj";152;33;2;35;NA;88759;154;2020-10-25;5285
2020-10-24;"Bratislavský kraj";170;221;6;227;NA;88759;176;2020-10-24;5131
2020-10-23;"Bratislavský kraj";151;144;8;152;NA;88759;159;2020-10-23;4955
2020-10-22;"Bratislavský kraj";192;204;15;219;NA;88759;207;2020-10-22;4796
2020-10-21;"Bratislavský kraj";66;90;6;96;NA;88759;72;2020-10-21;4589
2020-10-20;"Bratislavský kraj";183;97;4;101;NA;88759;187;2020-10-20;4517
2020-10-19;"Bratislavský kraj";148;168;4;172;NA;88759;152;2020-10-19;4330
2020-10-18;"Bratislavský kraj";75;92;0;92;NA;88759;75;2020-10-18;4178
2020-10-17;"Bratislavský kraj";136;0;0;0;NA;88759;136;2020-10-17;4103
2020-10-16;"Bratislavský kraj";103;14;1;15;NA;88759;104;2020-10-16;3967
2020-10-15;"Bratislavský kraj";135;6;1;7;NA;88759;136;2020-10-15;3863
2020-10-14;"Bratislavský kraj";127;4;0;4;NA;88759;127;2020-10-14;3727
2020-10-13;"Bratislavský kraj";86;108;8;116;NA;88759;94;2020-10-13;3600
2020-10-12;"Bratislavský kraj";46;0;0;0;NA;88759;46;2020-10-12;3506
2020-10-11;"Bratislavský kraj";80;0;0;0;NA;88759;80;2020-10-11;3460
2020-10-10;"Bratislavský kraj";55;0;0;0;NA;88759;55;2020-10-10;3380
2020-10-09;"Bratislavský kraj";148;0;0;0;NA;88759;148;2020-10-09;3325
2020-10-08;"Bratislavský kraj";100;0;0;0;NA;88759;100;2020-10-08;3177
2020-10-07;"Bratislavský kraj";107;0;0;0;NA;88759;107;2020-10-07;3077
2020-10-06;"Bratislavský kraj";108;0;0;0;NA;88759;108;2020-10-06;2970
2020-10-05;"Bratislavský kraj";30;0;0;0;NA;88759;30;2020-10-05;2862
2020-10-04;"Bratislavský kraj";49;0;0;0;NA;88759;49;2020-10-04;2832
2020-10-03;"Bratislavský kraj";82;0;0;0;NA;88759;82;2020-10-03;2783
2020-10-02;"Bratislavský kraj";101;0;0;0;NA;88759;101;2020-10-02;2701
2020-10-01;"Bratislavský kraj";72;0;0;0;NA;88759;72;2020-10-01;2600
2020-09-30;"Bratislavský kraj";91;0;0;0;NA;88759;91;2020-09-30;2528
2020-09-29;"Bratislavský kraj";74;0;0;0;NA;88759;74;2020-09-29;2437
2020-09-28;"Bratislavský kraj";29;0;0;0;NA;88759;29;2020-09-28;2363
2020-09-27;"Bratislavský kraj";48;0;0;0;NA;88759;48;2020-09-27;2334
2020-09-26;"Bratislavský kraj";86;0;0;0;NA;88759;86;2020-09-26;2286
2020-09-25;"Bratislavský kraj";97;0;0;0;NA;88759;97;2020-09-25;2200
2020-09-24;"Bratislavský kraj";73;0;0;0;NA;88759;73;2020-09-24;2103
2020-09-23;"Bratislavský kraj";55;0;0;0;NA;88759;55;2020-09-23;2030
2020-09-22;"Bratislavský kraj";81;0;0;0;NA;88759;81;2020-09-22;1975
2020-09-21;"Bratislavský kraj";32;0;0;0;NA;88759;32;2020-09-21;1894
2020-09-20;"Bratislavský kraj";25;0;0;0;NA;88759;25;2020-09-20;1862
2020-09-19;"Bratislavský kraj";59;0;0;0;NA;88759;59;2020-09-19;1837
2020-09-18;"Bratislavský kraj";42;0;0;0;NA;88759;42;2020-09-18;1778
2020-09-17;"Bratislavský kraj";52;0;0;0;NA;88759;52;2020-09-17;1736
2020-09-16;"Bratislavský kraj";32;0;0;0;NA;88759;32;2020-09-16;1684
2020-09-15;"Bratislavský kraj";26;0;0;0;NA;88759;26;2020-09-15;1652
2020-09-14;"Bratislavský kraj";24;0;0;0;NA;88759;24;2020-09-14;1626
2020-09-13;"Bratislavský kraj";11;0;0;0;NA;88759;11;2020-09-13;1602
2020-09-12;"Bratislavský kraj";24;0;0;0;NA;88759;24;2020-09-12;1591
2020-09-11;"Bratislavský kraj";50;0;0;0;NA;88759;50;2020-09-11;1567
2020-09-10;"Bratislavský kraj";47;0;0;0;NA;88759;47;2020-09-10;1517
2020-09-09;"Bratislavský kraj";40;0;0;0;NA;88759;40;2020-09-09;1470
2020-09-08;"Bratislavský kraj";58;0;0;0;NA;88759;58;2020-09-08;1430
2020-09-07;"Bratislavský kraj";39;0;0;0;NA;88759;39;2020-09-07;1372
2020-09-06;"Bratislavský kraj";11;0;0;0;NA;88759;11;2020-09-06;1333
2020-09-05;"Bratislavský kraj";37;0;0;0;NA;88759;37;2020-09-05;1322
2020-09-04;"Bratislavský kraj";87;0;0;0;NA;88759;87;2020-09-04;1285
2020-09-03;"Bratislavský kraj";51;0;0;0;NA;88759;51;2020-09-03;1198
2020-09-02;"Bratislavský kraj";50;0;0;0;NA;88759;50;2020-09-02;1147
2020-09-01;"Bratislavský kraj";16;0;0;0;NA;88759;16;2020-09-01;1097
2020-08-31;"Bratislavský kraj";19;0;0;0;NA;88759;19;2020-08-31;1081
2020-08-30;"Bratislavský kraj";9;0;0;0;NA;88759;9;2020-08-30;1062
2020-08-29;"Bratislavský kraj";12;0;0;0;NA;88759;12;2020-08-29;1053
2020-08-28;"Bratislavský kraj";35;0;0;0;NA;88759;35;2020-08-28;1041
2020-08-27;"Bratislavský kraj";33;0;0;0;NA;88759;33;2020-08-27;1006
2020-08-26;"Bratislavský kraj";27;0;0;0;NA;88759;27;2020-08-26;973
2020-08-25;"Bratislavský kraj";29;0;0;0;NA;88759;29;2020-08-25;946
2020-08-24;"Bratislavský kraj";6;0;0;0;NA;88759;6;2020-08-24;917
2020-08-23;"Bratislavský kraj";45;0;0;0;NA;88759;45;2020-08-23;911
2020-08-22;"Bratislavský kraj";13;0;0;0;NA;88759;13;2020-08-22;866
2020-08-21;"Bratislavský kraj";46;0;0;0;NA;88759;46;2020-08-21;853
2020-08-20;"Bratislavský kraj";41;0;0;0;NA;88759;41;2020-08-20;807
2020-08-19;"Bratislavský kraj";27;0;0;0;NA;88759;27;2020-08-19;766
2020-08-18;"Bratislavský kraj";47;0;0;0;NA;88759;47;2020-08-18;739
2020-08-17;"Bratislavský kraj";2;0;0;0;NA;88759;2;2020-08-17;692
2020-08-16;"Bratislavský kraj";3;0;0;0;NA;88759;3;2020-08-16;690
2020-08-15;"Bratislavský kraj";18;0;0;0;NA;88759;18;2020-08-15;687
2020-08-14;"Bratislavský kraj";16;0;0;0;NA;88759;16;2020-08-14;669
2020-08-13;"Bratislavský kraj";12;0;0;0;NA;88759;12;2020-08-13;653
2020-08-12;"Bratislavský kraj";10;0;0;0;NA;88759;10;2020-08-12;641
2020-08-11;"Bratislavský kraj";23;0;0;0;NA;88759;23;2020-08-11;631
2020-08-10;"Bratislavský kraj";2;0;0;0;NA;88759;2;2020-08-10;608
2020-08-09;"Bratislavský kraj";2;0;0;0;NA;88759;2;2020-08-09;606
2020-08-08;"Bratislavský kraj";1;0;0;0;NA;88759;1;2020-08-08;604
2020-08-07;"Bratislavský kraj";9;0;0;0;NA;88759;9;2020-08-07;603
2020-08-06;"Bratislavský kraj";15;0;0;0;NA;88759;15;2020-08-06;594
2020-08-05;"Bratislavský kraj";11;0;0;0;NA;88759;11;2020-08-05;579
2020-08-04;"Bratislavský kraj";21;0;0;0;NA;88759;21;2020-08-04;568
2020-08-03;"Bratislavský kraj";7;0;0;0;NA;88759;7;2020-08-03;547
2020-08-02;"Bratislavský kraj";0;0;0;0;NA;88759;0;2020-08-02;540
2020-08-01;"Bratislavský kraj";0;0;0;0;NA;88759;0;2020-08-01;540
2020-07-31;"Bratislavský kraj";14;0;0;0;NA;88759;14;2020-07-31;540
2020-07-30;"Bratislavský kraj";6;0;0;0;NA;88759;6;2020-07-30;526
2020-07-29;"Bratislavský kraj";7;0;0;0;NA;88759;7;2020-07-29;520
2020-07-28;"Bratislavský kraj";14;0;0;0;NA;88759;14;2020-07-28;513
2020-07-27;"Bratislavský kraj";3;0;0;0;NA;88759;3;2020-07-27;499
2020-07-26;"Bratislavský kraj";0;0;0;0;NA;88759;0;2020-07-26;496
2020-07-25;"Bratislavský kraj";8;0;0;0;NA;88759;8;2020-07-25;496
2020-07-24;"Bratislavský kraj";2;0;0;0;NA;88759;2;2020-07-24;488
2020-07-23;"Bratislavský kraj";8;0;0;0;NA;88759;8;2020-07-23;486
2020-07-22;"Bratislavský kraj";11;0;0;0;NA;88759;11;2020-07-22;478
2020-07-21;"Bratislavský kraj";8;0;0;0;NA;88759;8;2020-07-21;467
2020-07-20;"Bratislavský kraj";12;0;0;0;NA;88759;12;2020-07-20;459
2020-07-19;"Bratislavský kraj";0;0;0;0;NA;88759;0;2020-07-19;447
2020-07-18;"Bratislavský kraj";2;0;0;0;NA;88759;2;2020-07-18;447
2020-07-17;"Bratislavský kraj";2;0;0;0;NA;88759;2;2020-07-17;445
2020-07-16;"Bratislavský kraj";6;0;0;0;NA;88759;6;2020-07-16;443
2020-07-15;"Bratislavský kraj";3;0;0;0;NA;88759;3;2020-07-15;437
2020-07-14;"Bratislavský kraj";2;0;0;0;NA;88759;2;2020-07-14;434
2020-07-13;"Bratislavský kraj";2;0;0;0;NA;88759;2;2020-07-13;432
2020-07-12;"Bratislavský kraj";0;0;0;0;NA;88759;0;2020-07-12;430
2020-07-11;"Bratislavský kraj";0;0;0;0;NA;88759;0;2020-07-11;430
2020-07-10;"Bratislavský kraj";8;0;0;0;NA;88759;8;2020-07-10;430
2020-07-09;"Bratislavský kraj";2;0;0;0;NA;88759;2;2020-07-09;422
2020-07-08;"Bratislavský kraj";11;0;0;0;NA;88759;11;2020-07-08;420
2020-07-07;"Bratislavský kraj";5;0;0;0;NA;88759;5;2020-07-07;409
2020-07-06;"Bratislavský kraj";1;0;0;0;NA;88759;1;2020-07-06;404
2020-07-05;"Bratislavský kraj";0;0;0;0;NA;88759;0;2020-07-05;403
2020-07-04;"Bratislavský kraj";3;0;0;0;NA;88759;3;2020-07-04;403
2020-07-03;"Bratislavský kraj";1;0;0;0;NA;88759;1;2020-07-03;400
2020-07-02;"Bratislavský kraj";0;0;0;0;NA;88759;0;2020-07-02;399
2020-07-01;"Bratislavský kraj";7;0;0;0;NA;88759;7;2020-07-01;399
2020-06-30;"Bratislavský kraj";3;0;0;0;NA;88759;3;2020-06-30;392
2020-06-29;"Bratislavský kraj";1;0;0;0;NA;88759;1;2020-06-29;389
2020-06-28;"Bratislavský kraj";0;0;0;0;NA;88759;0;2020-06-28;388
2020-06-27;"Bratislavský kraj";1;0;0;0;NA;88759;1;2020-06-27;388
2020-06-26;"Bratislavský kraj";6;0;0;0;NA;88759;6;2020-06-26;387
2020-06-25;"Bratislavský kraj";0;0;0;0;NA;88759;0;2020-06-25;381
2020-06-24;"Bratislavský kraj";3;0;0;0;NA;88759;3;2020-06-24;381
2020-06-23;"Bratislavský kraj";0;0;0;0;NA;88759;0;2020-06-23;378
2020-06-22;"Bratislavský kraj";1;0;0;0;NA;88759;1;2020-06-22;378
2020-06-21;"Bratislavský kraj";0;0;0;0;NA;88759;0;2020-06-21;377
2020-06-20;"Bratislavský kraj";0;0;0;0;NA;88759;0;2020-06-20;377
2020-06-19;"Bratislavský kraj";3;0;0;0;NA;88759;3;2020-06-19;377
2020-06-18;"Bratislavský kraj";0;0;0;0;NA;88759;0;2020-06-18;374
2020-06-17;"Bratislavský kraj";0;0;0;0;NA;88759;0;2020-06-17;374
2020-06-16;"Bratislavský kraj";0;0;0;0;NA;88759;0;2020-06-16;374
2020-06-14;"Bratislavský kraj";2;0;0;0;NA;88759;2;2020-06-14;374
2020-06-13;"Bratislavský kraj";1;0;0;0;NA;88759;1;2020-06-13;372
2020-06-12;"Bratislavský kraj";2;0;0;0;NA;88759;2;2020-06-12;371
2020-06-11;"Bratislavský kraj";0;0;0;0;NA;88759;0;2020-06-11;369
2020-06-10;"Bratislavský kraj";0;0;0;0;NA;88759;0;2020-06-10;369
2020-06-09;"Bratislavský kraj";0;0;0;0;NA;88759;0;2020-06-09;369
2020-06-08;"Bratislavský kraj";1;0;0;0;NA;88759;1;2020-06-08;369
2020-06-07;"Bratislavský kraj";0;0;0;0;NA;88759;0;2020-06-07;368
2020-06-05;"Bratislavský kraj";0;0;0;0;NA;88759;0;2020-06-05;368
2020-06-03;"Bratislavský kraj";1;0;0;0;NA;88759;1;2020-06-03;368
2020-06-02;"Bratislavský kraj";0;0;0;0;NA;88759;0;2020-06-02;367
2020-05-31;"Bratislavský kraj";0;0;0;0;NA;88759;0;2020-05-31;367
2020-05-29;"Bratislavský kraj";0;0;0;0;NA;88759;0;2020-05-29;367
2020-05-27;"Bratislavský kraj";1;0;0;0;NA;88759;1;2020-05-27;367
2020-05-26;"Bratislavský kraj";0;0;0;0;NA;88759;0;2020-05-26;366
2020-05-25;"Bratislavský kraj";0;0;0;0;NA;88759;0;2020-05-25;366
2020-05-24;"Bratislavský kraj";0;0;0;0;NA;88759;0;2020-05-24;366
2020-05-23;"Bratislavský kraj";2;0;0;0;NA;88759;2;2020-05-23;366
2020-05-22;"Bratislavský kraj";0;0;0;0;NA;88759;0;2020-05-22;364
2020-05-21;"Bratislavský kraj";0;0;0;0;NA;88759;0;2020-05-21;364
2020-05-20;"Bratislavský kraj";0;0;0;0;NA;88759;0;2020-05-20;364
2020-05-19;"Bratislavský kraj";0;0;0;0;NA;88759;0;2020-05-19;364
2020-05-17;"Bratislavský kraj";0;0;0;0;NA;88759;0;2020-05-17;364
2020-05-16;"Bratislavský kraj";0;0;0;0;NA;88759;0;2020-05-16;364
2020-05-15;"Bratislavský kraj";0;0;0;0;NA;88759;0;2020-05-15;364
2020-05-14;"Bratislavský kraj";0;0;0;0;NA;88759;0;2020-05-14;364
2020-05-13;"Bratislavský kraj";0;0;0;0;NA;88759;0;2020-05-13;364
2020-05-12;"Bratislavský kraj";2;0;0;0;NA;88759;2;2020-05-12;364
2020-05-11;"Bratislavský kraj";0;0;0;0;NA;88759;0;2020-05-11;362
2020-05-09;"Bratislavský kraj";0;0;0;0;NA;88759;0;2020-05-09;362
2020-05-07;"Bratislavský kraj";1;0;0;0;NA;88759;1;2020-05-07;362
2020-05-06;"Bratislavský kraj";3;0;0;0;NA;88759;3;2020-05-06;361
2020-05-05;"Bratislavský kraj";0;0;0;0;NA;88759;0;2020-05-05;358
2020-05-04;"Bratislavský kraj";0;0;0;0;NA;88759;0;2020-05-04;358
2020-05-03;"Bratislavský kraj";2;0;0;0;NA;88759;2;2020-05-03;358
2020-05-02;"Bratislavský kraj";0;0;0;0;NA;88759;0;2020-05-02;356
2020-05-01;"Bratislavský kraj";0;0;0;0;NA;88759;0;2020-05-01;356
2020-04-30;"Bratislavský kraj";5;0;0;0;NA;88759;5;2020-04-30;356
2020-04-29;"Bratislavský kraj";0;0;0;0;NA;88759;0;2020-04-29;351
2020-04-28;"Bratislavský kraj";2;0;0;0;NA;88759;2;2020-04-28;351
2020-04-27;"Bratislavský kraj";0;0;0;0;NA;88759;0;2020-04-27;349
2020-04-26;"Bratislavský kraj";1;0;0;0;NA;88759;1;2020-04-26;349
2020-04-25;"Bratislavský kraj";0;0;0;0;NA;88759;0;2020-04-25;348
2020-04-24;"Bratislavský kraj";2;0;0;0;NA;88759;2;2020-04-24;348
2020-04-23;"Bratislavský kraj";6;0;0;0;NA;88759;6;2020-04-23;346
2020-04-22;"Bratislavský kraj";11;0;0;0;NA;88759;11;2020-04-22;340
2020-04-21;"Bratislavský kraj";4;0;0;0;NA;88759;4;2020-04-21;329
2020-04-20;"Bratislavský kraj";0;0;0;0;NA;88759;0;2020-04-20;325
2020-04-19;"Bratislavský kraj";4;0;0;0;NA;88759;4;2020-04-19;325
2020-04-18;"Bratislavský kraj";5;0;0;0;NA;88759;5;2020-04-18;321
2020-04-17;"Bratislavský kraj";6;0;0;0;NA;88759;6;2020-04-17;316
2020-04-16;"Bratislavský kraj";15;0;0;0;NA;88759;15;2020-04-16;310
2020-04-15;"Bratislavský kraj";11;0;0;0;NA;88759;11;2020-04-15;295
2020-04-14;"Bratislavský kraj";19;0;0;0;NA;88759;19;2020-04-14;284
2020-04-13;"Bratislavský kraj";53;0;0;0;NA;88759;53;2020-04-13;265
2020-04-12;"Bratislavský kraj";3;0;0;0;NA;88759;3;2020-04-12;212
2020-04-11;"Bratislavský kraj";1;0;0;0;NA;88759;1;2020-04-11;209
2020-04-10;"Bratislavský kraj";8;0;0;0;NA;88759;8;2020-04-10;208
2020-04-09;"Bratislavský kraj";3;0;0;0;NA;88759;3;2020-04-09;200
2020-04-08;"Bratislavský kraj";3;0;0;0;NA;88759;3;2020-04-08;197
2020-04-07;"Bratislavský kraj";24;0;0;0;NA;88759;24;2020-04-07;194
2020-04-06;"Bratislavský kraj";5;0;0;0;NA;88759;5;2020-04-06;170
2020-04-05;"Bratislavský kraj";6;0;0;0;NA;88759;6;2020-04-05;165
2020-04-04;"Bratislavský kraj";2;0;0;0;NA;88759;2;2020-04-04;159
2020-04-03;"Bratislavský kraj";1;0;0;0;NA;88759;1;2020-04-03;157
2020-04-02;"Bratislavský kraj";2;0;0;0;NA;88759;2;2020-04-02;156
2020-04-01;"Bratislavský kraj";5;0;0;0;NA;88759;5;2020-04-01;154
2020-03-31;"Bratislavský kraj";19;0;0;0;NA;88759;19;2020-03-31;149
2020-03-30;"Bratislavský kraj";6;0;0;0;NA;88759;6;2020-03-30;130
2020-03-29;"Bratislavský kraj";8;0;0;0;NA;88759;8;2020-03-29;124
2020-03-28;"Bratislavský kraj";4;0;0;0;NA;88759;4;2020-03-28;116
2020-03-27;"Bratislavský kraj";3;0;0;0;NA;88759;3;2020-03-27;112
2020-03-26;"Bratislavský kraj";15;0;0;0;NA;88759;15;2020-03-26;109
2020-03-25;"Bratislavský kraj";1;0;0;0;NA;88759;1;2020-03-25;94
2020-03-24;"Bratislavský kraj";4;0;0;0;NA;88759;4;2020-03-24;93
2020-03-23;"Bratislavský kraj";9;0;0;0;NA;88759;9;2020-03-23;89
2020-03-22;"Bratislavský kraj";2;0;0;0;NA;88759;2;2020-03-22;80
2020-03-21;"Bratislavský kraj";22;0;0;0;NA;88759;22;2020-03-21;78
2020-03-20;"Bratislavský kraj";3;0;0;0;NA;88759;3;2020-03-20;56
2020-03-19;"Bratislavský kraj";4;0;0;0;NA;88759;4;2020-03-19;53
2020-03-18;"Bratislavský kraj";3;0;0;0;NA;88759;3;2020-03-18;49
2020-03-17;"Bratislavský kraj";13;0;0;0;NA;88759;13;2020-03-17;46
2020-03-16;"Bratislavský kraj";1;0;0;0;NA;88759;1;2020-03-16;33
2020-03-15;"Bratislavský kraj";4;0;0;0;NA;88759;4;2020-03-15;32
2020-03-14;"Bratislavský kraj";9;0;0;0;NA;88759;9;2020-03-14;28
2020-03-13;"Bratislavský kraj";2;0;0;0;NA;88759;2;2020-03-13;19
2020-03-12;"Bratislavský kraj";8;0;0;0;NA;88759;8;2020-03-12;17
2020-03-11;"Bratislavský kraj";3;0;0;0;NA;88759;3;2020-03-11;9
2020-03-09;"Bratislavský kraj";0;0;0;0;NA;88759;0;2020-03-09;6
2020-03-08;"Bratislavský kraj";2;0;0;0;NA;88759;2;2020-03-08;6
2020-03-07;"Bratislavský kraj";2;0;0;0;NA;88759;2;2020-03-07;4
2020-03-06;"Bratislavský kraj";1;0;0;0;NA;88759;1;2020-03-06;2
2021-04-29;"Košický kraj";76;14300;148;14448;51395;94924;224;2021-04-29;94924
2021-04-28;"Košický kraj";99;16912;85;16997;NA;94924;184;2021-04-28;94700
2021-04-27;"Košický kraj";108;19853;42;19895;NA;94924;150;2021-04-27;94516
2021-04-26;"Košický kraj";39;25474;89;25563;NA;94924;128;2021-04-26;94366
2021-04-25;"Košický kraj";23;48357;57;48414;NA;94924;80;2021-04-25;94238
2021-04-24;"Košický kraj";68;89281;114;89395;NA;94924;182;2021-04-24;94158
2021-04-23;"Košický kraj";110;41290;75;41365;NA;94924;185;2021-04-23;93976
2021-04-22;"Košický kraj";56;16166;42;16208;NA;94924;98;2021-04-22;93791
2021-04-21;"Košický kraj";114;19533;61;19594;NA;94924;175;2021-04-21;93693
2021-04-20;"Košický kraj";81;25523;63;25586;NA;94924;144;2021-04-20;93518
2021-04-19;"Košický kraj";93;29789;107;29896;NA;94924;200;2021-04-19;93374
2021-04-18;"Košický kraj";10;48982;77;49059;NA;94924;87;2021-04-18;93174
2021-04-17;"Košický kraj";187;83867;103;83970;NA;94924;290;2021-04-17;93087
2021-04-16;"Košický kraj";83;41494;128;41622;NA;94924;211;2021-04-16;92797
2021-04-15;"Košický kraj";104;18537;93;18630;NA;94924;197;2021-04-15;92586
2021-04-14;"Košický kraj";119;20081;64;20145;NA;94924;183;2021-04-14;92389
2021-04-13;"Košický kraj";81;23248;120;23368;NA;94924;201;2021-04-13;92206
2021-04-12;"Košický kraj";129;26399;123;26522;NA;94924;252;2021-04-12;92005
2021-04-11;"Košický kraj";29;46916;79;46995;NA;94924;108;2021-04-11;91753
2021-04-10;"Košický kraj";138;99886;187;100073;NA;94924;325;2021-04-10;91645
2021-04-09;"Košický kraj";168;35305;130;35435;NA;94924;298;2021-04-09;91320
2021-04-08;"Košický kraj";81;18623;90;18713;NA;94924;171;2021-04-08;91022
2021-04-07;"Košický kraj";232;28031;195;28226;NA;94924;427;2021-04-07;90851
2021-04-06;"Košický kraj";121;36474;163;36637;NA;94924;284;2021-04-06;90424
2021-04-05;"Košický kraj";19;14347;65;14412;NA;94924;84;2021-04-05;90140
2021-04-04;"Košický kraj";33;15171;68;15239;NA;94924;101;2021-04-04;90056
2021-04-03;"Košický kraj";138;96413;238;96651;NA;94924;376;2021-04-03;89955
2021-04-02;"Košický kraj";128;24389;86;24475;NA;94924;214;2021-04-02;89579
2021-04-01;"Košický kraj";165;46076;146;46222;NA;94924;311;2021-04-01;89365
2021-03-31;"Košický kraj";160;29808;127;29935;NA;94924;287;2021-03-31;89054
2021-03-30;"Košický kraj";229;24108;163;24271;NA;94924;392;2021-03-30;88767
2021-03-29;"Košický kraj";78;28727;192;28919;NA;94924;270;2021-03-29;88375
2021-03-28;"Košický kraj";39;44263;128;44391;NA;94924;167;2021-03-28;88105
2021-03-27;"Košický kraj";222;96635;267;96902;NA;94924;489;2021-03-27;87938
2021-03-26;"Košický kraj";233;45262;202;45464;NA;94924;435;2021-03-26;87449
2021-03-25;"Košický kraj";133;23789;174;23963;NA;94924;307;2021-03-25;87014
2021-03-24;"Košický kraj";165;20685;157;20842;NA;94924;322;2021-03-24;86707
2021-03-23;"Košický kraj";202;22480;190;22670;NA;94924;392;2021-03-23;86385
2021-03-22;"Košický kraj";169;26742;227;26969;NA;94924;396;2021-03-22;85993
2021-03-21;"Košický kraj";109;46792;167;46959;NA;94924;276;2021-03-21;85597
2021-03-20;"Košický kraj";126;101376;315;101691;NA;94924;441;2021-03-20;85321
2021-03-19;"Košický kraj";205;45707;258;45965;NA;94924;463;2021-03-19;84880
2021-03-18;"Košický kraj";274;23831;211;24042;NA;94924;485;2021-03-18;84417
2021-03-17;"Košický kraj";177;21559;197;21756;NA;94924;374;2021-03-17;83932
2021-03-16;"Košický kraj";386;23431;226;23657;NA;94924;612;2021-03-16;83558
2021-03-15;"Košický kraj";173;27796;294;28090;NA;94924;467;2021-03-15;82946
2021-03-14;"Košický kraj";145;44419;226;44645;NA;94924;371;2021-03-14;82479
2021-03-13;"Košický kraj";146;103822;480;104302;NA;94924;626;2021-03-13;82108
2021-03-12;"Košický kraj";366;47839;322;48161;NA;94924;688;2021-03-12;81482
2021-03-11;"Košický kraj";396;23225;261;23486;NA;94924;657;2021-03-11;80794
2021-03-10;"Košický kraj";121;22199;268;22467;NA;94924;389;2021-03-10;80137
2021-03-09;"Košický kraj";676;24524;301;24825;NA;94924;977;2021-03-09;79748
2021-03-08;"Košický kraj";559;29679;342;30021;NA;94924;901;2021-03-08;78771
2021-03-07;"Košický kraj";45;44273;299;44572;NA;94924;344;2021-03-07;77870
2021-03-06;"Košický kraj";177;105659;536;106195;NA;94924;713;2021-03-06;77526
2021-03-05;"Košický kraj";439;45564;422;45986;NA;94924;861;2021-03-05;76813
2021-03-04;"Košický kraj";417;23862;321;24183;NA;94924;738;2021-03-04;75952
2021-03-03;"Košický kraj";390;23141;297;23438;NA;94924;687;2021-03-03;75214
2021-03-02;"Košický kraj";464;24158;372;24530;NA;94924;836;2021-03-02;74527
2021-03-01;"Košický kraj";389;29980;512;30492;NA;94924;901;2021-03-01;73691
2021-02-28;"Košický kraj";265;43053;334;43387;NA;94924;599;2021-02-28;72790
2021-02-27;"Košický kraj";301;101274;787;102061;NA;94924;1088;2021-02-27;72191
2021-02-26;"Košický kraj";440;45466;492;45958;NA;94924;932;2021-02-26;71103
2021-02-25;"Košický kraj";331;19872;342;20214;NA;94924;673;2021-02-25;70171
2021-02-24;"Košický kraj";263;18815;506;19321;NA;94924;769;2021-02-24;69498
2021-02-23;"Košický kraj";642;21592;341;21933;NA;94924;983;2021-02-23;68729
2021-02-22;"Košický kraj";362;30830;434;31264;NA;94924;796;2021-02-22;67746
2021-02-21;"Košický kraj";170;40464;385;40849;NA;94924;555;2021-02-21;66950
2021-02-20;"Košický kraj";283;92550;770;93320;NA;94924;1053;2021-02-20;66395
2021-02-19;"Košický kraj";507;42016;586;42602;NA;94924;1093;2021-02-19;65342
2021-02-18;"Košický kraj";397;18442;345;18787;NA;94924;742;2021-02-18;64249
2021-02-17;"Košický kraj";322;18080;387;18467;NA;94924;709;2021-02-17;63507
2021-02-16;"Košický kraj";600;22137;463;22600;NA;94924;1063;2021-02-16;62798
2021-02-15;"Košický kraj";216;27633;419;28052;NA;94924;635;2021-02-15;61735
2021-02-14;"Košický kraj";241;56743;524;57267;NA;94924;765;2021-02-14;61100
2021-02-13;"Košický kraj";206;93779;765;94544;NA;94924;971;2021-02-13;60335
2021-02-12;"Košický kraj";448;50184;611;50795;NA;94924;1059;2021-02-12;59364
2021-02-11;"Košický kraj";435;14524;323;14847;NA;94924;758;2021-02-11;58305
2021-02-10;"Košický kraj";360;18475;431;18906;NA;94924;791;2021-02-10;57547
2021-02-09;"Košický kraj";545;24841;463;25304;NA;94924;1008;2021-02-09;56756
2021-02-08;"Košický kraj";237;24836;392;25228;NA;94924;629;2021-02-08;55748
2021-02-07;"Košický kraj";208;56897;612;57509;NA;94924;820;2021-02-07;55119
2021-02-06;"Košický kraj";318;104357;884;105241;NA;94924;1202;2021-02-06;54299
2021-02-05;"Košický kraj";384;43186;494;43680;NA;94924;878;2021-02-05;53097
2021-02-04;"Košický kraj";391;14508;371;14879;NA;94924;762;2021-02-04;52219
2021-02-03;"Košický kraj";296;12599;339;12938;NA;94924;635;2021-02-03;51457
2021-02-02;"Košický kraj";473;43883;1212;45095;NA;94924;1685;2021-02-02;50822
2021-02-01;"Košický kraj";415;21965;362;22327;NA;94924;777;2021-02-01;49137
2021-01-31;"Košický kraj";142;54154;609;54763;NA;94924;751;2021-01-31;48360
2021-01-30;"Košický kraj";320;76925;665;77590;NA;94924;985;2021-01-30;47609
2021-01-29;"Košický kraj";311;37130;466;37596;NA;94924;777;2021-01-29;46624
2021-01-28;"Košický kraj";540;9006;244;9250;NA;94924;784;2021-01-28;45847
2021-01-27;"Košický kraj";265;7575;211;7786;NA;94924;476;2021-01-27;45063
2021-01-26;"Košický kraj";530;14256;246;14502;NA;94924;776;2021-01-26;44587
2021-01-25;"Košický kraj";226;26430;413;26843;NA;94924;639;2021-01-25;43811
2021-01-24;"Košický kraj";150;44419;581;45000;NA;94924;731;2021-01-24;43172
2021-01-23;"Košický kraj";232;82705;857;83562;NA;94924;1089;2021-01-23;42441
2021-01-22;"Košický kraj";316;19993;265;20258;NA;94924;581;2021-01-22;41352
2021-01-21;"Košický kraj";274;14047;158;14205;NA;94924;432;2021-01-21;40771
2021-01-20;"Košický kraj";374;10843;201;11044;NA;94924;575;2021-01-20;40339
2021-01-19;"Košický kraj";248;9717;181;9898;NA;94924;429;2021-01-19;39764
2021-01-18;"Košický kraj";333;7659;262;7921;NA;94924;595;2021-01-18;39335
2021-01-17;"Košický kraj";155;535;14;549;NA;94924;169;2021-01-17;38740
2021-01-16;"Košický kraj";153;1403;47;1450;NA;94924;200;2021-01-16;38571
2021-01-15;"Košický kraj";308;6443;213;6656;NA;94924;521;2021-01-15;38371
2021-01-14;"Košický kraj";358;5471;221;5692;NA;94924;579;2021-01-14;37850
2021-01-13;"Košický kraj";421;4897;226;5123;NA;94924;647;2021-01-13;37271
2021-01-12;"Košický kraj";482;6689;258;6947;NA;94924;740;2021-01-12;36624
2021-01-11;"Košický kraj";309;7945;304;8249;NA;94924;613;2021-01-11;35884
2021-01-10;"Košický kraj";193;136;6;142;NA;94924;199;2021-01-10;35271
2021-01-09;"Košický kraj";469;1134;45;1179;NA;94924;514;2021-01-09;35072
2021-01-08;"Košický kraj";551;8222;388;8610;NA;94924;939;2021-01-08;34558
2021-01-07;"Košický kraj";251;6566;434;7000;NA;94924;685;2021-01-07;33619
2021-01-06;"Košický kraj";442;429;33;462;NA;94924;475;2021-01-06;32934
2021-01-05;"Košický kraj";584;8100;560;8660;NA;94924;1144;2021-01-05;32459
2021-01-04;"Košický kraj";407;7113;737;7850;NA;94924;1144;2021-01-04;31315
2021-01-03;"Košický kraj";118;661;22;683;NA;94924;140;2021-01-03;30171
2021-01-02;"Košický kraj";88;440;52;492;NA;94924;140;2021-01-02;30031
2021-01-01;"Košický kraj";398;725;49;774;NA;94924;447;2021-01-01;29891
2020-12-31;"Košický kraj";625;7877;461;8338;NA;94924;1086;2020-12-31;29444
2020-12-30;"Košický kraj";590;6477;412;6889;NA;94924;1002;2020-12-30;28358
2020-12-29;"Košický kraj";419;7573;605;8178;NA;94924;1024;2020-12-29;27356
2020-12-28;"Košický kraj";356;8296;804;9100;NA;94924;1160;2020-12-28;26332
2020-12-27;"Košický kraj";159;147;16;163;NA;94924;175;2020-12-27;25172
2020-12-26;"Košický kraj";163;274;23;297;NA;94924;186;2020-12-26;24997
2020-12-25;"Košický kraj";237;140;10;150;NA;94924;247;2020-12-25;24811
2020-12-24;"Košický kraj";564;1470;90;1560;NA;94924;654;2020-12-24;24564
2020-12-23;"Košický kraj";304;7942;354;8296;NA;94924;658;2020-12-23;23910
2020-12-22;"Košický kraj";438;7920;459;8379;NA;94924;897;2020-12-22;23252
2020-12-21;"Košický kraj";405;6984;509;7493;NA;94924;914;2020-12-21;22355
2020-12-20;"Košický kraj";215;73;11;84;NA;94924;226;2020-12-20;21441
2020-12-19;"Košický kraj";207;1309;63;1372;NA;94924;270;2020-12-19;21215
2020-12-18;"Košický kraj";310;8484;326;8810;NA;94924;636;2020-12-18;20945
2020-12-17;"Košický kraj";463;5292;255;5547;NA;94924;718;2020-12-17;20309
2020-12-16;"Košický kraj";455;5898;316;6214;NA;94924;771;2020-12-16;19591
2020-12-15;"Košický kraj";319;5086;338;5424;NA;94924;657;2020-12-15;18820
2020-12-14;"Košický kraj";256;3401;264;3665;NA;94924;520;2020-12-14;18163
2020-12-13;"Košický kraj";47;181;2;183;NA;94924;49;2020-12-13;17643
2020-12-12;"Košický kraj";369;1587;118;1705;NA;94924;487;2020-12-12;17594
2020-12-11;"Košický kraj";354;5461;258;5719;NA;94924;612;2020-12-11;17107
2020-12-10;"Košický kraj";283;4064;176;4240;NA;94924;459;2020-12-10;16495
2020-12-09;"Košický kraj";279;3786;166;3952;NA;94924;445;2020-12-09;16036
2020-12-08;"Košický kraj";226;4105;355;4460;NA;94924;581;2020-12-08;15591
2020-12-07;"Košický kraj";270;2383;106;2489;NA;94924;376;2020-12-07;15010
2020-12-06;"Košický kraj";121;97;20;117;NA;94924;141;2020-12-06;14634
2020-12-05;"Košický kraj";90;1096;48;1144;NA;94924;138;2020-12-05;14493
2020-12-04;"Košický kraj";224;2680;82;2762;NA;94924;306;2020-12-04;14355
2020-12-03;"Košický kraj";211;7717;173;7890;NA;94924;384;2020-12-03;14049
2020-12-02;"Košický kraj";193;8132;496;8628;NA;94924;689;2020-12-02;13665
2020-12-01;"Košický kraj";178;2237;124;2361;NA;94924;302;2020-12-01;12976
2020-11-30;"Košický kraj";171;3645;58;3703;NA;94924;229;2020-11-30;12674
2020-11-29;"Košický kraj";31;325;17;342;NA;94924;48;2020-11-29;12445
2020-11-28;"Košický kraj";69;721;52;773;NA;94924;121;2020-11-28;12397
2020-11-27;"Košický kraj";149;2921;78;2999;NA;94924;227;2020-11-27;12276
2020-11-26;"Košický kraj";239;1234;60;1294;NA;94924;299;2020-11-26;12049
2020-11-25;"Košický kraj";237;1785;123;1908;NA;94924;360;2020-11-25;11750
2020-11-24;"Košický kraj";196;1976;67;2043;NA;94924;263;2020-11-24;11390
2020-11-23;"Košický kraj";51;4115;63;4178;NA;94924;114;2020-11-23;11127
2020-11-22;"Košický kraj";57;57;5;62;NA;94924;62;2020-11-22;11013
2020-11-21;"Košický kraj";87;858;36;894;NA;94924;123;2020-11-21;10951
2020-11-20;"Košický kraj";176;3084;49;3133;NA;94924;225;2020-11-20;10828
2020-11-19;"Košický kraj";206;1736;48;1784;NA;94924;254;2020-11-19;10603
2020-11-18;"Košický kraj";122;532;17;549;NA;94924;139;2020-11-18;10349
2020-11-17;"Košický kraj";152;82;9;91;NA;94924;161;2020-11-17;10210
2020-11-16;"Košický kraj";114;596;27;623;NA;94924;141;2020-11-16;10049
2020-11-15;"Košický kraj";15;338;7;345;NA;94924;22;2020-11-15;9908
2020-11-14;"Košický kraj";234;520;12;532;NA;94924;246;2020-11-14;9886
2020-11-13;"Košický kraj";207;664;29;693;NA;94924;236;2020-11-13;9640
2020-11-12;"Košický kraj";192;736;13;749;NA;94924;205;2020-11-12;9404
2020-11-11;"Košický kraj";301;593;7;600;NA;94924;308;2020-11-11;9199
2020-11-10;"Košický kraj";190;541;11;552;NA;94924;201;2020-11-10;8891
2020-11-09;"Košický kraj";129;380;17;397;NA;94924;146;2020-11-09;8690
2020-11-08;"Košický kraj";78;1306;8;1314;NA;94924;86;2020-11-08;8544
2020-11-07;"Košický kraj";192;3909;22;3931;NA;94924;214;2020-11-07;8458
2020-11-06;"Košický kraj";195;5310;34;5344;NA;94924;229;2020-11-06;8244
2020-11-05;"Košický kraj";342;330;31;361;NA;94924;373;2020-11-05;8015
2020-11-04;"Košický kraj";101;154;6;160;NA;94924;107;2020-11-04;7642
2020-11-03;"Košický kraj";358;1122;13;1135;NA;94924;371;2020-11-03;7535
2020-11-02;"Košický kraj";111;6125;56;6181;NA;94924;167;2020-11-02;7164
2020-11-01;"Košický kraj";346;6522;34;6556;NA;94924;380;2020-11-01;6997
2020-10-31;"Košický kraj";82;14035;106;14141;NA;94924;188;2020-10-31;6617
2020-10-30;"Košický kraj";379;2835;27;2862;NA;94924;406;2020-10-30;6429
2020-10-29;"Košický kraj";333;983;13;996;NA;94924;346;2020-10-29;6023
2020-10-28;"Košický kraj";224;305;13;318;NA;94924;237;2020-10-28;5677
2020-10-27;"Košický kraj";386;439;21;460;NA;94924;407;2020-10-27;5440
2020-10-26;"Košický kraj";56;227;12;239;NA;94924;68;2020-10-26;5033
2020-10-25;"Košický kraj";154;79;2;81;NA;94924;156;2020-10-25;4965
2020-10-24;"Košický kraj";313;118;16;134;NA;94924;329;2020-10-24;4809
2020-10-23;"Košický kraj";315;331;8;339;NA;94924;323;2020-10-23;4480
2020-10-22;"Košický kraj";349;530;16;546;NA;94924;365;2020-10-22;4157
2020-10-21;"Košický kraj";129;84;2;86;NA;94924;131;2020-10-21;3792
2020-10-20;"Košický kraj";181;14;1;15;NA;94924;182;2020-10-20;3661
2020-10-19;"Košický kraj";64;38;1;39;NA;94924;65;2020-10-19;3479
2020-10-18;"Košický kraj";158;0;0;0;NA;94924;158;2020-10-18;3414
2020-10-17;"Košický kraj";142;0;0;0;NA;94924;142;2020-10-17;3256
2020-10-16;"Košický kraj";206;19;0;19;NA;94924;206;2020-10-16;3114
2020-10-15;"Košický kraj";177;19;5;24;NA;94924;182;2020-10-15;2908
2020-10-14;"Košický kraj";211;8;0;8;NA;94924;211;2020-10-14;2726
2020-10-13;"Košický kraj";179;80;3;83;NA;94924;182;2020-10-13;2515
2020-10-12;"Košický kraj";74;0;0;0;NA;94924;74;2020-10-12;2333
2020-10-11;"Košický kraj";121;0;0;0;NA;94924;121;2020-10-11;2259
2020-10-10;"Košický kraj";70;0;0;0;NA;94924;70;2020-10-10;2138
2020-10-09;"Košický kraj";188;0;0;0;NA;94924;188;2020-10-09;2068
2020-10-08;"Košický kraj";102;0;0;0;NA;94924;102;2020-10-08;1880
2020-10-07;"Košický kraj";158;0;0;0;NA;94924;158;2020-10-07;1778
2020-10-06;"Košický kraj";70;0;0;0;NA;94924;70;2020-10-06;1620
2020-10-05;"Košický kraj";39;0;0;0;NA;94924;39;2020-10-05;1550
2020-10-04;"Košický kraj";45;0;0;0;NA;94924;45;2020-10-04;1511
2020-10-03;"Košický kraj";105;0;0;0;NA;94924;105;2020-10-03;1466
2020-10-02;"Košický kraj";57;0;0;0;NA;94924;57;2020-10-02;1361
2020-10-01;"Košický kraj";69;0;0;0;NA;94924;69;2020-10-01;1304
2020-09-30;"Košický kraj";95;0;0;0;NA;94924;95;2020-09-30;1235
2020-09-29;"Košický kraj";75;0;0;0;NA;94924;75;2020-09-29;1140
2020-09-28;"Košický kraj";19;0;0;0;NA;94924;19;2020-09-28;1065
2020-09-27;"Košický kraj";21;0;0;0;NA;94924;21;2020-09-27;1046
2020-09-26;"Košický kraj";53;0;0;0;NA;94924;53;2020-09-26;1025
2020-09-25;"Košický kraj";72;0;0;0;NA;94924;72;2020-09-25;972
2020-09-24;"Košický kraj";35;0;0;0;NA;94924;35;2020-09-24;900
2020-09-23;"Košický kraj";23;0;0;0;NA;94924;23;2020-09-23;865
2020-09-22;"Košický kraj";39;0;0;0;NA;94924;39;2020-09-22;842
2020-09-21;"Košický kraj";5;0;0;0;NA;94924;5;2020-09-21;803
2020-09-20;"Košický kraj";3;0;0;0;NA;94924;3;2020-09-20;798
2020-09-19;"Košický kraj";13;0;0;0;NA;94924;13;2020-09-19;795
2020-09-18;"Košický kraj";20;0;0;0;NA;94924;20;2020-09-18;782
2020-09-17;"Košický kraj";22;0;0;0;NA;94924;22;2020-09-17;762
2020-09-16;"Košický kraj";12;0;0;0;NA;94924;12;2020-09-16;740
2020-09-15;"Košický kraj";10;0;0;0;NA;94924;10;2020-09-15;728
2020-09-14;"Košický kraj";6;0;0;0;NA;94924;6;2020-09-14;718
2020-09-13;"Košický kraj";3;0;0;0;NA;94924;3;2020-09-13;712
2020-09-12;"Košický kraj";16;0;0;0;NA;94924;16;2020-09-12;709
2020-09-11;"Košický kraj";20;0;0;0;NA;94924;20;2020-09-11;693
2020-09-10;"Košický kraj";11;0;0;0;NA;94924;11;2020-09-10;673
2020-09-09;"Košický kraj";37;0;0;0;NA;94924;37;2020-09-09;662
2020-09-08;"Košický kraj";10;0;0;0;NA;94924;10;2020-09-08;625
2020-09-07;"Košický kraj";4;0;0;0;NA;94924;4;2020-09-07;615
2020-09-06;"Košický kraj";2;0;0;0;NA;94924;2;2020-09-06;611
2020-09-05;"Košický kraj";10;0;0;0;NA;94924;10;2020-09-05;609
2020-09-04;"Košický kraj";14;0;0;0;NA;94924;14;2020-09-04;599
2020-09-03;"Košický kraj";22;0;0;0;NA;94924;22;2020-09-03;585
2020-09-02;"Košický kraj";13;0;0;0;NA;94924;13;2020-09-02;563
2020-09-01;"Košický kraj";21;0;0;0;NA;94924;21;2020-09-01;550
2020-08-31;"Košický kraj";9;0;0;0;NA;94924;9;2020-08-31;529
2020-08-30;"Košický kraj";21;0;0;0;NA;94924;21;2020-08-30;520
2020-08-29;"Košický kraj";1;0;0;0;NA;94924;1;2020-08-29;499
2020-08-28;"Košický kraj";19;0;0;0;NA;94924;19;2020-08-28;498
2020-08-27;"Košický kraj";15;0;0;0;NA;94924;15;2020-08-27;479
2020-08-26;"Košický kraj";8;0;0;0;NA;94924;8;2020-08-26;464
2020-08-25;"Košický kraj";23;0;0;0;NA;94924;23;2020-08-25;456
2020-08-24;"Košický kraj";6;0;0;0;NA;94924;6;2020-08-24;433
2020-08-23;"Košický kraj";8;0;0;0;NA;94924;8;2020-08-23;427
2020-08-22;"Košický kraj";13;0;0;0;NA;94924;13;2020-08-22;419
2020-08-21;"Košický kraj";10;0;0;0;NA;94924;10;2020-08-21;406
2020-08-20;"Košický kraj";10;0;0;0;NA;94924;10;2020-08-20;396
2020-08-19;"Košický kraj";3;0;0;0;NA;94924;3;2020-08-19;386
2020-08-18;"Košický kraj";7;0;0;0;NA;94924;7;2020-08-18;383
2020-08-17;"Košický kraj";2;0;0;0;NA;94924;2;2020-08-17;376
2020-08-16;"Košický kraj";2;0;0;0;NA;94924;2;2020-08-16;374
2020-08-15;"Košický kraj";3;0;0;0;NA;94924;3;2020-08-15;372
2020-08-14;"Košický kraj";1;0;0;0;NA;94924;1;2020-08-14;369
2020-08-13;"Košický kraj";3;0;0;0;NA;94924;3;2020-08-13;368
2020-08-12;"Košický kraj";12;0;0;0;NA;94924;12;2020-08-12;365
2020-08-11;"Košický kraj";5;0;0;0;NA;94924;5;2020-08-11;353
2020-08-10;"Košický kraj";1;0;0;0;NA;94924;1;2020-08-10;348
2020-08-09;"Košický kraj";0;0;0;0;NA;94924;0;2020-08-09;347
2020-08-08;"Košický kraj";5;0;0;0;NA;94924;5;2020-08-08;347
2020-08-07;"Košický kraj";7;0;0;0;NA;94924;7;2020-08-07;342
2020-08-06;"Košický kraj";3;0;0;0;NA;94924;3;2020-08-06;335
2020-08-05;"Košický kraj";4;0;0;0;NA;94924;4;2020-08-05;332
2020-08-04;"Košický kraj";1;0;0;0;NA;94924;1;2020-08-04;328
2020-08-03;"Košický kraj";1;0;0;0;NA;94924;1;2020-08-03;327
2020-08-02;"Košický kraj";0;0;0;0;NA;94924;0;2020-08-02;326
2020-08-01;"Košický kraj";0;0;0;0;NA;94924;0;2020-08-01;326
2020-07-31;"Košický kraj";0;0;0;0;NA;94924;0;2020-07-31;326
2020-07-30;"Košický kraj";2;0;0;0;NA;94924;2;2020-07-30;326
2020-07-29;"Košický kraj";1;0;0;0;NA;94924;1;2020-07-29;324
2020-07-28;"Košický kraj";9;0;0;0;NA;94924;9;2020-07-28;323
2020-07-27;"Košický kraj";4;0;0;0;NA;94924;4;2020-07-27;314
2020-07-26;"Košický kraj";0;0;0;0;NA;94924;0;2020-07-26;310
2020-07-25;"Košický kraj";2;0;0;0;NA;94924;2;2020-07-25;310
2020-07-24;"Košický kraj";2;0;0;0;NA;94924;2;2020-07-24;308
2020-07-23;"Košický kraj";1;0;0;0;NA;94924;1;2020-07-23;306
2020-07-22;"Košický kraj";1;0;0;0;NA;94924;1;2020-07-22;305
2020-07-21;"Košický kraj";0;0;0;0;NA;94924;0;2020-07-21;304
2020-07-20;"Košický kraj";0;0;0;0;NA;94924;0;2020-07-20;304
2020-07-19;"Košický kraj";0;0;0;0;NA;94924;0;2020-07-19;304
2020-07-18;"Košický kraj";1;0;0;0;NA;94924;1;2020-07-18;304
2020-07-17;"Košický kraj";1;0;0;0;NA;94924;1;2020-07-17;303
2020-07-16;"Košický kraj";0;0;0;0;NA;94924;0;2020-07-16;302
2020-07-15;"Košický kraj";2;0;0;0;NA;94924;2;2020-07-15;302
2020-07-14;"Košický kraj";1;0;0;0;NA;94924;1;2020-07-14;300
2020-07-13;"Košický kraj";1;0;0;0;NA;94924;1;2020-07-13;299
2020-07-12;"Košický kraj";0;0;0;0;NA;94924;0;2020-07-12;298
2020-07-11;"Košický kraj";0;0;0;0;NA;94924;0;2020-07-11;298
2020-07-10;"Košický kraj";1;0;0;0;NA;94924;1;2020-07-10;298
2020-07-09;"Košický kraj";1;0;0;0;NA;94924;1;2020-07-09;297
2020-07-08;"Košický kraj";12;0;0;0;NA;94924;12;2020-07-08;296
2020-07-07;"Košický kraj";0;0;0;0;NA;94924;0;2020-07-07;284
2020-07-06;"Košický kraj";0;0;0;0;NA;94924;0;2020-07-06;284
2020-07-05;"Košický kraj";0;0;0;0;NA;94924;0;2020-07-05;284
2020-07-04;"Košický kraj";0;0;0;0;NA;94924;0;2020-07-04;284
2020-07-03;"Košický kraj";1;0;0;0;NA;94924;1;2020-07-03;284
2020-07-02;"Košický kraj";0;0;0;0;NA;94924;0;2020-07-02;283
2020-07-01;"Košický kraj";1;0;0;0;NA;94924;1;2020-07-01;283
2020-06-30;"Košický kraj";0;0;0;0;NA;94924;0;2020-06-30;282
2020-06-29;"Košický kraj";0;0;0;0;NA;94924;0;2020-06-29;282
2020-06-28;"Košický kraj";0;0;0;0;NA;94924;0;2020-06-28;282
2020-06-27;"Košický kraj";0;0;0;0;NA;94924;0;2020-06-27;282
2020-06-26;"Košický kraj";0;0;0;0;NA;94924;0;2020-06-26;282
2020-06-25;"Košický kraj";3;0;0;0;NA;94924;3;2020-06-25;282
2020-06-24;"Košický kraj";3;0;0;0;NA;94924;3;2020-06-24;279
2020-06-23;"Košický kraj";3;0;0;0;NA;94924;3;2020-06-23;276
2020-06-22;"Košický kraj";0;0;0;0;NA;94924;0;2020-06-22;273
2020-06-21;"Košický kraj";0;0;0;0;NA;94924;0;2020-06-21;273
2020-06-20;"Košický kraj";0;0;0;0;NA;94924;0;2020-06-20;273
2020-06-19;"Košický kraj";0;0;0;0;NA;94924;0;2020-06-19;273
2020-06-18;"Košický kraj";1;0;0;0;NA;94924;1;2020-06-18;273
2020-06-17;"Košický kraj";0;0;0;0;NA;94924;0;2020-06-17;272
2020-06-16;"Košický kraj";2;0;0;0;NA;94924;2;2020-06-16;272
2020-06-14;"Košický kraj";0;0;0;0;NA;94924;0;2020-06-14;270
2020-06-13;"Košický kraj";0;0;0;0;NA;94924;0;2020-06-13;270
2020-06-12;"Košický kraj";0;0;0;0;NA;94924;0;2020-06-12;270
2020-06-11;"Košický kraj";0;0;0;0;NA;94924;0;2020-06-11;270
2020-06-10;"Košický kraj";6;0;0;0;NA;94924;6;2020-06-10;270
2020-06-09;"Košický kraj";0;0;0;0;NA;94924;0;2020-06-09;264
2020-06-08;"Košický kraj";0;0;0;0;NA;94924;0;2020-06-08;264
2020-06-07;"Košický kraj";2;0;0;0;NA;94924;2;2020-06-07;264
2020-06-05;"Košický kraj";0;0;0;0;NA;94924;0;2020-06-05;262
2020-06-03;"Košický kraj";0;0;0;0;NA;94924;0;2020-06-03;262
2020-06-02;"Košický kraj";1;0;0;0;NA;94924;1;2020-06-02;262
2020-05-31;"Košický kraj";0;0;0;0;NA;94924;0;2020-05-31;261
2020-05-29;"Košický kraj";1;0;0;0;NA;94924;1;2020-05-29;261
2020-05-27;"Košický kraj";0;0;0;0;NA;94924;0;2020-05-27;260
2020-05-26;"Košický kraj";1;0;0;0;NA;94924;1;2020-05-26;260
2020-05-25;"Košický kraj";1;0;0;0;NA;94924;1;2020-05-25;259
2020-05-24;"Košický kraj";0;0;0;0;NA;94924;0;2020-05-24;258
2020-05-23;"Košický kraj";0;0;0;0;NA;94924;0;2020-05-23;258
2020-05-22;"Košický kraj";0;0;0;0;NA;94924;0;2020-05-22;258
2020-05-21;"Košický kraj";0;0;0;0;NA;94924;0;2020-05-21;258
2020-05-20;"Košický kraj";3;0;0;0;NA;94924;3;2020-05-20;258
2020-05-19;"Košický kraj";0;0;0;0;NA;94924;0;2020-05-19;255
2020-05-17;"Košický kraj";1;0;0;0;NA;94924;1;2020-05-17;255
2020-05-16;"Košický kraj";1;0;0;0;NA;94924;1;2020-05-16;254
2020-05-15;"Košický kraj";10;0;0;0;NA;94924;10;2020-05-15;253
2020-05-14;"Košický kraj";1;0;0;0;NA;94924;1;2020-05-14;243
2020-05-13;"Košický kraj";6;0;0;0;NA;94924;6;2020-05-13;242
2020-05-12;"Košický kraj";0;0;0;0;NA;94924;0;2020-05-12;236
2020-05-11;"Košický kraj";0;0;0;0;NA;94924;0;2020-05-11;236
2020-05-09;"Košický kraj";0;0;0;0;NA;94924;0;2020-05-09;236
2020-05-07;"Košický kraj";0;0;0;0;NA;94924;0;2020-05-07;236
2020-05-06;"Košický kraj";1;0;0;0;NA;94924;1;2020-05-06;236
2020-05-05;"Košický kraj";0;0;0;0;NA;94924;0;2020-05-05;235
2020-05-04;"Košický kraj";0;0;0;0;NA;94924;0;2020-05-04;235
2020-05-03;"Košický kraj";0;0;0;0;NA;94924;0;2020-05-03;235
2020-05-02;"Košický kraj";1;0;0;0;NA;94924;1;2020-05-02;235
2020-05-01;"Košický kraj";0;0;0;0;NA;94924;0;2020-05-01;234
2020-04-30;"Košický kraj";1;0;0;0;NA;94924;1;2020-04-30;234
2020-04-29;"Košický kraj";1;0;0;0;NA;94924;1;2020-04-29;233
2020-04-28;"Košický kraj";1;0;0;0;NA;94924;1;2020-04-28;232
2020-04-27;"Košický kraj";1;0;0;0;NA;94924;1;2020-04-27;231
2020-04-26;"Košický kraj";0;0;0;0;NA;94924;0;2020-04-26;230
2020-04-25;"Košický kraj";0;0;0;0;NA;94924;0;2020-04-25;230
2020-04-24;"Košický kraj";3;0;0;0;NA;94924;3;2020-04-24;230
2020-04-23;"Košický kraj";4;0;0;0;NA;94924;4;2020-04-23;227
2020-04-22;"Košický kraj";21;0;0;0;NA;94924;21;2020-04-22;223
2020-04-21;"Košický kraj";4;0;0;0;NA;94924;4;2020-04-21;202
2020-04-20;"Košický kraj";0;0;0;0;NA;94924;0;2020-04-20;198
2020-04-19;"Košický kraj";1;0;0;0;NA;94924;1;2020-04-19;198
2020-04-18;"Košický kraj";2;0;0;0;NA;94924;2;2020-04-18;197
2020-04-17;"Košický kraj";7;0;0;0;NA;94924;7;2020-04-17;195
2020-04-16;"Košický kraj";29;0;0;0;NA;94924;29;2020-04-16;188
2020-04-15;"Košický kraj";50;0;0;0;NA;94924;50;2020-04-15;159
2020-04-14;"Košický kraj";4;0;0;0;NA;94924;4;2020-04-14;109
2020-04-13;"Košický kraj";5;0;0;0;NA;94924;5;2020-04-13;105
2020-04-12;"Košický kraj";4;0;0;0;NA;94924;4;2020-04-12;100
2020-04-11;"Košický kraj";2;0;0;0;NA;94924;2;2020-04-11;96
2020-04-10;"Košický kraj";1;0;0;0;NA;94924;1;2020-04-10;94
2020-04-09;"Košický kraj";4;0;0;0;NA;94924;4;2020-04-09;93
2020-04-08;"Košický kraj";5;2;0;2;NA;94924;5;2020-04-08;89
2020-04-07;"Košický kraj";34;0;0;0;NA;94924;34;2020-04-07;84
2020-04-06;"Košický kraj";6;0;0;0;NA;94924;6;2020-04-06;50
2020-04-05;"Košický kraj";4;0;0;0;NA;94924;4;2020-04-05;44
2020-04-04;"Košický kraj";5;0;0;0;NA;94924;5;2020-04-04;40
2020-04-03;"Košický kraj";4;0;0;0;NA;94924;4;2020-04-03;35
2020-04-02;"Košický kraj";3;0;0;0;NA;94924;3;2020-04-02;31
2020-04-01;"Košický kraj";3;0;0;0;NA;94924;3;2020-04-01;28
2020-03-31;"Košický kraj";1;0;0;0;NA;94924;1;2020-03-31;25
2020-03-30;"Košický kraj";5;0;0;0;NA;94924;5;2020-03-30;24
2020-03-29;"Košický kraj";0;0;0;0;NA;94924;0;2020-03-29;19
2020-03-28;"Košický kraj";1;0;0;0;NA;94924;1;2020-03-28;19
2020-03-27;"Košický kraj";1;0;0;0;NA;94924;1;2020-03-27;18
2020-03-26;"Košický kraj";3;0;0;0;NA;94924;3;2020-03-26;17
2020-03-25;"Košický kraj";2;0;0;0;NA;94924;2;2020-03-25;14
2020-03-24;"Košický kraj";0;0;0;0;NA;94924;0;2020-03-24;12
2020-03-23;"Košický kraj";2;0;0;0;NA;94924;2;2020-03-23;12
2020-03-22;"Košický kraj";0;0;0;0;NA;94924;0;2020-03-22;10
2020-03-21;"Košický kraj";3;0;0;0;NA;94924;3;2020-03-21;10
2020-03-20;"Košický kraj";1;0;0;0;NA;94924;1;2020-03-20;7
2020-03-19;"Košický kraj";0;0;0;0;NA;94924;0;2020-03-19;6
2020-03-18;"Košický kraj";0;0;0;0;NA;94924;0;2020-03-18;6
2020-03-17;"Košický kraj";0;0;0;0;NA;94924;0;2020-03-17;6
2020-03-16;"Košický kraj";3;0;0;0;NA;94924;3;2020-03-16;6
2020-03-15;"Košický kraj";1;0;0;0;NA;94924;1;2020-03-15;3
2020-03-14;"Košický kraj";0;0;0;0;NA;94924;0;2020-03-14;2
2020-03-13;"Košický kraj";2;0;0;0;NA;94924;2;2020-03-13;2
2020-03-12;"Košický kraj";0;0;0;0;NA;94924;0;2020-03-12;0
2020-03-11;"Košický kraj";0;0;0;0;NA;94924;0;2020-03-11;0
2020-03-09;"Košický kraj";1;0;0;0;NA;94924;1;2020-03-09;0
2020-03-08;"Košický kraj";0;0;0;0;NA;94924;0;2020-03-08;-1
2020-03-07;"Košický kraj";0;0;0;0;NA;94924;0;2020-03-07;-1
2020-03-06;"Košický kraj";0;0;0;0;NA;94924;0;2020-03-06;-1
2021-04-29;"Nitriansky kraj";27;9734;27;9761;38661;91318;54;2021-04-29;91318
2021-04-28;"Nitriansky kraj";36;14145;41;14186;NA;91318;77;2021-04-28;91264
2021-04-27;"Nitriansky kraj";51;12680;35;12715;NA;91318;86;2021-04-27;91187
2021-04-26;"Nitriansky kraj";38;20392;43;20435;NA;91318;81;2021-04-26;91101
2021-04-25;"Nitriansky kraj";7;41189;40;41229;NA;91318;47;2021-04-25;91020
2021-04-24;"Nitriansky kraj";23;85030;70;85100;NA;91318;93;2021-04-24;90973
2021-04-23;"Nitriansky kraj";54;34760;51;34811;NA;91318;105;2021-04-23;90880
2021-04-22;"Nitriansky kraj";32;15435;44;15479;NA;91318;76;2021-04-22;90775
2021-04-21;"Nitriansky kraj";38;14089;45;14134;NA;91318;83;2021-04-21;90699
2021-04-20;"Nitriansky kraj";67;16053;51;16104;NA;91318;118;2021-04-20;90616
2021-04-19;"Nitriansky kraj";35;24796;59;24855;NA;91318;94;2021-04-19;90498
2021-04-18;"Nitriansky kraj";0;39307;27;39334;NA;91318;27;2021-04-18;90404
2021-04-17;"Nitriansky kraj";34;89024;79;89103;NA;91318;113;2021-04-17;90377
2021-04-16;"Nitriansky kraj";46;32253;37;32290;NA;91318;83;2021-04-16;90264
2021-04-15;"Nitriansky kraj";75;16550;53;16603;NA;91318;128;2021-04-15;90181
2021-04-14;"Nitriansky kraj";43;14994;42;15036;NA;91318;85;2021-04-14;90053
2021-04-13;"Nitriansky kraj";110;15460;45;15505;NA;91318;155;2021-04-13;89968
2021-04-12;"Nitriansky kraj";29;21846;49;21895;NA;91318;78;2021-04-12;89813
2021-04-11;"Nitriansky kraj";1;37537;31;37568;NA;91318;32;2021-04-11;89735
2021-04-10;"Nitriansky kraj";35;90504;106;90610;NA;91318;141;2021-04-10;89703
2021-04-09;"Nitriansky kraj";69;30669;58;30727;NA;91318;127;2021-04-09;89562
2021-04-08;"Nitriansky kraj";71;15455;39;15494;NA;91318;110;2021-04-08;89435
2021-04-07;"Nitriansky kraj";64;18533;43;18576;NA;91318;107;2021-04-07;89325
2021-04-06;"Nitriansky kraj";65;32994;112;33106;NA;91318;177;2021-04-06;89218
2021-04-05;"Nitriansky kraj";37;12673;48;12721;NA;91318;85;2021-04-05;89041
2021-04-04;"Nitriansky kraj";5;17887;35;17922;NA;91318;40;2021-04-04;88956
2021-04-03;"Nitriansky kraj";26;85188;153;85341;NA;91318;179;2021-04-03;88916
2021-04-02;"Nitriansky kraj";32;18591;46;18637;NA;91318;78;2021-04-02;88737
2021-04-01;"Nitriansky kraj";63;24610;83;24693;NA;91318;146;2021-04-01;88659
2021-03-31;"Nitriansky kraj";73;21752;94;21846;NA;91318;167;2021-03-31;88513
2021-03-30;"Nitriansky kraj";125;17044;83;17127;NA;91318;208;2021-03-30;88346
2021-03-29;"Nitriansky kraj";81;25139;99;25238;NA;91318;180;2021-03-29;88138
2021-03-28;"Nitriansky kraj";6;45581;106;45687;NA;91318;112;2021-03-28;87958
2021-03-27;"Nitriansky kraj";39;103659;174;103833;NA;91318;213;2021-03-27;87846
2021-03-26;"Nitriansky kraj";90;40444;115;40559;NA;91318;205;2021-03-26;87633
2021-03-25;"Nitriansky kraj";95;19149;94;19243;NA;91318;189;2021-03-25;87428
2021-03-24;"Nitriansky kraj";90;14784;91;14875;NA;91318;181;2021-03-24;87239
2021-03-23;"Nitriansky kraj";167;16753;66;16819;NA;91318;233;2021-03-23;87058
2021-03-22;"Nitriansky kraj";101;23699;124;23823;NA;91318;225;2021-03-22;86825
2021-03-21;"Nitriansky kraj";27;42318;99;42417;NA;91318;126;2021-03-21;86600
2021-03-20;"Nitriansky kraj";36;99816;207;100023;NA;91318;243;2021-03-20;86474
2021-03-19;"Nitriansky kraj";76;37115;101;37216;NA;91318;177;2021-03-19;86231
2021-03-18;"Nitriansky kraj";103;20051;113;20164;NA;91318;216;2021-03-18;86054
2021-03-17;"Nitriansky kraj";87;15832;127;15959;NA;91318;214;2021-03-17;85838
2021-03-16;"Nitriansky kraj";172;18277;123;18400;NA;91318;295;2021-03-16;85624
2021-03-15;"Nitriansky kraj";130;24491;165;24656;NA;91318;295;2021-03-15;85329
2021-03-14;"Nitriansky kraj";3;45758;107;45865;NA;91318;110;2021-03-14;85034
2021-03-13;"Nitriansky kraj";65;112255;242;112497;NA;91318;307;2021-03-13;84924
2021-03-12;"Nitriansky kraj";127;40776;159;40935;NA;91318;286;2021-03-12;84617
2021-03-11;"Nitriansky kraj";131;18950;132;19082;NA;91318;263;2021-03-11;84331
2021-03-10;"Nitriansky kraj";96;17422;143;17565;NA;91318;239;2021-03-10;84068
2021-03-09;"Nitriansky kraj";260;17645;149;17794;NA;91318;409;2021-03-09;83829
2021-03-08;"Nitriansky kraj";145;27214;172;27386;NA;91318;317;2021-03-08;83420
2021-03-07;"Nitriansky kraj";48;46867;185;47052;NA;91318;233;2021-03-07;83103
2021-03-06;"Nitriansky kraj";86;110858;326;111184;NA;91318;412;2021-03-06;82870
2021-03-05;"Nitriansky kraj";133;39068;200;39268;NA;91318;333;2021-03-05;82458
2021-03-04;"Nitriansky kraj";176;18206;173;18379;NA;91318;349;2021-03-04;82125
2021-03-03;"Nitriansky kraj";172;17210;177;17387;NA;91318;349;2021-03-03;81776
2021-03-02;"Nitriansky kraj";274;20999;366;21365;NA;91318;640;2021-03-02;81427
2021-03-01;"Nitriansky kraj";133;27881;279;28160;NA;91318;412;2021-03-01;80787
2021-02-28;"Nitriansky kraj";80;40866;218;41084;NA;91318;298;2021-02-28;80375
2021-02-27;"Nitriansky kraj";101;106352;496;106848;NA;91318;597;2021-02-27;80077
2021-02-26;"Nitriansky kraj";109;36679;310;36989;NA;91318;419;2021-02-26;79480
2021-02-25;"Nitriansky kraj";188;15228;208;15436;NA;91318;396;2021-02-25;79061
2021-02-24;"Nitriansky kraj";125;13844;260;14104;NA;91318;385;2021-02-24;78665
2021-02-23;"Nitriansky kraj";273;15343;271;15614;NA;91318;544;2021-02-23;78280
2021-02-22;"Nitriansky kraj";154;26466;330;26796;NA;91318;484;2021-02-22;77736
2021-02-21;"Nitriansky kraj";22;43657;320;43977;NA;91318;342;2021-02-21;77252
2021-02-20;"Nitriansky kraj";128;108304;584;108888;NA;91318;712;2021-02-20;76910
2021-02-19;"Nitriansky kraj";173;36885;325;37210;NA;91318;498;2021-02-19;76198
2021-02-18;"Nitriansky kraj";202;16938;285;17223;NA;91318;487;2021-02-18;75700
2021-02-17;"Nitriansky kraj";198;12079;300;12379;NA;91318;498;2021-02-17;75213
2021-02-16;"Nitriansky kraj";284;14490;281;14771;NA;91318;565;2021-02-16;74715
2021-02-15;"Nitriansky kraj";122;27620;471;28091;NA;91318;593;2021-02-15;74150
2021-02-14;"Nitriansky kraj";8;50408;318;50726;NA;91318;326;2021-02-14;73557
2021-02-13;"Nitriansky kraj";127;110035;689;110724;NA;91318;816;2021-02-13;73231
2021-02-12;"Nitriansky kraj";162;33400;407;33807;NA;91318;569;2021-02-12;72415
2021-02-11;"Nitriansky kraj";195;12406;270;12676;NA;91318;465;2021-02-11;71846
2021-02-10;"Nitriansky kraj";186;17632;644;18276;NA;91318;830;2021-02-10;71381
2021-02-09;"Nitriansky kraj";260;18523;385;18908;NA;91318;645;2021-02-09;70551
2021-02-08;"Nitriansky kraj";177;37534;569;38103;NA;91318;746;2021-02-08;69906
2021-02-07;"Nitriansky kraj";20;52307;513;52820;NA;91318;533;2021-02-07;69160
2021-02-06;"Nitriansky kraj";129;101942;765;102707;NA;91318;894;2021-02-06;68627
2021-02-05;"Nitriansky kraj";244;26144;491;26635;NA;91318;735;2021-02-05;67733
2021-02-04;"Nitriansky kraj";308;15681;512;16193;NA;91318;820;2021-02-04;66998
2021-02-03;"Nitriansky kraj";191;13372;372;13744;NA;91318;563;2021-02-03;66178
2021-02-02;"Nitriansky kraj";327;17878;382;18260;NA;91318;709;2021-02-02;65615
2021-02-01;"Nitriansky kraj";221;24049;460;24509;NA;91318;681;2021-02-01;64906
2021-01-31;"Nitriansky kraj";9;45339;496;45835;NA;91318;505;2021-01-31;64225
2021-01-30;"Nitriansky kraj";152;98142;1077;99219;NA;91318;1229;2021-01-30;63720
2021-01-29;"Nitriansky kraj";302;22461;477;22938;NA;91318;779;2021-01-29;62491
2021-01-28;"Nitriansky kraj";269;11370;398;11768;NA;91318;667;2021-01-28;61712
2021-01-27;"Nitriansky kraj";235;6760;299;7059;NA;91318;534;2021-01-27;61045
2021-01-26;"Nitriansky kraj";345;16036;454;16490;NA;91318;799;2021-01-26;60511
2021-01-25;"Nitriansky kraj";201;21729;429;22158;NA;91318;630;2021-01-25;59712
2021-01-24;"Nitriansky kraj";12;78775;889;79664;NA;91318;901;2021-01-24;59082
2021-01-23;"Nitriansky kraj";277;97395;1434;98829;NA;91318;1711;2021-01-23;58181
2021-01-22;"Nitriansky kraj";139;35826;619;36445;NA;91318;758;2021-01-22;56470
2021-01-21;"Nitriansky kraj";305;14649;412;15061;NA;91318;717;2021-01-21;55712
2021-01-20;"Nitriansky kraj";326;11991;625;12616;NA;91318;951;2021-01-20;54995
2021-01-19;"Nitriansky kraj";344;11022;633;11655;NA;91318;977;2021-01-19;54044
2021-01-18;"Nitriansky kraj";367;8902;520;9422;NA;91318;887;2021-01-18;53067
2021-01-17;"Nitriansky kraj";97;15061;275;15336;NA;91318;372;2021-01-17;52180
2021-01-16;"Nitriansky kraj";64;36838;679;37517;NA;91318;743;2021-01-16;51808
2021-01-15;"Nitriansky kraj";373;15940;474;16414;NA;91318;847;2021-01-15;51065
2021-01-14;"Nitriansky kraj";627;10577;452;11029;NA;91318;1079;2021-01-14;50218
2021-01-13;"Nitriansky kraj";663;9234;484;9718;NA;91318;1147;2021-01-13;49139
2021-01-12;"Nitriansky kraj";642;9014;557;9571;NA;91318;1199;2021-01-12;47992
2021-01-11;"Nitriansky kraj";422;8625;556;9181;NA;91318;978;2021-01-11;46793
2021-01-10;"Nitriansky kraj";44;19841;730;20571;NA;91318;774;2021-01-10;45815
2021-01-09;"Nitriansky kraj";532;36823;1071;37894;NA;91318;1603;2021-01-09;45041
2021-01-08;"Nitriansky kraj";817;14297;711;15008;NA;91318;1528;2021-01-08;43438
2021-01-07;"Nitriansky kraj";438;10820;823;11643;NA;91318;1261;2021-01-07;41910
2021-01-06;"Nitriansky kraj";259;3192;197;3389;NA;91318;456;2021-01-06;40649
2021-01-05;"Nitriansky kraj";732;8901;1202;10103;NA;91318;1934;2021-01-05;40193
2021-01-04;"Nitriansky kraj";362;8692;1329;10021;NA;91318;1691;2021-01-04;38259
2021-01-03;"Nitriansky kraj";42;84;20;104;NA;91318;62;2021-01-03;36568
2021-01-02;"Nitriansky kraj";249;1090;26;1116;NA;91318;275;2021-01-02;36506
2021-01-01;"Nitriansky kraj";119;781;95;876;NA;91318;214;2021-01-01;36231
2020-12-31;"Nitriansky kraj";786;7646;962;8608;NA;91318;1748;2020-12-31;36017
2020-12-30;"Nitriansky kraj";1094;9619;1165;10784;NA;91318;2259;2020-12-30;34269
2020-12-29;"Nitriansky kraj";607;8277;1286;9563;NA;91318;1893;2020-12-29;32010
2020-12-28;"Nitriansky kraj";83;6981;1271;8252;NA;91318;1354;2020-12-28;30117
2020-12-27;"Nitriansky kraj";22;60;8;68;NA;91318;30;2020-12-27;28763
2020-12-26;"Nitriansky kraj";54;297;56;353;NA;91318;110;2020-12-26;28733
2020-12-25;"Nitriansky kraj";35;60;11;71;NA;91318;46;2020-12-25;28623
2020-12-24;"Nitriansky kraj";514;1861;176;2037;NA;91318;690;2020-12-24;28577
2020-12-23;"Nitriansky kraj";349;15295;843;16138;NA;91318;1192;2020-12-23;27887
2020-12-22;"Nitriansky kraj";673;10987;994;11981;NA;91318;1667;2020-12-22;26695
2020-12-21;"Nitriansky kraj";128;7953;976;8929;NA;91318;1104;2020-12-21;25028
2020-12-20;"Nitriansky kraj";77;50;10;60;NA;91318;87;2020-12-20;23924
2020-12-19;"Nitriansky kraj";262;2259;159;2418;NA;91318;421;2020-12-19;23837
2020-12-18;"Nitriansky kraj";512;8437;551;8988;NA;91318;1063;2020-12-18;23416
2020-12-17;"Nitriansky kraj";586;6894;514;7408;NA;91318;1100;2020-12-17;22353
2020-12-16;"Nitriansky kraj";357;8785;546;9331;NA;91318;903;2020-12-16;21253
2020-12-15;"Nitriansky kraj";461;9365;769;10134;NA;91318;1230;2020-12-15;20350
2020-12-14;"Nitriansky kraj";217;8089;827;8916;NA;91318;1044;2020-12-14;19120
2020-12-13;"Nitriansky kraj";12;69;6;75;NA;91318;18;2020-12-13;18076
2020-12-12;"Nitriansky kraj";341;1832;125;1957;NA;91318;466;2020-12-12;18058
2020-12-11;"Nitriansky kraj";409;5431;416;5847;NA;91318;825;2020-12-11;17592
2020-12-10;"Nitriansky kraj";360;5473;351;5824;NA;91318;711;2020-12-10;16767
2020-12-09;"Nitriansky kraj";362;5506;529;6035;NA;91318;891;2020-12-09;16056
2020-12-08;"Nitriansky kraj";340;8611;589;9200;NA;91318;929;2020-12-08;15165
2020-12-07;"Nitriansky kraj";139;6243;573;6816;NA;91318;712;2020-12-07;14236
2020-12-06;"Nitriansky kraj";15;89;4;93;NA;91318;19;2020-12-06;13524
2020-12-05;"Nitriansky kraj";136;1388;19;1407;NA;91318;155;2020-12-05;13505
2020-12-04;"Nitriansky kraj";232;2884;74;2958;NA;91318;306;2020-12-04;13350
2020-12-03;"Nitriansky kraj";248;2471;110;2581;NA;91318;358;2020-12-03;13044
2020-12-02;"Nitriansky kraj";252;3733;163;3896;NA;91318;415;2020-12-02;12686
2020-12-01;"Nitriansky kraj";331;2891;131;3022;NA;91318;462;2020-12-01;12271
2020-11-30;"Nitriansky kraj";91;4228;188;4416;NA;91318;279;2020-11-30;11809
2020-11-29;"Nitriansky kraj";3;634;42;676;NA;91318;45;2020-11-29;11530
2020-11-28;"Nitriansky kraj";135;892;31;923;NA;91318;166;2020-11-28;11485
2020-11-27;"Nitriansky kraj";177;2069;73;2142;NA;91318;250;2020-11-27;11319
2020-11-26;"Nitriansky kraj";191;2813;80;2893;NA;91318;271;2020-11-26;11069
2020-11-25;"Nitriansky kraj";325;2478;91;2569;NA;91318;416;2020-11-25;10798
2020-11-24;"Nitriansky kraj";147;1641;64;1705;NA;91318;211;2020-11-24;10382
2020-11-23;"Nitriansky kraj";102;9891;212;10103;NA;91318;314;2020-11-23;10171
2020-11-22;"Nitriansky kraj";7;1176;25;1201;NA;91318;32;2020-11-22;9857
2020-11-21;"Nitriansky kraj";86;1083;38;1121;NA;91318;124;2020-11-21;9825
2020-11-20;"Nitriansky kraj";264;4180;103;4283;NA;91318;367;2020-11-20;9701
2020-11-19;"Nitriansky kraj";185;3065;134;3199;NA;91318;319;2020-11-19;9334
2020-11-18;"Nitriansky kraj";188;2214;79;2293;NA;91318;267;2020-11-18;9015
2020-11-17;"Nitriansky kraj";178;596;29;625;NA;91318;207;2020-11-17;8748
2020-11-16;"Nitriansky kraj";139;1877;75;1952;NA;91318;214;2020-11-16;8541
2020-11-15;"Nitriansky kraj";14;180;5;185;NA;91318;19;2020-11-15;8327
2020-11-14;"Nitriansky kraj";114;1131;32;1163;NA;91318;146;2020-11-14;8308
2020-11-13;"Nitriansky kraj";210;936;46;982;NA;91318;256;2020-11-13;8162
2020-11-12;"Nitriansky kraj";256;1195;35;1230;NA;91318;291;2020-11-12;7906
2020-11-11;"Nitriansky kraj";279;1247;22;1269;NA;91318;301;2020-11-11;7615
2020-11-10;"Nitriansky kraj";192;2623;39;2662;NA;91318;231;2020-11-10;7314
2020-11-09;"Nitriansky kraj";128;3136;43;3179;NA;91318;171;2020-11-09;7083
2020-11-08;"Nitriansky kraj";43;1462;32;1494;NA;91318;75;2020-11-08;6912
2020-11-07;"Nitriansky kraj";130;1046;4;1050;NA;91318;134;2020-11-07;6837
2020-11-06;"Nitriansky kraj";210;2264;32;2296;NA;91318;242;2020-11-06;6703
2020-11-05;"Nitriansky kraj";178;313;14;327;NA;91318;192;2020-11-05;6461
2020-11-04;"Nitriansky kraj";211;297;16;313;NA;91318;227;2020-11-04;6269
2020-11-03;"Nitriansky kraj";216;435;25;460;NA;91318;241;2020-11-03;6042
2020-11-02;"Nitriansky kraj";171;4208;46;4254;NA;91318;217;2020-11-02;5801
2020-11-01;"Nitriansky kraj";130;2546;27;2573;NA;91318;157;2020-11-01;5584
2020-10-31;"Nitriansky kraj";261;10572;134;10706;NA;91318;395;2020-10-31;5427
2020-10-30;"Nitriansky kraj";204;2661;44;2705;NA;91318;248;2020-10-30;5032
2020-10-29;"Nitriansky kraj";293;841;39;880;NA;91318;332;2020-10-29;4784
2020-10-28;"Nitriansky kraj";216;608;59;667;NA;91318;275;2020-10-28;4452
2020-10-27;"Nitriansky kraj";296;550;47;597;NA;91318;343;2020-10-27;4177
2020-10-26;"Nitriansky kraj";69;633;56;689;NA;91318;125;2020-10-26;3834
2020-10-25;"Nitriansky kraj";50;62;8;70;NA;91318;58;2020-10-25;3709
2020-10-24;"Nitriansky kraj";169;237;11;248;NA;91318;180;2020-10-24;3651
2020-10-23;"Nitriansky kraj";282;762;41;803;NA;91318;323;2020-10-23;3471
2020-10-22;"Nitriansky kraj";137;444;39;483;NA;91318;176;2020-10-22;3148
2020-10-21;"Nitriansky kraj";146;208;3;211;NA;91318;149;2020-10-21;2972
2020-10-20;"Nitriansky kraj";197;78;6;84;NA;91318;203;2020-10-20;2823
2020-10-19;"Nitriansky kraj";148;79;1;80;NA;91318;149;2020-10-19;2620
2020-10-18;"Nitriansky kraj";22;0;0;0;NA;91318;22;2020-10-18;2471
2020-10-17;"Nitriansky kraj";67;0;0;0;NA;91318;67;2020-10-17;2449
2020-10-16;"Nitriansky kraj";133;28;3;31;NA;91318;136;2020-10-16;2382
2020-10-15;"Nitriansky kraj";106;31;2;33;NA;91318;108;2020-10-15;2246
2020-10-14;"Nitriansky kraj";80;22;4;26;NA;91318;84;2020-10-14;2138
2020-10-13;"Nitriansky kraj";101;82;2;84;NA;91318;103;2020-10-13;2054
2020-10-12;"Nitriansky kraj";36;0;0;0;NA;91318;36;2020-10-12;1951
2020-10-11;"Nitriansky kraj";8;0;0;0;NA;91318;8;2020-10-11;1915
2020-10-10;"Nitriansky kraj";107;0;0;0;NA;91318;107;2020-10-10;1907
2020-10-09;"Nitriansky kraj";120;0;0;0;NA;91318;120;2020-10-09;1800
2020-10-08;"Nitriansky kraj";132;0;0;0;NA;91318;132;2020-10-08;1680
2020-10-07;"Nitriansky kraj";81;0;0;0;NA;91318;81;2020-10-07;1548
2020-10-06;"Nitriansky kraj";48;0;0;0;NA;91318;48;2020-10-06;1467
2020-10-05;"Nitriansky kraj";20;0;0;0;NA;91318;20;2020-10-05;1419
2020-10-04;"Nitriansky kraj";17;0;0;0;NA;91318;17;2020-10-04;1399
2020-10-03;"Nitriansky kraj";96;0;0;0;NA;91318;96;2020-10-03;1382
2020-10-02;"Nitriansky kraj";108;0;0;0;NA;91318;108;2020-10-02;1286
2020-10-01;"Nitriansky kraj";95;0;0;0;NA;91318;95;2020-10-01;1178
2020-09-30;"Nitriansky kraj";100;0;0;0;NA;91318;100;2020-09-30;1083
2020-09-29;"Nitriansky kraj";50;0;0;0;NA;91318;50;2020-09-29;983
2020-09-28;"Nitriansky kraj";22;0;0;0;NA;91318;22;2020-09-28;933
2020-09-27;"Nitriansky kraj";16;0;0;0;NA;91318;16;2020-09-27;911
2020-09-26;"Nitriansky kraj";64;0;0;0;NA;91318;64;2020-09-26;895
2020-09-25;"Nitriansky kraj";90;0;0;0;NA;91318;90;2020-09-25;831
2020-09-24;"Nitriansky kraj";51;0;0;0;NA;91318;51;2020-09-24;741
2020-09-23;"Nitriansky kraj";70;0;0;0;NA;91318;70;2020-09-23;690
2020-09-22;"Nitriansky kraj";18;0;0;0;NA;91318;18;2020-09-22;620
2020-09-21;"Nitriansky kraj";10;0;0;0;NA;91318;10;2020-09-21;602
2020-09-20;"Nitriansky kraj";4;0;0;0;NA;91318;4;2020-09-20;592
2020-09-19;"Nitriansky kraj";14;0;0;0;NA;91318;14;2020-09-19;588
2020-09-18;"Nitriansky kraj";19;0;0;0;NA;91318;19;2020-09-18;574
2020-09-17;"Nitriansky kraj";30;0;0;0;NA;91318;30;2020-09-17;555
2020-09-16;"Nitriansky kraj";6;0;0;0;NA;91318;6;2020-09-16;525
2020-09-15;"Nitriansky kraj";19;0;0;0;NA;91318;19;2020-09-15;519
2020-09-14;"Nitriansky kraj";28;0;0;0;NA;91318;28;2020-09-14;500
2020-09-13;"Nitriansky kraj";3;0;0;0;NA;91318;3;2020-09-13;472
2020-09-12;"Nitriansky kraj";12;0;0;0;NA;91318;12;2020-09-12;469
2020-09-11;"Nitriansky kraj";23;0;0;0;NA;91318;23;2020-09-11;457
2020-09-10;"Nitriansky kraj";29;0;0;0;NA;91318;29;2020-09-10;434
2020-09-09;"Nitriansky kraj";19;0;0;0;NA;91318;19;2020-09-09;405
2020-09-08;"Nitriansky kraj";17;0;0;0;NA;91318;17;2020-09-08;386
2020-09-07;"Nitriansky kraj";17;0;0;0;NA;91318;17;2020-09-07;369
2020-09-06;"Nitriansky kraj";0;0;0;0;NA;91318;0;2020-09-06;352
2020-09-05;"Nitriansky kraj";22;0;0;0;NA;91318;22;2020-09-05;352
2020-09-04;"Nitriansky kraj";34;0;0;0;NA;91318;34;2020-09-04;330
2020-09-03;"Nitriansky kraj";15;0;0;0;NA;91318;15;2020-09-03;296
2020-09-02;"Nitriansky kraj";15;0;0;0;NA;91318;15;2020-09-02;281
2020-09-01;"Nitriansky kraj";2;0;0;0;NA;91318;2;2020-09-01;266
2020-08-31;"Nitriansky kraj";12;0;0;0;NA;91318;12;2020-08-31;264
2020-08-30;"Nitriansky kraj";1;0;0;0;NA;91318;1;2020-08-30;252
2020-08-29;"Nitriansky kraj";7;0;0;0;NA;91318;7;2020-08-29;251
2020-08-28;"Nitriansky kraj";12;0;0;0;NA;91318;12;2020-08-28;244
2020-08-27;"Nitriansky kraj";12;0;0;0;NA;91318;12;2020-08-27;232
2020-08-26;"Nitriansky kraj";4;0;0;0;NA;91318;4;2020-08-26;220
2020-08-25;"Nitriansky kraj";8;0;0;0;NA;91318;8;2020-08-25;216
2020-08-24;"Nitriansky kraj";1;0;0;0;NA;91318;1;2020-08-24;208
2020-08-23;"Nitriansky kraj";1;0;0;0;NA;91318;1;2020-08-23;207
2020-08-22;"Nitriansky kraj";2;0;0;0;NA;91318;2;2020-08-22;206
2020-08-21;"Nitriansky kraj";0;0;0;0;NA;91318;0;2020-08-21;204
2020-08-20;"Nitriansky kraj";7;0;0;0;NA;91318;7;2020-08-20;204
2020-08-19;"Nitriansky kraj";1;0;0;0;NA;91318;1;2020-08-19;197
2020-08-18;"Nitriansky kraj";2;0;0;0;NA;91318;2;2020-08-18;196
2020-08-17;"Nitriansky kraj";1;0;0;0;NA;91318;1;2020-08-17;194
2020-08-16;"Nitriansky kraj";0;0;0;0;NA;91318;0;2020-08-16;193
2020-08-15;"Nitriansky kraj";2;0;0;0;NA;91318;2;2020-08-15;193
2020-08-14;"Nitriansky kraj";1;0;0;0;NA;91318;1;2020-08-14;191
2020-08-13;"Nitriansky kraj";4;0;0;0;NA;91318;4;2020-08-13;190
2020-08-12;"Nitriansky kraj";0;0;0;0;NA;91318;0;2020-08-12;186
2020-08-11;"Nitriansky kraj";1;0;0;0;NA;91318;1;2020-08-11;186
2020-08-10;"Nitriansky kraj";0;0;0;0;NA;91318;0;2020-08-10;185
2020-08-09;"Nitriansky kraj";0;0;0;0;NA;91318;0;2020-08-09;185
2020-08-08;"Nitriansky kraj";0;0;0;0;NA;91318;0;2020-08-08;185
2020-08-07;"Nitriansky kraj";4;0;0;0;NA;91318;4;2020-08-07;185
2020-08-06;"Nitriansky kraj";4;0;0;0;NA;91318;4;2020-08-06;181
2020-08-05;"Nitriansky kraj";0;0;0;0;NA;91318;0;2020-08-05;177
2020-08-04;"Nitriansky kraj";7;0;0;0;NA;91318;7;2020-08-04;177
2020-08-03;"Nitriansky kraj";0;0;0;0;NA;91318;0;2020-08-03;170
2020-08-02;"Nitriansky kraj";0;0;0;0;NA;91318;0;2020-08-02;170
2020-08-01;"Nitriansky kraj";0;0;0;0;NA;91318;0;2020-08-01;170
2020-07-31;"Nitriansky kraj";0;0;0;0;NA;91318;0;2020-07-31;170
2020-07-30;"Nitriansky kraj";0;0;0;0;NA;91318;0;2020-07-30;170
2020-07-29;"Nitriansky kraj";0;0;0;0;NA;91318;0;2020-07-29;170
2020-07-28;"Nitriansky kraj";0;0;0;0;NA;91318;0;2020-07-28;170
2020-07-27;"Nitriansky kraj";0;0;0;0;NA;91318;0;2020-07-27;170
2020-07-26;"Nitriansky kraj";0;0;0;0;NA;91318;0;2020-07-26;170
2020-07-25;"Nitriansky kraj";0;0;0;0;NA;91318;0;2020-07-25;170
2020-07-24;"Nitriansky kraj";1;0;0;0;NA;91318;1;2020-07-24;170
2020-07-23;"Nitriansky kraj";3;0;0;0;NA;91318;3;2020-07-23;169
2020-07-22;"Nitriansky kraj";2;0;0;0;NA;91318;2;2020-07-22;166
2020-07-21;"Nitriansky kraj";14;0;0;0;NA;91318;14;2020-07-21;164
2020-07-20;"Nitriansky kraj";11;0;0;0;NA;91318;11;2020-07-20;150
2020-07-19;"Nitriansky kraj";0;0;0;0;NA;91318;0;2020-07-19;139
2020-07-18;"Nitriansky kraj";0;0;0;0;NA;91318;0;2020-07-18;139
2020-07-17;"Nitriansky kraj";0;0;0;0;NA;91318;0;2020-07-17;139
2020-07-16;"Nitriansky kraj";4;0;0;0;NA;91318;4;2020-07-16;139
2020-07-15;"Nitriansky kraj";5;0;0;0;NA;91318;5;2020-07-15;135
2020-07-14;"Nitriansky kraj";0;0;0;0;NA;91318;0;2020-07-14;130
2020-07-13;"Nitriansky kraj";0;0;0;0;NA;91318;0;2020-07-13;130
2020-07-12;"Nitriansky kraj";0;0;0;0;NA;91318;0;2020-07-12;130
2020-07-11;"Nitriansky kraj";0;0;0;0;NA;91318;0;2020-07-11;130
2020-07-10;"Nitriansky kraj";0;0;0;0;NA;91318;0;2020-07-10;130
2020-07-09;"Nitriansky kraj";1;0;0;0;NA;91318;1;2020-07-09;130
2020-07-08;"Nitriansky kraj";2;0;0;0;NA;91318;2;2020-07-08;129
2020-07-07;"Nitriansky kraj";0;0;0;0;NA;91318;0;2020-07-07;127
2020-07-06;"Nitriansky kraj";0;0;0;0;NA;91318;0;2020-07-06;127
2020-07-05;"Nitriansky kraj";0;0;0;0;NA;91318;0;2020-07-05;127
2020-07-04;"Nitriansky kraj";0;0;0;0;NA;91318;0;2020-07-04;127
2020-07-03;"Nitriansky kraj";0;0;0;0;NA;91318;0;2020-07-03;127
2020-07-02;"Nitriansky kraj";0;0;0;0;NA;91318;0;2020-07-02;127
2020-07-01;"Nitriansky kraj";3;0;0;0;NA;91318;3;2020-07-01;127
2020-06-30;"Nitriansky kraj";0;0;0;0;NA;91318;0;2020-06-30;124
2020-06-29;"Nitriansky kraj";0;0;0;0;NA;91318;0;2020-06-29;124
2020-06-28;"Nitriansky kraj";0;0;0;0;NA;91318;0;2020-06-28;124
2020-06-27;"Nitriansky kraj";0;0;0;0;NA;91318;0;2020-06-27;124
2020-06-26;"Nitriansky kraj";0;0;0;0;NA;91318;0;2020-06-26;124
2020-06-25;"Nitriansky kraj";0;0;0;0;NA;91318;0;2020-06-25;124
2020-06-24;"Nitriansky kraj";1;0;0;0;NA;91318;1;2020-06-24;124
2020-06-23;"Nitriansky kraj";0;0;0;0;NA;91318;0;2020-06-23;123
2020-06-22;"Nitriansky kraj";0;0;0;0;NA;91318;0;2020-06-22;123
2020-06-21;"Nitriansky kraj";0;0;0;0;NA;91318;0;2020-06-21;123
2020-06-20;"Nitriansky kraj";0;0;0;0;NA;91318;0;2020-06-20;123
2020-06-19;"Nitriansky kraj";0;0;0;0;NA;91318;0;2020-06-19;123
2020-06-18;"Nitriansky kraj";0;0;0;0;NA;91318;0;2020-06-18;123
2020-06-17;"Nitriansky kraj";0;0;0;0;NA;91318;0;2020-06-17;123
2020-06-16;"Nitriansky kraj";0;0;0;0;NA;91318;0;2020-06-16;123
2020-06-14;"Nitriansky kraj";0;0;0;0;NA;91318;0;2020-06-14;123
2020-06-13;"Nitriansky kraj";0;0;0;0;NA;91318;0;2020-06-13;123
2020-06-12;"Nitriansky kraj";0;0;0;0;NA;91318;0;2020-06-12;123
2020-06-11;"Nitriansky kraj";0;0;0;0;NA;91318;0;2020-06-11;123
2020-06-10;"Nitriansky kraj";1;0;0;0;NA;91318;1;2020-06-10;123
2020-06-09;"Nitriansky kraj";1;0;0;0;NA;91318;1;2020-06-09;122
2020-06-08;"Nitriansky kraj";0;0;0;0;NA;91318;0;2020-06-08;121
2020-06-07;"Nitriansky kraj";0;0;0;0;NA;91318;0;2020-06-07;121
2020-06-05;"Nitriansky kraj";0;0;0;0;NA;91318;0;2020-06-05;121
2020-06-03;"Nitriansky kraj";0;0;0;0;NA;91318;0;2020-06-03;121
2020-06-02;"Nitriansky kraj";1;0;0;0;NA;91318;1;2020-06-02;121
2020-05-31;"Nitriansky kraj";0;0;0;0;NA;91318;0;2020-05-31;120
2020-05-29;"Nitriansky kraj";0;0;0;0;NA;91318;0;2020-05-29;120
2020-05-27;"Nitriansky kraj";0;0;0;0;NA;91318;0;2020-05-27;120
2020-05-26;"Nitriansky kraj";0;0;0;0;NA;91318;0;2020-05-26;120
2020-05-25;"Nitriansky kraj";0;0;0;0;NA;91318;0;2020-05-25;120
2020-05-24;"Nitriansky kraj";2;0;0;0;NA;91318;2;2020-05-24;120
2020-05-23;"Nitriansky kraj";0;0;0;0;NA;91318;0;2020-05-23;118
2020-05-22;"Nitriansky kraj";1;0;0;0;NA;91318;1;2020-05-22;118
2020-05-21;"Nitriansky kraj";0;0;0;0;NA;91318;0;2020-05-21;117
2020-05-20;"Nitriansky kraj";0;0;0;0;NA;91318;0;2020-05-20;117
2020-05-19;"Nitriansky kraj";0;0;0;0;NA;91318;0;2020-05-19;117
2020-05-17;"Nitriansky kraj";0;0;0;0;NA;91318;0;2020-05-17;117
2020-05-16;"Nitriansky kraj";0;0;0;0;NA;91318;0;2020-05-16;117
2020-05-15;"Nitriansky kraj";1;0;0;0;NA;91318;1;2020-05-15;117
2020-05-14;"Nitriansky kraj";0;0;0;0;NA;91318;0;2020-05-14;116
2020-05-13;"Nitriansky kraj";0;0;0;0;NA;91318;0;2020-05-13;116
2020-05-12;"Nitriansky kraj";0;0;0;0;NA;91318;0;2020-05-12;116
2020-05-11;"Nitriansky kraj";2;0;0;0;NA;91318;2;2020-05-11;116
2020-05-09;"Nitriansky kraj";0;0;0;0;NA;91318;0;2020-05-09;114
2020-05-07;"Nitriansky kraj";1;0;0;0;NA;91318;1;2020-05-07;114
2020-05-06;"Nitriansky kraj";9;0;0;0;NA;91318;9;2020-05-06;113
2020-05-05;"Nitriansky kraj";0;0;0;0;NA;91318;0;2020-05-05;104
2020-05-04;"Nitriansky kraj";5;0;0;0;NA;91318;5;2020-05-04;104
2020-05-03;"Nitriansky kraj";2;0;0;0;NA;91318;2;2020-05-03;99
2020-05-02;"Nitriansky kraj";0;0;0;0;NA;91318;0;2020-05-02;97
2020-05-01;"Nitriansky kraj";1;0;0;0;NA;91318;1;2020-05-01;97
2020-04-30;"Nitriansky kraj";0;0;0;0;NA;91318;0;2020-04-30;96
2020-04-29;"Nitriansky kraj";0;0;0;0;NA;91318;0;2020-04-29;96
2020-04-28;"Nitriansky kraj";1;0;0;0;NA;91318;1;2020-04-28;96
2020-04-27;"Nitriansky kraj";0;0;0;0;NA;91318;0;2020-04-27;95
2020-04-26;"Nitriansky kraj";0;0;0;0;NA;91318;0;2020-04-26;95
2020-04-25;"Nitriansky kraj";0;0;0;0;NA;91318;0;2020-04-25;95
2020-04-24;"Nitriansky kraj";0;0;0;0;NA;91318;0;2020-04-24;95
2020-04-23;"Nitriansky kraj";3;0;0;0;NA;91318;3;2020-04-23;95
2020-04-22;"Nitriansky kraj";16;0;0;0;NA;91318;16;2020-04-22;92
2020-04-21;"Nitriansky kraj";6;0;0;0;NA;91318;6;2020-04-21;76
2020-04-20;"Nitriansky kraj";5;0;0;0;NA;91318;5;2020-04-20;70
2020-04-19;"Nitriansky kraj";0;0;0;0;NA;91318;0;2020-04-19;65
2020-04-18;"Nitriansky kraj";0;0;0;0;NA;91318;0;2020-04-18;65
2020-04-17;"Nitriansky kraj";7;0;0;0;NA;91318;7;2020-04-17;65
2020-04-16;"Nitriansky kraj";0;0;0;0;NA;91318;0;2020-04-16;58
2020-04-15;"Nitriansky kraj";6;0;0;0;NA;91318;6;2020-04-15;58
2020-04-14;"Nitriansky kraj";2;0;0;0;NA;91318;2;2020-04-14;52
2020-04-13;"Nitriansky kraj";1;0;0;0;NA;91318;1;2020-04-13;50
2020-04-12;"Nitriansky kraj";3;0;0;0;NA;91318;3;2020-04-12;49
2020-04-11;"Nitriansky kraj";1;0;0;0;NA;91318;1;2020-04-11;46
2020-04-10;"Nitriansky kraj";1;0;0;0;NA;91318;1;2020-04-10;45
2020-04-09;"Nitriansky kraj";0;0;0;0;NA;91318;0;2020-04-09;44
2020-04-08;"Nitriansky kraj";2;0;0;0;NA;91318;2;2020-04-08;44
2020-04-07;"Nitriansky kraj";3;0;0;0;NA;91318;3;2020-04-07;42
2020-04-06;"Nitriansky kraj";4;0;0;0;NA;91318;4;2020-04-06;39
2020-04-05;"Nitriansky kraj";5;0;0;0;NA;91318;5;2020-04-05;35
2020-04-04;"Nitriansky kraj";0;0;0;0;NA;91318;0;2020-04-04;30
2020-04-03;"Nitriansky kraj";0;0;0;0;NA;91318;0;2020-04-03;30
2020-04-02;"Nitriansky kraj";1;0;0;0;NA;91318;1;2020-04-02;30
2020-04-01;"Nitriansky kraj";0;0;0;0;NA;91318;0;2020-04-01;29
2020-03-31;"Nitriansky kraj";3;0;0;0;NA;91318;3;2020-03-31;29
2020-03-30;"Nitriansky kraj";3;0;0;0;NA;91318;3;2020-03-30;26
2020-03-29;"Nitriansky kraj";3;0;0;0;NA;91318;3;2020-03-29;23
2020-03-28;"Nitriansky kraj";1;0;0;0;NA;91318;1;2020-03-28;20
2020-03-27;"Nitriansky kraj";1;0;0;0;NA;91318;1;2020-03-27;19
2020-03-26;"Nitriansky kraj";1;0;0;0;NA;91318;1;2020-03-26;18
2020-03-25;"Nitriansky kraj";1;0;0;0;NA;91318;1;2020-03-25;17
2020-03-24;"Nitriansky kraj";0;0;0;0;NA;91318;0;2020-03-24;16
2020-03-23;"Nitriansky kraj";2;0;0;0;NA;91318;2;2020-03-23;16
2020-03-22;"Nitriansky kraj";2;0;0;0;NA;91318;2;2020-03-22;14
2020-03-21;"Nitriansky kraj";2;0;0;0;NA;91318;2;2020-03-21;12
2020-03-20;"Nitriansky kraj";1;0;0;0;NA;91318;1;2020-03-20;10
2020-03-19;"Nitriansky kraj";1;0;0;0;NA;91318;1;2020-03-19;9
2020-03-18;"Nitriansky kraj";2;0;0;0;NA;91318;2;2020-03-18;8
2020-03-17;"Nitriansky kraj";1;0;0;0;NA;91318;1;2020-03-17;6
2020-03-16;"Nitriansky kraj";0;0;0;0;NA;91318;0;2020-03-16;5
2020-03-15;"Nitriansky kraj";4;0;0;0;NA;91318;4;2020-03-15;5
2020-03-14;"Nitriansky kraj";1;0;0;0;NA;91318;1;2020-03-14;1
2020-03-13;"Nitriansky kraj";0;0;0;0;NA;91318;0;2020-03-13;0
2020-03-12;"Nitriansky kraj";0;0;0;0;NA;91318;0;2020-03-12;0
2020-03-11;"Nitriansky kraj";0;0;0;0;NA;91318;0;2020-03-11;0
2020-03-09;"Nitriansky kraj";0;0;0;0;NA;91318;0;2020-03-09;0
2020-03-08;"Nitriansky kraj";0;0;0;0;NA;91318;0;2020-03-08;0
2020-03-07;"Nitriansky kraj";0;0;0;0;NA;91318;0;2020-03-07;0
2020-03-06;"Nitriansky kraj";0;0;0;0;NA;91318;0;2020-03-06;0
2021-04-29;"Prešovský kraj";110;14009;81;14090;58132;109843;191;2021-04-29;109843
2021-04-28;"Prešovský kraj";122;18270;88;18358;NA;109843;210;2021-04-28;109652
2021-04-27;"Prešovský kraj";154;19795;118;19913;NA;109843;272;2021-04-27;109442
2021-04-26;"Prešovský kraj";99;27471;124;27595;NA;109843;223;2021-04-26;109170
2021-04-25;"Prešovský kraj";9;49396;143;49539;NA;109843;152;2021-04-25;108947
2021-04-24;"Prešovský kraj";61;85742;246;85988;NA;109843;307;2021-04-24;108795
2021-04-23;"Prešovský kraj";171;39782;133;39915;NA;109843;304;2021-04-23;108488
2021-04-22;"Prešovský kraj";86;17735;122;17857;NA;109843;208;2021-04-22;108184
2021-04-21;"Prešovský kraj";144;21530;139;21669;NA;109843;283;2021-04-21;107976
2021-04-20;"Prešovský kraj";115;23345;127;23472;NA;109843;242;2021-04-20;107693
2021-04-19;"Prešovský kraj";106;29131;145;29276;NA;109843;251;2021-04-19;107451
2021-04-18;"Prešovský kraj";4;51540;129;51669;NA;109843;133;2021-04-18;107200
2021-04-17;"Prešovský kraj";119;97174;238;97412;NA;109843;357;2021-04-17;107067
2021-04-16;"Prešovský kraj";135;41248;149;41397;NA;109843;284;2021-04-16;106710
2021-04-15;"Prešovský kraj";112;19872;133;20005;NA;109843;245;2021-04-15;106426
2021-04-14;"Prešovský kraj";199;23327;130;23457;NA;109843;329;2021-04-14;106181
2021-04-13;"Prešovský kraj";180;23730;116;23846;NA;109843;296;2021-04-13;105852
2021-04-12;"Prešovský kraj";172;30152;175;30327;NA;109843;347;2021-04-12;105556
2021-04-11;"Prešovský kraj";11;49998;187;50185;NA;109843;198;2021-04-11;105209
2021-04-10;"Prešovský kraj";94;90032;295;90327;NA;109843;389;2021-04-10;105011
2021-04-09;"Prešovský kraj";255;37130;200;37330;NA;109843;455;2021-04-09;104622
2021-04-08;"Prešovský kraj";192;18891;157;19048;NA;109843;349;2021-04-08;104167
2021-04-07;"Prešovský kraj";314;27700;154;27854;NA;109843;468;2021-04-07;103818
2021-04-06;"Prešovský kraj";231;41672;268;41940;NA;109843;499;2021-04-06;103350
2021-04-05;"Prešovský kraj";54;18454;132;18586;NA;109843;186;2021-04-05;102851
2021-04-04;"Prešovský kraj";31;18546;91;18637;NA;109843;122;2021-04-04;102665
2021-04-03;"Prešovský kraj";104;89627;316;89943;NA;109843;420;2021-04-03;102543
2021-04-02;"Prešovský kraj";194;23775;134;23909;NA;109843;328;2021-04-02;102123
2021-04-01;"Prešovský kraj";256;42433;195;42628;NA;109843;451;2021-04-01;101795
2021-03-31;"Prešovský kraj";311;30144;227;30371;NA;109843;538;2021-03-31;101344
2021-03-30;"Prešovský kraj";374;20747;203;20950;NA;109843;577;2021-03-30;100806
2021-03-29;"Prešovský kraj";219;28188;229;28417;NA;109843;448;2021-03-29;100229
2021-03-28;"Prešovský kraj";26;46811;256;47067;NA;109843;282;2021-03-28;99781
2021-03-27;"Prešovský kraj";181;88639;373;89012;NA;109843;554;2021-03-27;99499
2021-03-26;"Prešovský kraj";310;47751;299;48050;NA;109843;609;2021-03-26;98945
2021-03-25;"Prešovský kraj";248;22279;213;22492;NA;109843;461;2021-03-25;98336
2021-03-24;"Prešovský kraj";381;19588;213;19801;NA;109843;594;2021-03-24;97875
2021-03-23;"Prešovský kraj";241;20329;255;20584;NA;109843;496;2021-03-23;97281
2021-03-22;"Prešovský kraj";299;28490;286;28776;NA;109843;585;2021-03-22;96785
2021-03-21;"Prešovský kraj";32;49439;266;49705;NA;109843;298;2021-03-21;96200
2021-03-20;"Prešovský kraj";180;92531;427;92958;NA;109843;607;2021-03-20;95902
2021-03-19;"Prešovský kraj";373;46196;320;46516;NA;109843;693;2021-03-19;95295
2021-03-18;"Prešovský kraj";251;21721;217;21938;NA;109843;468;2021-03-18;94602
2021-03-17;"Prešovský kraj";331;20887;231;21118;NA;109843;562;2021-03-17;94134
2021-03-16;"Prešovský kraj";461;21094;277;21371;NA;109843;738;2021-03-16;93572
2021-03-15;"Prešovský kraj";370;28789;324;29113;NA;109843;694;2021-03-15;92834
2021-03-14;"Prešovský kraj";52;50410;356;50766;NA;109843;408;2021-03-14;92140
2021-03-13;"Prešovský kraj";200;95300;532;95832;NA;109843;732;2021-03-13;91732
2021-03-12;"Prešovský kraj";425;47691;368;48059;NA;109843;793;2021-03-12;91000
2021-03-11;"Prešovský kraj";463;22059;253;22312;NA;109843;716;2021-03-11;90207
2021-03-10;"Prešovský kraj";325;20821;293;21114;NA;109843;618;2021-03-10;89491
2021-03-09;"Prešovský kraj";505;21489;288;21777;NA;109843;793;2021-03-09;88873
2021-03-08;"Prešovský kraj";314;28902;333;29235;NA;109843;647;2021-03-08;88080
2021-03-07;"Prešovský kraj";19;48024;385;48409;NA;109843;404;2021-03-07;87433
2021-03-06;"Prešovský kraj";193;96985;591;97576;NA;109843;784;2021-03-06;87029
2021-03-05;"Prešovský kraj";497;46044;397;46441;NA;109843;894;2021-03-05;86245
2021-03-04;"Prešovský kraj";372;22814;359;23173;NA;109843;731;2021-03-04;85351
2021-03-03;"Prešovský kraj";397;21424;330;21754;NA;109843;727;2021-03-03;84620
2021-03-02;"Prešovský kraj";421;22679;357;23036;NA;109843;778;2021-03-02;83893
2021-03-01;"Prešovský kraj";303;27716;406;28122;NA;109843;709;2021-03-01;83115
2021-02-28;"Prešovský kraj";75;45000;387;45387;NA;109843;462;2021-02-28;82406
2021-02-27;"Prešovský kraj";273;90231;734;90965;NA;109843;1007;2021-02-27;81944
2021-02-26;"Prešovský kraj";455;41700;439;42139;NA;109843;894;2021-02-26;80937
2021-02-25;"Prešovský kraj";270;19496;337;19833;NA;109843;607;2021-02-25;80043
2021-02-24;"Prešovský kraj";328;19026;377;19403;NA;109843;705;2021-02-24;79436
2021-02-23;"Prešovský kraj";430;21273;345;21618;NA;109843;775;2021-02-23;78731
2021-02-22;"Prešovský kraj";351;27175;356;27531;NA;109843;707;2021-02-22;77956
2021-02-21;"Prešovský kraj";66;31802;302;32104;NA;109843;368;2021-02-21;77249
2021-02-20;"Prešovský kraj";129;71413;517;71930;NA;109843;646;2021-02-20;76881
2021-02-19;"Prešovský kraj";381;38597;425;39022;NA;109843;806;2021-02-19;76235
2021-02-18;"Prešovský kraj";268;16960;322;17282;NA;109843;590;2021-02-18;75429
2021-02-17;"Prešovský kraj";293;17392;246;17638;NA;109843;539;2021-02-17;74839
2021-02-16;"Prešovský kraj";422;18862;265;19127;NA;109843;687;2021-02-16;74300
2021-02-15;"Prešovský kraj";211;31360;303;31663;NA;109843;514;2021-02-15;73613
2021-02-14;"Prešovský kraj";27;39271;318;39589;NA;109843;345;2021-02-14;73099
2021-02-13;"Prešovský kraj";157;73937;392;74329;NA;109843;549;2021-02-13;72754
2021-02-12;"Prešovský kraj";308;38720;362;39082;NA;109843;670;2021-02-12;72205
2021-02-11;"Prešovský kraj";218;16207;238;16445;NA;109843;456;2021-02-11;71535
2021-02-10;"Prešovský kraj";220;18499;279;18778;NA;109843;499;2021-02-10;71079
2021-02-09;"Prešovský kraj";323;21495;370;21865;NA;109843;693;2021-02-09;70580
2021-02-08;"Prešovský kraj";161;36971;261;37232;NA;109843;422;2021-02-08;69887
2021-02-07;"Prešovský kraj";21;34227;209;34436;NA;109843;230;2021-02-07;69465
2021-02-06;"Prešovský kraj";176;69164;360;69524;NA;109843;536;2021-02-06;69235
2021-02-05;"Prešovský kraj";177;31247;261;31508;NA;109843;438;2021-02-05;68699
2021-02-04;"Prešovský kraj";176;13073;237;13310;NA;109843;413;2021-02-04;68261
2021-02-03;"Prešovský kraj";251;8421;236;8657;NA;109843;487;2021-02-03;67848
2021-02-02;"Prešovský kraj";249;11976;275;12251;NA;109843;524;2021-02-02;67361
2021-02-01;"Prešovský kraj";220;16059;316;16375;NA;109843;536;2021-02-01;66837
2021-01-31;"Prešovský kraj";42;10587;107;10694;NA;109843;149;2021-01-31;66301
2021-01-30;"Prešovský kraj";142;23939;215;24154;NA;109843;357;2021-01-30;66152
2021-01-29;"Prešovský kraj";185;17924;326;18250;NA;109843;511;2021-01-29;65795
2021-01-28;"Prešovský kraj";311;7338;150;7488;NA;109843;461;2021-01-28;65284
2021-01-27;"Prešovský kraj";153;9886;150;10036;NA;109843;303;2021-01-27;64823
2021-01-26;"Prešovský kraj";252;16648;151;16799;NA;109843;403;2021-01-26;64520
2021-01-25;"Prešovský kraj";196;29649;251;29900;NA;109843;447;2021-01-25;64117
2021-01-24;"Prešovský kraj";12;45706;304;46010;NA;109843;316;2021-01-24;63670
2021-01-23;"Prešovský kraj";189;96726;487;97213;NA;109843;676;2021-01-23;63354
2021-01-22;"Prešovský kraj";187;35377;261;35638;NA;109843;448;2021-01-22;62678
2021-01-21;"Prešovský kraj";187;20434;212;20646;NA;109843;399;2021-01-21;62230
2021-01-20;"Prešovský kraj";253;14579;195;14774;NA;109843;448;2021-01-20;61831
2021-01-19;"Prešovský kraj";281;12329;305;12634;NA;109843;586;2021-01-19;61383
2021-01-18;"Prešovský kraj";203;10422;336;10758;NA;109843;539;2021-01-18;60797
2021-01-17;"Prešovský kraj";107;14391;1008;15399;NA;109843;1115;2021-01-17;60258
2021-01-16;"Prešovský kraj";72;1838;81;1919;NA;109843;153;2021-01-16;59143
2021-01-15;"Prešovský kraj";159;7033;257;7290;NA;109843;416;2021-01-15;58990
2021-01-14;"Prešovský kraj";268;5523;252;5775;NA;109843;520;2021-01-14;58574
2021-01-13;"Prešovský kraj";342;5649;226;5875;NA;109843;568;2021-01-13;58054
2021-01-12;"Prešovský kraj";455;8487;409;8896;NA;109843;864;2021-01-12;57486
2021-01-11;"Prešovský kraj";343;8489;479;8968;NA;109843;822;2021-01-11;56622
2021-01-10;"Prešovský kraj";63;476;23;499;NA;109843;86;2021-01-10;55800
2021-01-09;"Prešovský kraj";439;2248;125;2373;NA;109843;564;2021-01-09;55714
2021-01-08;"Prešovský kraj";430;10865;572;11437;NA;109843;1002;2021-01-08;55150
2021-01-07;"Prešovský kraj";268;7789;648;8437;NA;109843;916;2021-01-07;54148
2021-01-06;"Prešovský kraj";315;1484;134;1618;NA;109843;449;2021-01-06;53232
2021-01-05;"Prešovský kraj";655;11591;1003;12594;NA;109843;1658;2021-01-05;52783
2021-01-04;"Prešovský kraj";371;17192;1812;19004;NA;109843;2183;2021-01-04;51125
2021-01-03;"Prešovský kraj";89;459;41;500;NA;109843;130;2021-01-03;48942
2021-01-02;"Prešovský kraj";65;1556;160;1716;NA;109843;225;2021-01-02;48812
2021-01-01;"Prešovský kraj";174;956;71;1027;NA;109843;245;2021-01-01;48587
2020-12-31;"Prešovský kraj";640;11959;783;12742;NA;109843;1423;2020-12-31;48342
2020-12-30;"Prešovský kraj";729;9065;802;9867;NA;109843;1531;2020-12-30;46919
2020-12-29;"Prešovský kraj";435;9273;949;10222;NA;109843;1384;2020-12-29;45388
2020-12-28;"Prešovský kraj";393;9046;1079;10125;NA;109843;1472;2020-12-28;44004
2020-12-27;"Prešovský kraj";40;613;45;658;NA;109843;85;2020-12-27;42532
2020-12-26;"Prešovský kraj";64;176;12;188;NA;109843;76;2020-12-26;42447
2020-12-25;"Prešovský kraj";208;274;11;285;NA;109843;219;2020-12-25;42371
2020-12-24;"Prešovský kraj";452;1214;85;1299;NA;109843;537;2020-12-24;42152
2020-12-23;"Prešovský kraj";361;11369;635;12004;NA;109843;996;2020-12-23;41615
2020-12-22;"Prešovský kraj";439;9371;710;10081;NA;109843;1149;2020-12-22;40619
2020-12-21;"Prešovský kraj";432;9923;880;10803;NA;109843;1312;2020-12-21;39470
2020-12-20;"Prešovský kraj";184;396;20;416;NA;109843;204;2020-12-20;38158
2020-12-19;"Prešovský kraj";276;1658;151;1809;NA;109843;427;2020-12-19;37954
2020-12-18;"Prešovský kraj";396;8845;595;9440;NA;109843;991;2020-12-18;37527
2020-12-17;"Prešovský kraj";427;10826;891;11717;NA;109843;1318;2020-12-17;36536
2020-12-16;"Prešovský kraj";466;6017;508;6525;NA;109843;974;2020-12-16;35218
2020-12-15;"Prešovský kraj";411;5685;584;6269;NA;109843;995;2020-12-15;34244
2020-12-14;"Prešovský kraj";334;5767;508;6275;NA;109843;842;2020-12-14;33249
2020-12-13;"Prešovský kraj";89;29;8;37;NA;109843;97;2020-12-13;32407
2020-12-12;"Prešovský kraj";319;2474;166;2640;NA;109843;485;2020-12-12;32310
2020-12-11;"Prešovský kraj";560;5602;402;6004;NA;109843;962;2020-12-11;31825
2020-12-10;"Prešovský kraj";337;5180;440;5620;NA;109843;777;2020-12-10;30863
2020-12-09;"Prešovský kraj";358;4357;314;4671;NA;109843;672;2020-12-09;30086
2020-12-08;"Prešovský kraj";350;6629;651;7280;NA;109843;1001;2020-12-08;29414
2020-12-07;"Prešovský kraj";309;4345;327;4672;NA;109843;636;2020-12-07;28413
2020-12-06;"Prešovský kraj";59;655;26;681;NA;109843;85;2020-12-06;27777
2020-12-05;"Prešovský kraj";218;984;87;1071;NA;109843;305;2020-12-05;27692
2020-12-04;"Prešovský kraj";352;5070;293;5363;NA;109843;645;2020-12-04;27387
2020-12-03;"Prešovský kraj";284;2456;179;2635;NA;109843;463;2020-12-03;26742
2020-12-02;"Prešovský kraj";232;2830;225;3055;NA;109843;457;2020-12-02;26279
2020-12-01;"Prešovský kraj";281;1884;196;2080;NA;109843;477;2020-12-01;25822
2020-11-30;"Prešovský kraj";196;5333;97;5430;NA;109843;293;2020-11-30;25345
2020-11-29;"Prešovský kraj";27;379;42;421;NA;109843;69;2020-11-29;25052
2020-11-28;"Prešovský kraj";199;772;77;849;NA;109843;276;2020-11-28;24983
2020-11-27;"Prešovský kraj";232;2350;130;2480;NA;109843;362;2020-11-27;24707
2020-11-26;"Prešovský kraj";263;3014;329;3343;NA;109843;592;2020-11-26;24345
2020-11-25;"Prešovský kraj";302;2174;103;2277;NA;109843;405;2020-11-25;23753
2020-11-24;"Prešovský kraj";365;1777;156;1933;NA;109843;521;2020-11-24;23348
2020-11-23;"Prešovský kraj";164;1099;60;1159;NA;109843;224;2020-11-23;22827
2020-11-22;"Prešovský kraj";46;44;1;45;NA;109843;47;2020-11-22;22603
2020-11-21;"Prešovský kraj";205;754;62;816;NA;109843;267;2020-11-21;22556
2020-11-20;"Prešovský kraj";363;2258;102;2360;NA;109843;465;2020-11-20;22289
2020-11-19;"Prešovský kraj";359;2096;238;2334;NA;109843;597;2020-11-19;21824
2020-11-18;"Prešovský kraj";270;488;43;531;NA;109843;313;2020-11-18;21227
2020-11-17;"Prešovský kraj";347;205;23;228;NA;109843;370;2020-11-17;20914
2020-11-16;"Prešovský kraj";226;540;58;598;NA;109843;284;2020-11-16;20544
2020-11-15;"Prešovský kraj";186;39;4;43;NA;109843;190;2020-11-15;20260
2020-11-14;"Prešovský kraj";261;54;4;58;NA;109843;265;2020-11-14;20070
2020-11-13;"Prešovský kraj";395;166;8;174;NA;109843;403;2020-11-13;19805
2020-11-12;"Prešovský kraj";397;229;50;279;NA;109843;447;2020-11-12;19402
2020-11-11;"Prešovský kraj";516;161;15;176;NA;109843;531;2020-11-11;18955
2020-11-10;"Prešovský kraj";437;197;9;206;NA;109843;446;2020-11-10;18424
2020-11-09;"Prešovský kraj";190;4112;945;5057;NA;109843;1135;2020-11-09;17978
2020-11-08;"Prešovský kraj";97;2817;32;2849;NA;109843;129;2020-11-08;16843
2020-11-07;"Prešovský kraj";416;8578;81;8659;NA;109843;497;2020-11-07;16714
2020-11-06;"Prešovský kraj";520;4791;76;4867;NA;109843;596;2020-11-06;16217
2020-11-05;"Prešovský kraj";397;180;5;185;NA;109843;402;2020-11-05;15621
2020-11-04;"Prešovský kraj";350;807;8;815;NA;109843;358;2020-11-04;15219
2020-11-03;"Prešovský kraj";565;98;12;110;NA;109843;577;2020-11-03;14861
2020-11-02;"Prešovský kraj";203;4158;1004;5162;NA;109843;1207;2020-11-02;14284
2020-11-01;"Prešovský kraj";386;2906;53;2959;NA;109843;439;2020-11-01;13077
2020-10-31;"Prešovský kraj";315;10497;170;10667;NA;109843;485;2020-10-31;12638
2020-10-30;"Prešovský kraj";552;2949;65;3014;NA;109843;617;2020-10-30;12153
2020-10-29;"Prešovský kraj";594;301;38;339;NA;109843;632;2020-10-29;11536
2020-10-28;"Prešovský kraj";617;291;46;337;NA;109843;663;2020-10-28;10904
2020-10-27;"Prešovský kraj";656;268;34;302;NA;109843;690;2020-10-27;10241
2020-10-26;"Prešovský kraj";137;363;57;420;NA;109843;194;2020-10-26;9551
2020-10-25;"Prešovský kraj";237;346;11;357;NA;109843;248;2020-10-25;9357
2020-10-24;"Prešovský kraj";719;200;12;212;NA;109843;731;2020-10-24;9109
2020-10-23;"Prešovský kraj";750;218;8;226;NA;109843;758;2020-10-23;8378
2020-10-22;"Prešovský kraj";646;396;30;426;NA;109843;676;2020-10-22;7620
2020-10-21;"Prešovský kraj";383;58;8;66;NA;109843;391;2020-10-21;6944
2020-10-20;"Prešovský kraj";493;65;7;72;NA;109843;500;2020-10-20;6553
2020-10-19;"Prešovský kraj";140;235;15;250;NA;109843;155;2020-10-19;6053
2020-10-18;"Prešovský kraj";209;0;0;0;NA;109843;209;2020-10-18;5898
2020-10-17;"Prešovský kraj";342;0;0;0;NA;109843;342;2020-10-17;5689
2020-10-16;"Prešovský kraj";388;57;3;60;NA;109843;391;2020-10-16;5347
2020-10-15;"Prešovský kraj";435;85;18;103;NA;109843;453;2020-10-15;4956
2020-10-14;"Prešovský kraj";451;54;10;64;NA;109843;461;2020-10-14;4503
2020-10-13;"Prešovský kraj";264;50;6;56;NA;109843;270;2020-10-13;4042
2020-10-12;"Prešovský kraj";214;334;35;369;NA;109843;249;2020-10-12;3772
2020-10-11;"Prešovský kraj";127;0;0;0;NA;109843;127;2020-10-11;3523
2020-10-10;"Prešovský kraj";248;0;0;0;NA;109843;248;2020-10-10;3396
2020-10-09;"Prešovský kraj";406;0;0;0;NA;109843;406;2020-10-09;3148
2020-10-08;"Prešovský kraj";245;0;0;0;NA;109843;245;2020-10-08;2742
2020-10-07;"Prešovský kraj";244;0;0;0;NA;109843;244;2020-10-07;2497
2020-10-06;"Prešovský kraj";166;0;0;0;NA;109843;166;2020-10-06;2253
2020-10-05;"Prešovský kraj";84;0;0;0;NA;109843;84;2020-10-05;2087
2020-10-04;"Prešovský kraj";118;0;0;0;NA;109843;118;2020-10-04;2003
2020-10-03;"Prešovský kraj";204;0;0;0;NA;109843;204;2020-10-03;1885
2020-10-02;"Prešovský kraj";149;0;0;0;NA;109843;149;2020-10-02;1681
2020-10-01;"Prešovský kraj";136;0;0;0;NA;109843;136;2020-10-01;1532
2020-09-30;"Prešovský kraj";121;0;0;0;NA;109843;121;2020-09-30;1396
2020-09-29;"Prešovský kraj";156;0;0;0;NA;109843;156;2020-09-29;1275
2020-09-28;"Prešovský kraj";51;0;0;0;NA;109843;51;2020-09-28;1119
2020-09-27;"Prešovský kraj";10;0;0;0;NA;109843;10;2020-09-27;1068
2020-09-26;"Prešovský kraj";72;0;0;0;NA;109843;72;2020-09-26;1058
2020-09-25;"Prešovský kraj";91;0;0;0;NA;109843;91;2020-09-25;986
2020-09-24;"Prešovský kraj";52;0;0;0;NA;109843;52;2020-09-24;895
2020-09-23;"Prešovský kraj";55;0;0;0;NA;109843;55;2020-09-23;843
2020-09-22;"Prešovský kraj";29;0;0;0;NA;109843;29;2020-09-22;788
2020-09-21;"Prešovský kraj";14;0;0;0;NA;109843;14;2020-09-21;759
2020-09-20;"Prešovský kraj";5;0;0;0;NA;109843;5;2020-09-20;745
2020-09-19;"Prešovský kraj";12;0;0;0;NA;109843;12;2020-09-19;740
2020-09-18;"Prešovský kraj";29;0;0;0;NA;109843;29;2020-09-18;728
2020-09-17;"Prešovský kraj";25;0;0;0;NA;109843;25;2020-09-17;699
2020-09-16;"Prešovský kraj";8;0;0;0;NA;109843;8;2020-09-16;674
2020-09-15;"Prešovský kraj";10;0;0;0;NA;109843;10;2020-09-15;666
2020-09-14;"Prešovský kraj";47;0;0;0;NA;109843;47;2020-09-14;656
2020-09-13;"Prešovský kraj";3;0;0;0;NA;109843;3;2020-09-13;609
2020-09-12;"Prešovský kraj";4;0;0;0;NA;109843;4;2020-09-12;606
2020-09-11;"Prešovský kraj";15;0;0;0;NA;109843;15;2020-09-11;602
2020-09-10;"Prešovský kraj";10;0;0;0;NA;109843;10;2020-09-10;587
2020-09-09;"Prešovský kraj";21;0;0;0;NA;109843;21;2020-09-09;577
2020-09-08;"Prešovský kraj";23;0;0;0;NA;109843;23;2020-09-08;556
2020-09-07;"Prešovský kraj";5;0;0;0;NA;109843;5;2020-09-07;533
2020-09-06;"Prešovský kraj";3;0;0;0;NA;109843;3;2020-09-06;528
2020-09-05;"Prešovský kraj";7;0;0;0;NA;109843;7;2020-09-05;525
2020-09-04;"Prešovský kraj";24;0;0;0;NA;109843;24;2020-09-04;518
2020-09-03;"Prešovský kraj";8;0;0;0;NA;109843;8;2020-09-03;494
2020-09-02;"Prešovský kraj";9;0;0;0;NA;109843;9;2020-09-02;486
2020-09-01;"Prešovský kraj";6;0;0;0;NA;109843;6;2020-09-01;477
2020-08-31;"Prešovský kraj";3;0;0;0;NA;109843;3;2020-08-31;471
2020-08-30;"Prešovský kraj";6;0;0;0;NA;109843;6;2020-08-30;468
2020-08-29;"Prešovský kraj";4;0;0;0;NA;109843;4;2020-08-29;462
2020-08-28;"Prešovský kraj";6;0;0;0;NA;109843;6;2020-08-28;458
2020-08-27;"Prešovský kraj";7;0;0;0;NA;109843;7;2020-08-27;452
2020-08-26;"Prešovský kraj";22;0;0;0;NA;109843;22;2020-08-26;445
2020-08-25;"Prešovský kraj";1;0;0;0;NA;109843;1;2020-08-25;423
2020-08-24;"Prešovský kraj";5;0;0;0;NA;109843;5;2020-08-24;422
2020-08-23;"Prešovský kraj";3;0;0;0;NA;109843;3;2020-08-23;417
2020-08-22;"Prešovský kraj";3;0;0;0;NA;109843;3;2020-08-22;414
2020-08-21;"Prešovský kraj";11;0;0;0;NA;109843;11;2020-08-21;411
2020-08-20;"Prešovský kraj";8;0;0;0;NA;109843;8;2020-08-20;400
2020-08-19;"Prešovský kraj";8;0;0;0;NA;109843;8;2020-08-19;392
2020-08-18;"Prešovský kraj";6;0;0;0;NA;109843;6;2020-08-18;384
2020-08-17;"Prešovský kraj";1;0;0;0;NA;109843;1;2020-08-17;378
2020-08-16;"Prešovský kraj";0;0;0;0;NA;109843;0;2020-08-16;377
2020-08-15;"Prešovský kraj";8;0;0;0;NA;109843;8;2020-08-15;377
2020-08-14;"Prešovský kraj";6;0;0;0;NA;109843;6;2020-08-14;369
2020-08-13;"Prešovský kraj";8;0;0;0;NA;109843;8;2020-08-13;363
2020-08-12;"Prešovský kraj";19;0;0;0;NA;109843;19;2020-08-12;355
2020-08-11;"Prešovský kraj";3;0;0;0;NA;109843;3;2020-08-11;336
2020-08-10;"Prešovský kraj";0;0;0;0;NA;109843;0;2020-08-10;333
2020-08-09;"Prešovský kraj";0;0;0;0;NA;109843;0;2020-08-09;333
2020-08-08;"Prešovský kraj";2;0;0;0;NA;109843;2;2020-08-08;333
2020-08-07;"Prešovský kraj";6;0;0;0;NA;109843;6;2020-08-07;331
2020-08-06;"Prešovský kraj";2;0;0;0;NA;109843;2;2020-08-06;325
2020-08-05;"Prešovský kraj";8;0;0;0;NA;109843;8;2020-08-05;323
2020-08-04;"Prešovský kraj";5;0;0;0;NA;109843;5;2020-08-04;315
2020-08-03;"Prešovský kraj";4;0;0;0;NA;109843;4;2020-08-03;310
2020-08-02;"Prešovský kraj";6;0;0;0;NA;109843;6;2020-08-02;306
2020-08-01;"Prešovský kraj";0;0;0;0;NA;109843;0;2020-08-01;300
2020-07-31;"Prešovský kraj";2;0;0;0;NA;109843;2;2020-07-31;300
2020-07-30;"Prešovský kraj";6;0;0;0;NA;109843;6;2020-07-30;298
2020-07-29;"Prešovský kraj";5;0;0;0;NA;109843;5;2020-07-29;292
2020-07-28;"Prešovský kraj";0;0;0;0;NA;109843;0;2020-07-28;287
2020-07-27;"Prešovský kraj";1;0;0;0;NA;109843;1;2020-07-27;287
2020-07-26;"Prešovský kraj";1;0;0;0;NA;109843;1;2020-07-26;286
2020-07-25;"Prešovský kraj";21;0;0;0;NA;109843;21;2020-07-25;285
2020-07-24;"Prešovský kraj";1;0;0;0;NA;109843;1;2020-07-24;264
2020-07-23;"Prešovský kraj";5;0;0;0;NA;109843;5;2020-07-23;263
2020-07-22;"Prešovský kraj";1;0;0;0;NA;109843;1;2020-07-22;258
2020-07-21;"Prešovský kraj";2;0;0;0;NA;109843;2;2020-07-21;257
2020-07-20;"Prešovský kraj";1;0;0;0;NA;109843;1;2020-07-20;255
2020-07-19;"Prešovský kraj";0;0;0;0;NA;109843;0;2020-07-19;254
2020-07-18;"Prešovský kraj";0;0;0;0;NA;109843;0;2020-07-18;254
2020-07-17;"Prešovský kraj";3;0;0;0;NA;109843;3;2020-07-17;254
2020-07-16;"Prešovský kraj";1;0;0;0;NA;109843;1;2020-07-16;251
2020-07-15;"Prešovský kraj";5;0;0;0;NA;109843;5;2020-07-15;250
2020-07-14;"Prešovský kraj";5;0;0;0;NA;109843;5;2020-07-14;245
2020-07-13;"Prešovský kraj";1;0;0;0;NA;109843;1;2020-07-13;240
2020-07-12;"Prešovský kraj";1;0;0;0;NA;109843;1;2020-07-12;239
2020-07-11;"Prešovský kraj";6;0;0;0;NA;109843;6;2020-07-11;238
2020-07-10;"Prešovský kraj";5;0;0;0;NA;109843;5;2020-07-10;232
2020-07-09;"Prešovský kraj";2;0;0;0;NA;109843;2;2020-07-09;227
2020-07-08;"Prešovský kraj";14;0;0;0;NA;109843;14;2020-07-08;225
2020-07-07;"Prešovský kraj";2;0;0;0;NA;109843;2;2020-07-07;211
2020-07-06;"Prešovský kraj";0;0;0;0;NA;109843;0;2020-07-06;209
2020-07-05;"Prešovský kraj";0;0;0;0;NA;109843;0;2020-07-05;209
2020-07-04;"Prešovský kraj";1;0;0;0;NA;109843;1;2020-07-04;209
2020-07-03;"Prešovský kraj";3;0;0;0;NA;109843;3;2020-07-03;208
2020-07-02;"Prešovský kraj";0;0;0;0;NA;109843;0;2020-07-02;205
2020-07-01;"Prešovský kraj";0;0;0;0;NA;109843;0;2020-07-01;205
2020-06-30;"Prešovský kraj";7;0;0;0;NA;109843;7;2020-06-30;205
2020-06-29;"Prešovský kraj";0;0;0;0;NA;109843;0;2020-06-29;198
2020-06-28;"Prešovský kraj";0;0;0;0;NA;109843;0;2020-06-28;198
2020-06-27;"Prešovský kraj";3;0;0;0;NA;109843;3;2020-06-27;198
2020-06-26;"Prešovský kraj";3;0;0;0;NA;109843;3;2020-06-26;195
2020-06-25;"Prešovský kraj";0;0;0;0;NA;109843;0;2020-06-25;192
2020-06-24;"Prešovský kraj";4;0;0;0;NA;109843;4;2020-06-24;192
2020-06-23;"Prešovský kraj";0;0;0;0;NA;109843;0;2020-06-23;188
2020-06-22;"Prešovský kraj";0;0;0;0;NA;109843;0;2020-06-22;188
2020-06-21;"Prešovský kraj";0;0;0;0;NA;109843;0;2020-06-21;188
2020-06-20;"Prešovský kraj";0;0;0;0;NA;109843;0;2020-06-20;188
2020-06-19;"Prešovský kraj";1;0;0;0;NA;109843;1;2020-06-19;188
2020-06-18;"Prešovský kraj";0;0;0;0;NA;109843;0;2020-06-18;187
2020-06-17;"Prešovský kraj";0;0;0;0;NA;109843;0;2020-06-17;187
2020-06-16;"Prešovský kraj";6;0;0;0;NA;109843;6;2020-06-16;187
2020-06-14;"Prešovský kraj";0;0;0;0;NA;109843;0;2020-06-14;181
2020-06-13;"Prešovský kraj";0;0;0;0;NA;109843;0;2020-06-13;181
2020-06-12;"Prešovský kraj";1;0;0;0;NA;109843;1;2020-06-12;181
2020-06-11;"Prešovský kraj";0;0;0;0;NA;109843;0;2020-06-11;180
2020-06-10;"Prešovský kraj";0;0;0;0;NA;109843;0;2020-06-10;180
2020-06-09;"Prešovský kraj";0;0;0;0;NA;109843;0;2020-06-09;180
2020-06-08;"Prešovský kraj";0;0;0;0;NA;109843;0;2020-06-08;180
2020-06-07;"Prešovský kraj";0;0;0;0;NA;109843;0;2020-06-07;180
2020-06-05;"Prešovský kraj";0;0;0;0;NA;109843;0;2020-06-05;180
2020-06-03;"Prešovský kraj";0;0;0;0;NA;109843;0;2020-06-03;180
2020-06-02;"Prešovský kraj";1;0;0;0;NA;109843;1;2020-06-02;180
2020-05-31;"Prešovský kraj";1;0;0;0;NA;109843;1;2020-05-31;179
2020-05-29;"Prešovský kraj";0;0;0;0;NA;109843;0;2020-05-29;178
2020-05-27;"Prešovský kraj";0;0;0;0;NA;109843;0;2020-05-27;178
2020-05-26;"Prešovský kraj";0;0;0;0;NA;109843;0;2020-05-26;178
2020-05-25;"Prešovský kraj";0;0;0;0;NA;109843;0;2020-05-25;178
2020-05-24;"Prešovský kraj";0;0;0;0;NA;109843;0;2020-05-24;178
2020-05-23;"Prešovský kraj";0;0;0;0;NA;109843;0;2020-05-23;178
2020-05-22;"Prešovský kraj";0;0;0;0;NA;109843;0;2020-05-22;178
2020-05-21;"Prešovský kraj";1;0;0;0;NA;109843;1;2020-05-21;178
2020-05-20;"Prešovský kraj";0;0;0;0;NA;109843;0;2020-05-20;177
2020-05-19;"Prešovský kraj";0;0;0;0;NA;109843;0;2020-05-19;177
2020-05-17;"Prešovský kraj";0;0;0;0;NA;109843;0;2020-05-17;177
2020-05-16;"Prešovský kraj";0;0;0;0;NA;109843;0;2020-05-16;177
2020-05-15;"Prešovský kraj";0;0;0;0;NA;109843;0;2020-05-15;177
2020-05-14;"Prešovský kraj";0;0;0;0;NA;109843;0;2020-05-14;177
2020-05-13;"Prešovský kraj";1;0;0;0;NA;109843;1;2020-05-13;177
2020-05-12;"Prešovský kraj";0;0;0;0;NA;109843;0;2020-05-12;176
2020-05-11;"Prešovský kraj";1;0;0;0;NA;109843;1;2020-05-11;176
2020-05-09;"Prešovský kraj";0;0;0;0;NA;109843;0;2020-05-09;175
2020-05-07;"Prešovský kraj";0;0;0;0;NA;109843;0;2020-05-07;175
2020-05-06;"Prešovský kraj";0;0;0;0;NA;109843;0;2020-05-06;175
2020-05-05;"Prešovský kraj";1;0;0;0;NA;109843;1;2020-05-05;175
2020-05-04;"Prešovský kraj";0;0;0;0;NA;109843;0;2020-05-04;174
2020-05-03;"Prešovský kraj";0;0;0;0;NA;109843;0;2020-05-03;174
2020-05-02;"Prešovský kraj";0;0;0;0;NA;109843;0;2020-05-02;174
2020-05-01;"Prešovský kraj";2;0;0;0;NA;109843;2;2020-05-01;174
2020-04-30;"Prešovský kraj";0;0;0;0;NA;109843;0;2020-04-30;172
2020-04-29;"Prešovský kraj";1;0;0;0;NA;109843;1;2020-04-29;172
2020-04-28;"Prešovský kraj";1;0;0;0;NA;109843;1;2020-04-28;171
2020-04-27;"Prešovský kraj";2;0;0;0;NA;109843;2;2020-04-27;170
2020-04-26;"Prešovský kraj";0;0;0;0;NA;109843;0;2020-04-26;168
2020-04-25;"Prešovský kraj";0;0;0;0;NA;109843;0;2020-04-25;168
2020-04-24;"Prešovský kraj";0;0;0;0;NA;109843;0;2020-04-24;168
2020-04-23;"Prešovský kraj";2;0;0;0;NA;109843;2;2020-04-23;168
2020-04-22;"Prešovský kraj";11;0;0;0;NA;109843;11;2020-04-22;166
2020-04-21;"Prešovský kraj";12;0;0;0;NA;109843;12;2020-04-21;155
2020-04-20;"Prešovský kraj";2;0;0;0;NA;109843;2;2020-04-20;143
2020-04-19;"Prešovský kraj";4;0;0;0;NA;109843;4;2020-04-19;141
2020-04-18;"Prešovský kraj";1;0;0;0;NA;109843;1;2020-04-18;137
2020-04-17;"Prešovský kraj";4;0;0;0;NA;109843;4;2020-04-17;136
2020-04-16;"Prešovský kraj";9;0;0;0;NA;109843;9;2020-04-16;132
2020-04-15;"Prešovský kraj";21;0;0;0;NA;109843;21;2020-04-15;123
2020-04-14;"Prešovský kraj";1;0;0;0;NA;109843;1;2020-04-14;102
2020-04-13;"Prešovský kraj";2;0;0;0;NA;109843;2;2020-04-13;101
2020-04-12;"Prešovský kraj";6;0;0;0;NA;109843;6;2020-04-12;99
2020-04-11;"Prešovský kraj";4;0;0;0;NA;109843;4;2020-04-11;93
2020-04-10;"Prešovský kraj";0;0;0;0;NA;109843;0;2020-04-10;89
2020-04-09;"Prešovský kraj";1;0;0;0;NA;109843;1;2020-04-09;89
2020-04-08;"Prešovský kraj";0;0;0;0;NA;109843;0;2020-04-08;88
2020-04-07;"Prešovský kraj";7;0;0;0;NA;109843;7;2020-04-07;88
2020-04-06;"Prešovský kraj";10;0;0;0;NA;109843;10;2020-04-06;81
2020-04-05;"Prešovský kraj";13;0;0;0;NA;109843;13;2020-04-05;71
2020-04-04;"Prešovský kraj";1;0;0;0;NA;109843;1;2020-04-04;58
2020-04-03;"Prešovský kraj";4;0;0;0;NA;109843;4;2020-04-03;57
2020-04-02;"Prešovský kraj";6;0;0;0;NA;109843;6;2020-04-02;53
2020-04-01;"Prešovský kraj";6;0;0;0;NA;109843;6;2020-04-01;47
2020-03-31;"Prešovský kraj";6;0;0;0;NA;109843;6;2020-03-31;41
2020-03-30;"Prešovský kraj";2;0;0;0;NA;109843;2;2020-03-30;35
2020-03-29;"Prešovský kraj";2;0;0;0;NA;109843;2;2020-03-29;33
2020-03-28;"Prešovský kraj";2;0;0;0;NA;109843;2;2020-03-28;31
2020-03-27;"Prešovský kraj";1;0;0;0;NA;109843;1;2020-03-27;29
2020-03-26;"Prešovský kraj";8;0;0;0;NA;109843;8;2020-03-26;28
2020-03-25;"Prešovský kraj";1;0;0;0;NA;109843;1;2020-03-25;20
2020-03-24;"Prešovský kraj";4;0;0;0;NA;109843;4;2020-03-24;19
2020-03-23;"Prešovský kraj";0;0;0;0;NA;109843;0;2020-03-23;15
2020-03-22;"Prešovský kraj";1;0;0;0;NA;109843;1;2020-03-22;15
2020-03-21;"Prešovský kraj";2;0;0;0;NA;109843;2;2020-03-21;14
2020-03-20;"Prešovský kraj";3;0;0;0;NA;109843;3;2020-03-20;12
2020-03-19;"Prešovský kraj";2;0;0;0;NA;109843;2;2020-03-19;9
2020-03-18;"Prešovský kraj";1;0;0;0;NA;109843;1;2020-03-18;7
2020-03-17;"Prešovský kraj";1;0;0;0;NA;109843;1;2020-03-17;6
2020-03-16;"Prešovský kraj";4;0;0;0;NA;109843;4;2020-03-16;5
2020-03-15;"Prešovský kraj";0;0;0;0;NA;109843;0;2020-03-15;1
2020-03-14;"Prešovský kraj";1;0;0;0;NA;109843;1;2020-03-14;1
2020-03-13;"Prešovský kraj";0;0;0;0;NA;109843;0;2020-03-13;0
2020-03-12;"Prešovský kraj";0;0;0;0;NA;109843;0;2020-03-12;0
2020-03-11;"Prešovský kraj";0;0;0;0;NA;109843;0;2020-03-11;0
2020-03-09;"Prešovský kraj";0;0;0;0;NA;109843;0;2020-03-09;0
2020-03-08;"Prešovský kraj";0;0;0;0;NA;109843;0;2020-03-08;0
2020-03-07;"Prešovský kraj";0;0;0;0;NA;109843;0;2020-03-07;0
2020-03-06;"Prešovský kraj";0;0;0;0;NA;109843;0;2020-03-06;0
2021-04-29;"Trenčiansky kraj";49;11450;47;11497;52040;98056;96;2021-04-29;98056
2021-04-28;"Trenčiansky kraj";79;12460;52;12512;NA;98056;131;2021-04-28;97960
2021-04-27;"Trenčiansky kraj";107;15524;40;15564;NA;98056;147;2021-04-27;97829
2021-04-26;"Trenčiansky kraj";52;20952;63;21015;NA;98056;115;2021-04-26;97682
2021-04-25;"Trenčiansky kraj";0;34992;49;35041;NA;98056;49;2021-04-25;97567
2021-04-24;"Trenčiansky kraj";76;68470;94;68564;NA;98056;170;2021-04-24;97518
2021-04-23;"Trenčiansky kraj";143;29143;79;29222;NA;98056;222;2021-04-23;97348
2021-04-22;"Trenčiansky kraj";71;13847;64;13911;NA;98056;135;2021-04-22;97126
2021-04-21;"Trenčiansky kraj";79;12996;67;13063;NA;98056;146;2021-04-21;96991
2021-04-20;"Trenčiansky kraj";142;17652;80;17732;NA;98056;222;2021-04-20;96845
2021-04-19;"Trenčiansky kraj";102;22630;103;22733;NA;98056;205;2021-04-19;96623
2021-04-18;"Trenčiansky kraj";3;40879;97;40976;NA;98056;100;2021-04-18;96418
2021-04-17;"Trenčiansky kraj";77;81498;136;81634;NA;98056;213;2021-04-17;96318
2021-04-16;"Trenčiansky kraj";100;31361;90;31451;NA;98056;190;2021-04-16;96105
2021-04-15;"Trenčiansky kraj";71;14477;69;14546;NA;98056;140;2021-04-15;95915
2021-04-14;"Trenčiansky kraj";135;15550;72;15622;NA;98056;207;2021-04-14;95775
2021-04-13;"Trenčiansky kraj";189;18713;75;18788;NA;98056;264;2021-04-13;95568
2021-04-12;"Trenčiansky kraj";97;23743;91;23834;NA;98056;188;2021-04-12;95304
2021-04-11;"Trenčiansky kraj";1;34738;72;34810;NA;98056;73;2021-04-11;95116
2021-04-10;"Trenčiansky kraj";81;83093;145;83238;NA;98056;226;2021-04-10;95043
2021-04-09;"Trenčiansky kraj";120;27993;91;28084;NA;98056;211;2021-04-09;94817
2021-04-08;"Trenčiansky kraj";112;13282;85;13367;NA;98056;197;2021-04-08;94606
2021-04-07;"Trenčiansky kraj";204;17689;122;17811;NA;98056;326;2021-04-07;94409
2021-04-06;"Trenčiansky kraj";157;28622;178;28800;NA;98056;335;2021-04-06;94083
2021-04-05;"Trenčiansky kraj";15;9227;64;9291;NA;98056;79;2021-04-05;93748
2021-04-04;"Trenčiansky kraj";2;20291;85;20376;NA;98056;87;2021-04-04;93669
2021-04-03;"Trenčiansky kraj";86;80473;221;80694;NA;98056;307;2021-04-03;93582
2021-04-02;"Trenčiansky kraj";126;21531;80;21611;NA;98056;206;2021-04-02;93275
2021-04-01;"Trenčiansky kraj";159;32375;139;32514;NA;98056;298;2021-04-01;93069
2021-03-31;"Trenčiansky kraj";198;20100;130;20230;NA;98056;328;2021-03-31;92771
2021-03-30;"Trenčiansky kraj";272;17304;136;17440;NA;98056;408;2021-03-30;92443
2021-03-29;"Trenčiansky kraj";142;19478;170;19648;NA;98056;312;2021-03-29;92035
2021-03-28;"Trenčiansky kraj";3;34756;116;34872;NA;98056;119;2021-03-28;91723
2021-03-27;"Trenčiansky kraj";130;77314;293;77607;NA;98056;423;2021-03-27;91604
2021-03-26;"Trenčiansky kraj";211;35052;157;35209;NA;98056;368;2021-03-26;91181
2021-03-25;"Trenčiansky kraj";184;16579;176;16755;NA;98056;360;2021-03-25;90813
2021-03-24;"Trenčiansky kraj";259;13099;171;13270;NA;98056;430;2021-03-24;90453
2021-03-23;"Trenčiansky kraj";349;17588;174;17762;NA;98056;523;2021-03-23;90023
2021-03-22;"Trenčiansky kraj";141;21118;213;21331;NA;98056;354;2021-03-22;89500
2021-03-21;"Trenčiansky kraj";85;32709;164;32873;NA;98056;249;2021-03-21;89146
2021-03-20;"Trenčiansky kraj";128;80035;322;80357;NA;98056;450;2021-03-20;88897
2021-03-19;"Trenčiansky kraj";231;34784;232;35016;NA;98056;463;2021-03-19;88447
2021-03-18;"Trenčiansky kraj";262;16105;178;16283;NA;98056;440;2021-03-18;87984
2021-03-17;"Trenčiansky kraj";366;13436;163;13599;NA;98056;529;2021-03-17;87544
2021-03-16;"Trenčiansky kraj";450;15281;241;15522;NA;98056;691;2021-03-16;87015
2021-03-15;"Trenčiansky kraj";162;21235;261;21496;NA;98056;423;2021-03-15;86324
2021-03-14;"Trenčiansky kraj";42;33890;233;34123;NA;98056;275;2021-03-14;85901
2021-03-13;"Trenčiansky kraj";270;79187;453;79640;NA;98056;723;2021-03-13;85626
2021-03-12;"Trenčiansky kraj";366;34783;307;35090;NA;98056;673;2021-03-12;84903
2021-03-11;"Trenčiansky kraj";302;15557;213;15770;NA;98056;515;2021-03-11;84230
2021-03-10;"Trenčiansky kraj";402;13585;237;13822;NA;98056;639;2021-03-10;83715
2021-03-09;"Trenčiansky kraj";586;17982;285;18267;NA;98056;871;2021-03-09;83076
2021-03-08;"Trenčiansky kraj";174;21431;358;21789;NA;98056;532;2021-03-08;82205
2021-03-07;"Trenčiansky kraj";4;33991;318;34309;NA;98056;322;2021-03-07;81673
2021-03-06;"Trenčiansky kraj";260;79134;527;79661;NA;98056;787;2021-03-06;81351
2021-03-05;"Trenčiansky kraj";326;32946;416;33362;NA;98056;742;2021-03-05;80564
2021-03-04;"Trenčiansky kraj";323;16820;315;17135;NA;98056;638;2021-03-04;79822
2021-03-03;"Trenčiansky kraj";413;13953;346;14299;NA;98056;759;2021-03-03;79184
2021-03-02;"Trenčiansky kraj";612;17797;344;18141;NA;98056;956;2021-03-02;78425
2021-03-01;"Trenčiansky kraj";217;21127;445;21572;NA;98056;662;2021-03-01;77469
2021-02-28;"Trenčiansky kraj";45;30238;376;30614;NA;98056;421;2021-02-28;76807
2021-02-27;"Trenčiansky kraj";277;78732;686;79418;NA;98056;963;2021-02-27;76386
2021-02-26;"Trenčiansky kraj";420;32932;435;33367;NA;98056;855;2021-02-26;75423
2021-02-25;"Trenčiansky kraj";424;14029;328;14357;NA;98056;752;2021-02-25;74568
2021-02-24;"Trenčiansky kraj";427;12002;399;12401;NA;98056;826;2021-02-24;73816
2021-02-23;"Trenčiansky kraj";577;14904;390;15294;NA;98056;967;2021-02-23;72990
2021-02-22;"Trenčiansky kraj";160;19969;468;20437;NA;98056;628;2021-02-22;72023
2021-02-21;"Trenčiansky kraj";64;29478;392;29870;NA;98056;456;2021-02-21;71395
2021-02-20;"Trenčiansky kraj";274;77840;745;78585;NA;98056;1019;2021-02-20;70939
2021-02-19;"Trenčiansky kraj";272;30245;520;30765;NA;98056;792;2021-02-19;69920
2021-02-18;"Trenčiansky kraj";355;14378;410;14788;NA;98056;765;2021-02-18;69128
2021-02-17;"Trenčiansky kraj";363;11399;376;11775;NA;98056;739;2021-02-17;68363
2021-02-16;"Trenčiansky kraj";488;17761;406;18167;NA;98056;894;2021-02-16;67624
2021-02-15;"Trenčiansky kraj";151;21846;463;22309;NA;98056;614;2021-02-15;66730
2021-02-14;"Trenčiansky kraj";2;31255;324;31579;NA;98056;326;2021-02-14;66116
2021-02-13;"Trenčiansky kraj";274;63006;522;63528;NA;98056;796;2021-02-13;65790
2021-02-12;"Trenčiansky kraj";276;27966;412;28378;NA;98056;688;2021-02-12;64994
2021-02-11;"Trenčiansky kraj";291;11566;323;11889;NA;98056;614;2021-02-11;64306
2021-02-10;"Trenčiansky kraj";304;11402;317;11719;NA;98056;621;2021-02-10;63692
2021-02-09;"Trenčiansky kraj";514;18401;360;18761;NA;98056;874;2021-02-09;63071
2021-02-08;"Trenčiansky kraj";182;26972;430;27402;NA;98056;612;2021-02-08;62197
2021-02-07;"Trenčiansky kraj";31;36772;341;37113;NA;98056;372;2021-02-07;61585
2021-02-06;"Trenčiansky kraj";216;63931;560;64491;NA;98056;776;2021-02-06;61213
2021-02-05;"Trenčiansky kraj";202;18154;367;18521;NA;98056;569;2021-02-05;60437
2021-02-04;"Trenčiansky kraj";266;7013;279;7292;NA;98056;545;2021-02-04;59868
2021-02-03;"Trenčiansky kraj";162;6677;320;6997;NA;98056;482;2021-02-03;59323
2021-02-02;"Trenčiansky kraj";347;8058;380;8438;NA;98056;727;2021-02-02;58841
2021-02-01;"Trenčiansky kraj";167;8917;311;9228;NA;98056;478;2021-02-01;58114
2021-01-31;"Trenčiansky kraj";7;19103;159;19262;NA;98056;166;2021-01-31;57636
2021-01-30;"Trenčiansky kraj";228;38167;332;38499;NA;98056;560;2021-01-30;57470
2021-01-29;"Trenčiansky kraj";214;7586;235;7821;NA;98056;449;2021-01-29;56910
2021-01-28;"Trenčiansky kraj";307;5442;158;5600;NA;98056;465;2021-01-28;56461
2021-01-27;"Trenčiansky kraj";166;4842;181;5023;NA;98056;347;2021-01-27;55996
2021-01-26;"Trenčiansky kraj";303;14585;250;14835;NA;98056;553;2021-01-26;55649
2021-01-25;"Trenčiansky kraj";160;24302;207;24509;NA;98056;367;2021-01-25;55096
2021-01-24;"Trenčiansky kraj";51;38369;282;38651;NA;98056;333;2021-01-24;54729
2021-01-23;"Trenčiansky kraj";206;114125;749;114874;NA;98056;955;2021-01-23;54396
2021-01-22;"Trenčiansky kraj";148;21833;242;22075;NA;98056;390;2021-01-22;53441
2021-01-21;"Trenčiansky kraj";143;8582;166;8748;NA;98056;309;2021-01-21;53051
2021-01-20;"Trenčiansky kraj";181;8189;227;8416;NA;98056;408;2021-01-20;52742
2021-01-19;"Trenčiansky kraj";363;6618;262;6880;NA;98056;625;2021-01-19;52334
2021-01-18;"Trenčiansky kraj";72;4970;321;5291;NA;98056;393;2021-01-18;51709
2021-01-17;"Trenčiansky kraj";124;156;11;167;NA;98056;135;2021-01-17;51316
2021-01-16;"Trenčiansky kraj";39;1288;53;1341;NA;98056;92;2021-01-16;51181
2021-01-15;"Trenčiansky kraj";264;4029;218;4247;NA;98056;482;2021-01-15;51089
2021-01-14;"Trenčiansky kraj";275;3193;189;3382;NA;98056;464;2021-01-14;50607
2021-01-13;"Trenčiansky kraj";222;3893;215;4108;NA;98056;437;2021-01-13;50143
2021-01-12;"Trenčiansky kraj";508;4604;261;4865;NA;98056;769;2021-01-12;49706
2021-01-11;"Trenčiansky kraj";142;4367;354;4721;NA;98056;496;2021-01-11;48937
2021-01-10;"Trenčiansky kraj";89;4969;77;5046;NA;98056;166;2021-01-10;48441
2021-01-09;"Trenčiansky kraj";276;8280;128;8408;NA;98056;404;2021-01-09;48275
2021-01-08;"Trenčiansky kraj";489;6434;484;6918;NA;98056;973;2021-01-08;47871
2021-01-07;"Trenčiansky kraj";420;6138;577;6715;NA;98056;997;2021-01-07;46898
2021-01-06;"Trenčiansky kraj";221;1021;64;1085;NA;98056;285;2021-01-06;45901
2021-01-05;"Trenčiansky kraj";669;5753;706;6459;NA;98056;1375;2021-01-05;45616
2021-01-04;"Trenčiansky kraj";337;5248;782;6030;NA;98056;1119;2021-01-04;44241
2021-01-03;"Trenčiansky kraj";38;114;15;129;NA;98056;53;2021-01-03;43122
2021-01-02;"Trenčiansky kraj";129;196;23;219;NA;98056;152;2021-01-02;43069
2021-01-01;"Trenčiansky kraj";329;347;23;370;NA;98056;352;2021-01-01;42917
2020-12-31;"Trenčiansky kraj";597;4943;557;5500;NA;98056;1154;2020-12-31;42565
2020-12-30;"Trenčiansky kraj";836;7012;762;7774;NA;98056;1598;2020-12-30;41411
2020-12-29;"Trenčiansky kraj";459;6191;1018;7209;NA;98056;1477;2020-12-29;39813
2020-12-28;"Trenčiansky kraj";258;4195;777;4972;NA;98056;1035;2020-12-28;38336
2020-12-27;"Trenčiansky kraj";5;208;36;244;NA;98056;41;2020-12-27;37301
2020-12-26;"Trenčiansky kraj";174;74;10;84;NA;98056;184;2020-12-26;37260
2020-12-25;"Trenčiansky kraj";251;325;47;372;NA;98056;298;2020-12-25;37076
2020-12-24;"Trenčiansky kraj";552;2194;256;2450;NA;98056;808;2020-12-24;36778
2020-12-23;"Trenčiansky kraj";421;6552;661;7213;NA;98056;1082;2020-12-23;35970
2020-12-22;"Trenčiansky kraj";673;5760;694;6454;NA;98056;1367;2020-12-22;34888
2020-12-21;"Trenčiansky kraj";248;13321;956;14277;NA;98056;1204;2020-12-21;33521
2020-12-20;"Trenčiansky kraj";238;12504;292;12796;NA;98056;530;2020-12-20;32317
2020-12-19;"Trenčiansky kraj";341;1611;150;1761;NA;98056;491;2020-12-19;31787
2020-12-18;"Trenčiansky kraj";521;5199;615;5814;NA;98056;1136;2020-12-18;31296
2020-12-17;"Trenčiansky kraj";670;3843;524;4367;NA;98056;1194;2020-12-17;30160
2020-12-16;"Trenčiansky kraj";461;4464;647;5111;NA;98056;1108;2020-12-16;28966
2020-12-15;"Trenčiansky kraj";595;3805;670;4475;NA;98056;1265;2020-12-15;27858
2020-12-14;"Trenčiansky kraj";318;3194;613;3807;NA;98056;931;2020-12-14;26593
2020-12-13;"Trenčiansky kraj";77;49;6;55;NA;98056;83;2020-12-13;25662
2020-12-12;"Trenčiansky kraj";314;1191;132;1323;NA;98056;446;2020-12-12;25579
2020-12-11;"Trenčiansky kraj";751;4066;479;4545;NA;98056;1230;2020-12-11;25133
2020-12-10;"Trenčiansky kraj";271;3354;473;3827;NA;98056;744;2020-12-10;23903
2020-12-09;"Trenčiansky kraj";508;3788;466;4254;NA;98056;974;2020-12-09;23159
2020-12-08;"Trenčiansky kraj";546;3440;522;3962;NA;98056;1068;2020-12-08;22185
2020-12-07;"Trenčiansky kraj";258;3832;468;4300;NA;98056;726;2020-12-07;21117
2020-12-06;"Trenčiansky kraj";114;187;11;198;NA;98056;125;2020-12-06;20391
2020-12-05;"Trenčiansky kraj";223;616;56;672;NA;98056;279;2020-12-05;20266
2020-12-04;"Trenčiansky kraj";253;2989;273;3262;NA;98056;526;2020-12-04;19987
2020-12-03;"Trenčiansky kraj";503;1739;179;1918;NA;98056;682;2020-12-03;19461
2020-12-02;"Trenčiansky kraj";418;1887;232;2119;NA;98056;650;2020-12-02;18779
2020-12-01;"Trenčiansky kraj";321;5705;353;6058;NA;98056;674;2020-12-01;18129
2020-11-30;"Trenčiansky kraj";167;11514;520;12034;NA;98056;687;2020-11-30;17455
2020-11-29;"Trenčiansky kraj";29;30;5;35;NA;98056;34;2020-11-29;16768
2020-11-28;"Trenčiansky kraj";202;1051;93;1144;NA;98056;295;2020-11-28;16734
2020-11-27;"Trenčiansky kraj";330;1888;186;2074;NA;98056;516;2020-11-27;16439
2020-11-26;"Trenčiansky kraj";395;1252;122;1374;NA;98056;517;2020-11-26;15923
2020-11-25;"Trenčiansky kraj";322;1444;160;1604;NA;98056;482;2020-11-25;15406
2020-11-24;"Trenčiansky kraj";348;2553;308;2861;NA;98056;656;2020-11-24;14924
2020-11-23;"Trenčiansky kraj";159;1186;122;1308;NA;98056;281;2020-11-23;14268
2020-11-22;"Trenčiansky kraj";26;30;7;37;NA;98056;33;2020-11-22;13987
2020-11-21;"Trenčiansky kraj";255;1376;69;1445;NA;98056;324;2020-11-21;13954
2020-11-20;"Trenčiansky kraj";316;861;93;954;NA;98056;409;2020-11-20;13630
2020-11-19;"Trenčiansky kraj";316;740;113;853;NA;98056;429;2020-11-19;13221
2020-11-18;"Trenčiansky kraj";233;379;66;445;NA;98056;299;2020-11-18;12792
2020-11-17;"Trenčiansky kraj";222;106;15;121;NA;98056;237;2020-11-17;12493
2020-11-16;"Trenčiansky kraj";245;236;45;281;NA;98056;290;2020-11-16;12256
2020-11-15;"Trenčiansky kraj";109;29;6;35;NA;98056;115;2020-11-15;11966
2020-11-14;"Trenčiansky kraj";190;74;11;85;NA;98056;201;2020-11-14;11851
2020-11-13;"Trenčiansky kraj";308;131;13;144;NA;98056;321;2020-11-13;11650
2020-11-12;"Trenčiansky kraj";324;124;5;129;NA;98056;329;2020-11-12;11329
2020-11-11;"Trenčiansky kraj";366;113;10;123;NA;98056;376;2020-11-11;11000
2020-11-10;"Trenčiansky kraj";277;106;6;112;NA;98056;283;2020-11-10;10624
2020-11-09;"Trenčiansky kraj";115;1407;48;1455;NA;98056;163;2020-11-09;10341
2020-11-08;"Trenčiansky kraj";81;1271;8;1279;NA;98056;89;2020-11-08;10178
2020-11-07;"Trenčiansky kraj";319;3662;59;3721;NA;98056;378;2020-11-07;10089
2020-11-06;"Trenčiansky kraj";383;6893;84;6977;NA;98056;467;2020-11-06;9711
2020-11-05;"Trenčiansky kraj";399;98;15;113;NA;98056;414;2020-11-05;9244
2020-11-04;"Trenčiansky kraj";370;91;9;100;NA;98056;379;2020-11-04;8830
2020-11-03;"Trenčiansky kraj";575;97;8;105;NA;98056;583;2020-11-03;8451
2020-11-02;"Trenčiansky kraj";197;1833;68;1901;NA;98056;265;2020-11-02;7868
2020-11-01;"Trenčiansky kraj";257;808;24;832;NA;98056;281;2020-11-01;7603
2020-10-31;"Trenčiansky kraj";332;4719;82;4801;NA;98056;414;2020-10-31;7322
2020-10-30;"Trenčiansky kraj";299;5283;102;5385;NA;98056;401;2020-10-30;6908
2020-10-29;"Trenčiansky kraj";496;764;68;832;NA;98056;564;2020-10-29;6507
2020-10-28;"Trenčiansky kraj";269;192;33;225;NA;98056;302;2020-10-28;5943
2020-10-27;"Trenčiansky kraj";473;127;27;154;NA;98056;500;2020-10-27;5641
2020-10-26;"Trenčiansky kraj";177;107;36;143;NA;98056;213;2020-10-26;5141
2020-10-25;"Trenčiansky kraj";138;9;5;14;NA;98056;143;2020-10-25;4928
2020-10-24;"Trenčiansky kraj";395;128;6;134;NA;98056;401;2020-10-24;4785
2020-10-23;"Trenčiansky kraj";301;154;8;162;NA;98056;309;2020-10-23;4384
2020-10-22;"Trenčiansky kraj";273;82;12;94;NA;98056;285;2020-10-22;4075
2020-10-21;"Trenčiansky kraj";183;53;9;62;NA;98056;192;2020-10-21;3790
2020-10-20;"Trenčiansky kraj";212;47;6;53;NA;98056;218;2020-10-20;3598
2020-10-19;"Trenčiansky kraj";41;83;25;108;NA;98056;66;2020-10-19;3380
2020-10-18;"Trenčiansky kraj";104;0;0;0;NA;98056;104;2020-10-18;3314
2020-10-17;"Trenčiansky kraj";157;0;0;0;NA;98056;157;2020-10-17;3210
2020-10-16;"Trenčiansky kraj";225;42;6;48;NA;98056;231;2020-10-16;3053
2020-10-15;"Trenčiansky kraj";255;39;4;43;NA;98056;259;2020-10-15;2822
2020-10-14;"Trenčiansky kraj";162;42;7;49;NA;98056;169;2020-10-14;2563
2020-10-13;"Trenčiansky kraj";124;105;12;117;NA;98056;136;2020-10-13;2394
2020-10-12;"Trenčiansky kraj";55;0;0;0;NA;98056;55;2020-10-12;2258
2020-10-11;"Trenčiansky kraj";73;0;0;0;NA;98056;73;2020-10-11;2203
2020-10-10;"Trenčiansky kraj";180;0;0;0;NA;98056;180;2020-10-10;2130
2020-10-09;"Trenčiansky kraj";198;0;0;0;NA;98056;198;2020-10-09;1950
2020-10-08;"Trenčiansky kraj";115;0;0;0;NA;98056;115;2020-10-08;1752
2020-10-07;"Trenčiansky kraj";75;0;0;0;NA;98056;75;2020-10-07;1637
2020-10-06;"Trenčiansky kraj";72;0;0;0;NA;98056;72;2020-10-06;1562
2020-10-05;"Trenčiansky kraj";32;0;0;0;NA;98056;32;2020-10-05;1490
2020-10-04;"Trenčiansky kraj";37;0;0;0;NA;98056;37;2020-10-04;1458
2020-10-03;"Trenčiansky kraj";79;0;0;0;NA;98056;79;2020-10-03;1421
2020-10-02;"Trenčiansky kraj";69;0;0;0;NA;98056;69;2020-10-02;1342
2020-10-01;"Trenčiansky kraj";58;0;0;0;NA;98056;58;2020-10-01;1273
2020-09-30;"Trenčiansky kraj";76;0;0;0;NA;98056;76;2020-09-30;1215
2020-09-29;"Trenčiansky kraj";43;0;0;0;NA;98056;43;2020-09-29;1139
2020-09-28;"Trenčiansky kraj";7;0;0;0;NA;98056;7;2020-09-28;1096
2020-09-27;"Trenčiansky kraj";12;0;0;0;NA;98056;12;2020-09-27;1089
2020-09-26;"Trenčiansky kraj";37;0;0;0;NA;98056;37;2020-09-26;1077
2020-09-25;"Trenčiansky kraj";72;0;0;0;NA;98056;72;2020-09-25;1040
2020-09-24;"Trenčiansky kraj";41;0;0;0;NA;98056;41;2020-09-24;968
2020-09-23;"Trenčiansky kraj";32;0;0;0;NA;98056;32;2020-09-23;927
2020-09-22;"Trenčiansky kraj";26;0;0;0;NA;98056;26;2020-09-22;895
2020-09-21;"Trenčiansky kraj";23;0;0;0;NA;98056;23;2020-09-21;869
2020-09-20;"Trenčiansky kraj";21;0;0;0;NA;98056;21;2020-09-20;846
2020-09-19;"Trenčiansky kraj";20;0;0;0;NA;98056;20;2020-09-19;825
2020-09-18;"Trenčiansky kraj";41;0;0;0;NA;98056;41;2020-09-18;805
2020-09-17;"Trenčiansky kraj";20;0;0;0;NA;98056;20;2020-09-17;764
2020-09-16;"Trenčiansky kraj";14;0;0;0;NA;98056;14;2020-09-16;744
2020-09-15;"Trenčiansky kraj";8;0;0;0;NA;98056;8;2020-09-15;730
2020-09-14;"Trenčiansky kraj";5;0;0;0;NA;98056;5;2020-09-14;722
2020-09-13;"Trenčiansky kraj";12;0;0;0;NA;98056;12;2020-09-13;717
2020-09-12;"Trenčiansky kraj";2;0;0;0;NA;98056;2;2020-09-12;705
2020-09-11;"Trenčiansky kraj";27;0;0;0;NA;98056;27;2020-09-11;703
2020-09-10;"Trenčiansky kraj";15;0;0;0;NA;98056;15;2020-09-10;676
2020-09-09;"Trenčiansky kraj";11;0;0;0;NA;98056;11;2020-09-09;661
2020-09-08;"Trenčiansky kraj";12;0;0;0;NA;98056;12;2020-09-08;650
2020-09-07;"Trenčiansky kraj";6;0;0;0;NA;98056;6;2020-09-07;638
2020-09-06;"Trenčiansky kraj";1;0;0;0;NA;98056;1;2020-09-06;632
2020-09-05;"Trenčiansky kraj";3;0;0;0;NA;98056;3;2020-09-05;631
2020-09-04;"Trenčiansky kraj";9;0;0;0;NA;98056;9;2020-09-04;628
2020-09-03;"Trenčiansky kraj";10;0;0;0;NA;98056;10;2020-09-03;619
2020-09-02;"Trenčiansky kraj";5;0;0;0;NA;98056;5;2020-09-02;609
2020-09-01;"Trenčiansky kraj";1;0;0;0;NA;98056;1;2020-09-01;604
2020-08-31;"Trenčiansky kraj";12;0;0;0;NA;98056;12;2020-08-31;603
2020-08-30;"Trenčiansky kraj";0;0;0;0;NA;98056;0;2020-08-30;591
2020-08-29;"Trenčiansky kraj";1;0;0;0;NA;98056;1;2020-08-29;591
2020-08-28;"Trenčiansky kraj";12;0;0;0;NA;98056;12;2020-08-28;590
2020-08-27;"Trenčiansky kraj";10;0;0;0;NA;98056;10;2020-08-27;578
2020-08-26;"Trenčiansky kraj";15;0;0;0;NA;98056;15;2020-08-26;568
2020-08-25;"Trenčiansky kraj";12;0;0;0;NA;98056;12;2020-08-25;553
2020-08-24;"Trenčiansky kraj";4;0;0;0;NA;98056;4;2020-08-24;541
2020-08-23;"Trenčiansky kraj";5;0;0;0;NA;98056;5;2020-08-23;537
2020-08-22;"Trenčiansky kraj";6;0;0;0;NA;98056;6;2020-08-22;532
2020-08-21;"Trenčiansky kraj";6;0;0;0;NA;98056;6;2020-08-21;526
2020-08-20;"Trenčiansky kraj";20;0;0;0;NA;98056;20;2020-08-20;520
2020-08-19;"Trenčiansky kraj";17;0;0;0;NA;98056;17;2020-08-19;500
2020-08-18;"Trenčiansky kraj";9;0;0;0;NA;98056;9;2020-08-18;483
2020-08-17;"Trenčiansky kraj";4;0;0;0;NA;98056;4;2020-08-17;474
2020-08-16;"Trenčiansky kraj";0;0;0;0;NA;98056;0;2020-08-16;470
2020-08-15;"Trenčiansky kraj";9;0;0;0;NA;98056;9;2020-08-15;470
2020-08-14;"Trenčiansky kraj";15;0;0;0;NA;98056;15;2020-08-14;461
2020-08-13;"Trenčiansky kraj";23;0;0;0;NA;98056;23;2020-08-13;446
2020-08-12;"Trenčiansky kraj";6;0;0;0;NA;98056;6;2020-08-12;423
2020-08-11;"Trenčiansky kraj";7;0;0;0;NA;98056;7;2020-08-11;417
2020-08-10;"Trenčiansky kraj";9;0;0;0;NA;98056;9;2020-08-10;410
2020-08-09;"Trenčiansky kraj";1;0;0;0;NA;98056;1;2020-08-09;401
2020-08-08;"Trenčiansky kraj";4;0;0;0;NA;98056;4;2020-08-08;400
2020-08-07;"Trenčiansky kraj";4;0;0;0;NA;98056;4;2020-08-07;396
2020-08-06;"Trenčiansky kraj";13;0;0;0;NA;98056;13;2020-08-06;392
2020-08-05;"Trenčiansky kraj";39;0;0;0;NA;98056;39;2020-08-05;379
2020-08-04;"Trenčiansky kraj";9;0;0;0;NA;98056;9;2020-08-04;340
2020-08-03;"Trenčiansky kraj";0;0;0;0;NA;98056;0;2020-08-03;331
2020-08-02;"Trenčiansky kraj";2;0;0;0;NA;98056;2;2020-08-02;331
2020-08-01;"Trenčiansky kraj";6;0;0;0;NA;98056;6;2020-08-01;329
2020-07-31;"Trenčiansky kraj";16;0;0;0;NA;98056;16;2020-07-31;323
2020-07-30;"Trenčiansky kraj";4;0;0;0;NA;98056;4;2020-07-30;307
2020-07-29;"Trenčiansky kraj";5;0;0;0;NA;98056;5;2020-07-29;303
2020-07-28;"Trenčiansky kraj";11;0;0;0;NA;98056;11;2020-07-28;298
2020-07-27;"Trenčiansky kraj";4;0;0;0;NA;98056;4;2020-07-27;287
2020-07-26;"Trenčiansky kraj";1;0;0;0;NA;98056;1;2020-07-26;283
2020-07-25;"Trenčiansky kraj";7;0;0;0;NA;98056;7;2020-07-25;282
2020-07-24;"Trenčiansky kraj";5;0;0;0;NA;98056;5;2020-07-24;275
2020-07-23;"Trenčiansky kraj";10;0;0;0;NA;98056;10;2020-07-23;270
2020-07-22;"Trenčiansky kraj";11;0;0;0;NA;98056;11;2020-07-22;260
2020-07-21;"Trenčiansky kraj";6;0;0;0;NA;98056;6;2020-07-21;249
2020-07-20;"Trenčiansky kraj";13;0;0;0;NA;98056;13;2020-07-20;243
2020-07-19;"Trenčiansky kraj";0;0;0;0;NA;98056;0;2020-07-19;230
2020-07-18;"Trenčiansky kraj";0;0;0;0;NA;98056;0;2020-07-18;230
2020-07-17;"Trenčiansky kraj";1;0;0;0;NA;98056;1;2020-07-17;230
2020-07-16;"Trenčiansky kraj";0;0;0;0;NA;98056;0;2020-07-16;229
2020-07-15;"Trenčiansky kraj";2;0;0;0;NA;98056;2;2020-07-15;229
2020-07-14;"Trenčiansky kraj";8;0;0;0;NA;98056;8;2020-07-14;227
2020-07-13;"Trenčiansky kraj";1;0;0;0;NA;98056;1;2020-07-13;219
2020-07-12;"Trenčiansky kraj";0;0;0;0;NA;98056;0;2020-07-12;218
2020-07-11;"Trenčiansky kraj";0;0;0;0;NA;98056;0;2020-07-11;218
2020-07-10;"Trenčiansky kraj";3;0;0;0;NA;98056;3;2020-07-10;218
2020-07-09;"Trenčiansky kraj";2;0;0;0;NA;98056;2;2020-07-09;215
2020-07-08;"Trenčiansky kraj";1;0;0;0;NA;98056;1;2020-07-08;213
2020-07-07;"Trenčiansky kraj";9;0;0;0;NA;98056;9;2020-07-07;212
2020-07-06;"Trenčiansky kraj";1;0;0;0;NA;98056;1;2020-07-06;203
2020-07-05;"Trenčiansky kraj";1;0;0;0;NA;98056;1;2020-07-05;202
2020-07-04;"Trenčiansky kraj";0;0;0;0;NA;98056;0;2020-07-04;201
2020-07-03;"Trenčiansky kraj";2;0;0;0;NA;98056;2;2020-07-03;201
2020-07-02;"Trenčiansky kraj";10;0;0;0;NA;98056;10;2020-07-02;199
2020-07-01;"Trenčiansky kraj";1;0;0;0;NA;98056;1;2020-07-01;189
2020-06-30;"Trenčiansky kraj";6;0;0;0;NA;98056;6;2020-06-30;188
2020-06-29;"Trenčiansky kraj";1;0;0;0;NA;98056;1;2020-06-29;182
2020-06-28;"Trenčiansky kraj";0;0;0;0;NA;98056;0;2020-06-28;181
2020-06-27;"Trenčiansky kraj";0;0;0;0;NA;98056;0;2020-06-27;181
2020-06-26;"Trenčiansky kraj";0;0;0;0;NA;98056;0;2020-06-26;181
2020-06-25;"Trenčiansky kraj";2;0;0;0;NA;98056;2;2020-06-25;181
2020-06-24;"Trenčiansky kraj";1;0;0;0;NA;98056;1;2020-06-24;179
2020-06-23;"Trenčiansky kraj";0;0;0;0;NA;98056;0;2020-06-23;178
2020-06-22;"Trenčiansky kraj";0;0;0;0;NA;98056;0;2020-06-22;178
2020-06-21;"Trenčiansky kraj";0;0;0;0;NA;98056;0;2020-06-21;178
2020-06-20;"Trenčiansky kraj";0;0;0;0;NA;98056;0;2020-06-20;178
2020-06-19;"Trenčiansky kraj";0;0;0;0;NA;98056;0;2020-06-19;178
2020-06-18;"Trenčiansky kraj";0;0;0;0;NA;98056;0;2020-06-18;178
2020-06-17;"Trenčiansky kraj";0;0;0;0;NA;98056;0;2020-06-17;178
2020-06-16;"Trenčiansky kraj";0;0;0;0;NA;98056;0;2020-06-16;178
2020-06-14;"Trenčiansky kraj";0;0;0;0;NA;98056;0;2020-06-14;178
2020-06-13;"Trenčiansky kraj";0;0;0;0;NA;98056;0;2020-06-13;178
2020-06-12;"Trenčiansky kraj";0;0;0;0;NA;98056;0;2020-06-12;178
2020-06-11;"Trenčiansky kraj";0;0;0;0;NA;98056;0;2020-06-11;178
2020-06-10;"Trenčiansky kraj";1;0;0;0;NA;98056;1;2020-06-10;178
2020-06-09;"Trenčiansky kraj";0;0;0;0;NA;98056;0;2020-06-09;177
2020-06-08;"Trenčiansky kraj";0;0;0;0;NA;98056;0;2020-06-08;177
2020-06-07;"Trenčiansky kraj";0;0;0;0;NA;98056;0;2020-06-07;177
2020-06-05;"Trenčiansky kraj";0;0;0;0;NA;98056;0;2020-06-05;177
2020-06-03;"Trenčiansky kraj";0;0;0;0;NA;98056;0;2020-06-03;177
2020-06-02;"Trenčiansky kraj";0;0;0;0;NA;98056;0;2020-06-02;177
2020-05-31;"Trenčiansky kraj";0;0;0;0;NA;98056;0;2020-05-31;177
2020-05-29;"Trenčiansky kraj";0;0;0;0;NA;98056;0;2020-05-29;177
2020-05-27;"Trenčiansky kraj";2;0;0;0;NA;98056;2;2020-05-27;177
2020-05-26;"Trenčiansky kraj";0;0;0;0;NA;98056;0;2020-05-26;175
2020-05-25;"Trenčiansky kraj";0;0;0;0;NA;98056;0;2020-05-25;175
2020-05-24;"Trenčiansky kraj";0;0;0;0;NA;98056;0;2020-05-24;175
2020-05-23;"Trenčiansky kraj";0;0;0;0;NA;98056;0;2020-05-23;175
2020-05-22;"Trenčiansky kraj";0;0;0;0;NA;98056;0;2020-05-22;175
2020-05-21;"Trenčiansky kraj";0;0;0;0;NA;98056;0;2020-05-21;175
2020-05-20;"Trenčiansky kraj";0;0;0;0;NA;98056;0;2020-05-20;175
2020-05-19;"Trenčiansky kraj";0;0;0;0;NA;98056;0;2020-05-19;175
2020-05-17;"Trenčiansky kraj";0;0;0;0;NA;98056;0;2020-05-17;175
2020-05-16;"Trenčiansky kraj";0;0;0;0;NA;98056;0;2020-05-16;175
2020-05-15;"Trenčiansky kraj";1;0;0;0;NA;98056;1;2020-05-15;175
2020-05-14;"Trenčiansky kraj";2;0;0;0;NA;98056;2;2020-05-14;174
2020-05-13;"Trenčiansky kraj";1;0;0;0;NA;98056;1;2020-05-13;172
2020-05-12;"Trenčiansky kraj";1;0;0;0;NA;98056;1;2020-05-12;171
2020-05-11;"Trenčiansky kraj";3;0;0;0;NA;98056;3;2020-05-11;170
2020-05-09;"Trenčiansky kraj";2;0;0;0;NA;98056;2;2020-05-09;167
2020-05-07;"Trenčiansky kraj";6;0;0;0;NA;98056;6;2020-05-07;165
2020-05-06;"Trenčiansky kraj";0;0;0;0;NA;98056;0;2020-05-06;159
2020-05-05;"Trenčiansky kraj";2;0;0;0;NA;98056;2;2020-05-05;159
2020-05-04;"Trenčiansky kraj";0;0;0;0;NA;98056;0;2020-05-04;157
2020-05-03;"Trenčiansky kraj";0;0;0;0;NA;98056;0;2020-05-03;157
2020-05-02;"Trenčiansky kraj";0;0;0;0;NA;98056;0;2020-05-02;157
2020-05-01;"Trenčiansky kraj";0;0;0;0;NA;98056;0;2020-05-01;157
2020-04-30;"Trenčiansky kraj";0;0;0;0;NA;98056;0;2020-04-30;157
2020-04-29;"Trenčiansky kraj";2;0;0;0;NA;98056;2;2020-04-29;157
2020-04-28;"Trenčiansky kraj";1;0;0;0;NA;98056;1;2020-04-28;155
2020-04-27;"Trenčiansky kraj";0;0;0;0;NA;98056;0;2020-04-27;154
2020-04-26;"Trenčiansky kraj";1;0;0;0;NA;98056;1;2020-04-26;154
2020-04-25;"Trenčiansky kraj";0;0;0;0;NA;98056;0;2020-04-25;153
2020-04-24;"Trenčiansky kraj";0;0;0;0;NA;98056;0;2020-04-24;153
2020-04-23;"Trenčiansky kraj";11;0;0;0;NA;98056;11;2020-04-23;153
2020-04-22;"Trenčiansky kraj";1;0;0;0;NA;98056;1;2020-04-22;142
2020-04-21;"Trenčiansky kraj";11;0;0;0;NA;98056;11;2020-04-21;141
2020-04-20;"Trenčiansky kraj";15;0;0;0;NA;98056;15;2020-04-20;130
2020-04-19;"Trenčiansky kraj";2;0;0;0;NA;98056;2;2020-04-19;115
2020-04-18;"Trenčiansky kraj";3;0;0;0;NA;98056;3;2020-04-18;113
2020-04-17;"Trenčiansky kraj";4;0;0;0;NA;98056;4;2020-04-17;110
2020-04-16;"Trenčiansky kraj";10;0;0;0;NA;98056;10;2020-04-16;106
2020-04-15;"Trenčiansky kraj";4;0;0;0;NA;98056;4;2020-04-15;96
2020-04-14;"Trenčiansky kraj";0;0;0;0;NA;98056;0;2020-04-14;92
2020-04-13;"Trenčiansky kraj";1;0;0;0;NA;98056;1;2020-04-13;92
2020-04-12;"Trenčiansky kraj";2;0;0;0;NA;98056;2;2020-04-12;91
2020-04-11;"Trenčiansky kraj";3;0;0;0;NA;98056;3;2020-04-11;89
2020-04-10;"Trenčiansky kraj";0;0;0;0;NA;98056;0;2020-04-10;86
2020-04-09;"Trenčiansky kraj";0;0;0;0;NA;98056;0;2020-04-09;86
2020-04-08;"Trenčiansky kraj";2;0;0;0;NA;98056;2;2020-04-08;86
2020-04-07;"Trenčiansky kraj";18;0;0;0;NA;98056;18;2020-04-07;84
2020-04-06;"Trenčiansky kraj";0;0;0;0;NA;98056;0;2020-04-06;66
2020-04-05;"Trenčiansky kraj";3;0;0;0;NA;98056;3;2020-04-05;66
2020-04-04;"Trenčiansky kraj";5;0;0;0;NA;98056;5;2020-04-04;63
2020-04-03;"Trenčiansky kraj";4;0;0;0;NA;98056;4;2020-04-03;58
2020-04-02;"Trenčiansky kraj";1;0;0;0;NA;98056;1;2020-04-02;54
2020-04-01;"Trenčiansky kraj";3;0;0;0;NA;98056;3;2020-04-01;53
2020-03-31;"Trenčiansky kraj";1;0;0;0;NA;98056;1;2020-03-31;50
2020-03-30;"Trenčiansky kraj";3;0;0;0;NA;98056;3;2020-03-30;49
2020-03-29;"Trenčiansky kraj";6;0;0;0;NA;98056;6;2020-03-29;46
2020-03-28;"Trenčiansky kraj";9;0;0;0;NA;98056;9;2020-03-28;40
2020-03-27;"Trenčiansky kraj";2;0;0;0;NA;98056;2;2020-03-27;31
2020-03-26;"Trenčiansky kraj";6;0;0;0;NA;98056;6;2020-03-26;29
2020-03-25;"Trenčiansky kraj";3;0;0;0;NA;98056;3;2020-03-25;23
2020-03-24;"Trenčiansky kraj";1;0;0;0;NA;98056;1;2020-03-24;20
2020-03-23;"Trenčiansky kraj";0;0;0;0;NA;98056;0;2020-03-23;19
2020-03-22;"Trenčiansky kraj";0;0;0;0;NA;98056;0;2020-03-22;19
2020-03-21;"Trenčiansky kraj";2;0;0;0;NA;98056;2;2020-03-21;19
2020-03-20;"Trenčiansky kraj";2;0;0;0;NA;98056;2;2020-03-20;17
2020-03-19;"Trenčiansky kraj";8;0;0;0;NA;98056;8;2020-03-19;15
2020-03-18;"Trenčiansky kraj";0;0;0;0;NA;98056;0;2020-03-18;7
2020-03-17;"Trenčiansky kraj";0;0;0;0;NA;98056;0;2020-03-17;7
2020-03-16;"Trenčiansky kraj";1;0;0;0;NA;98056;1;2020-03-16;7
2020-03-15;"Trenčiansky kraj";5;0;0;0;NA;98056;5;2020-03-15;6
2020-03-14;"Trenčiansky kraj";0;0;0;0;NA;98056;0;2020-03-14;1
2020-03-13;"Trenčiansky kraj";0;0;0;0;NA;98056;0;2020-03-13;1
2020-03-12;"Trenčiansky kraj";1;0;0;0;NA;98056;1;2020-03-12;1
2020-03-11;"Trenčiansky kraj";0;0;0;0;NA;98056;0;2020-03-11;0
2020-03-09;"Trenčiansky kraj";0;0;0;0;NA;98056;0;2020-03-09;0
2020-03-08;"Trenčiansky kraj";0;0;0;0;NA;98056;0;2020-03-08;0
2020-03-07;"Trenčiansky kraj";0;0;0;0;NA;98056;0;2020-03-07;0
2020-03-06;"Trenčiansky kraj";0;0;0;0;NA;98056;0;2020-03-06;0
2021-04-29;"Trnavský kraj";25;17612;22;17634;44929;88605;47;2021-04-29;88605
2021-04-28;"Trnavský kraj";46;8952;28;8980;NA;88605;74;2021-04-28;88558
2021-04-27;"Trnavský kraj";54;8739;37;8776;NA;88605;91;2021-04-27;88484
2021-04-26;"Trnavský kraj";53;16110;41;16151;NA;88605;94;2021-04-26;88393
2021-04-25;"Trnavský kraj";0;30166;24;30190;NA;88605;24;2021-04-25;88299
2021-04-24;"Trnavský kraj";46;124216;81;124297;NA;88605;127;2021-04-24;88275
2021-04-23;"Trnavský kraj";71;25562;53;25615;NA;88605;124;2021-04-23;88148
2021-04-22;"Trnavský kraj";40;10901;25;10926;NA;88605;65;2021-04-22;88024
2021-04-21;"Trnavský kraj";60;10728;45;10773;NA;88605;105;2021-04-21;87959
2021-04-20;"Trnavský kraj";57;13499;28;13527;NA;88605;85;2021-04-20;87854
2021-04-19;"Trnavský kraj";46;14580;18;14598;NA;88605;64;2021-04-19;87769
2021-04-18;"Trnavský kraj";7;40825;43;40868;NA;88605;50;2021-04-18;87705
2021-04-17;"Trnavský kraj";58;117950;89;118039;NA;88605;147;2021-04-17;87655
2021-04-16;"Trnavský kraj";67;25609;48;25657;NA;88605;115;2021-04-16;87508
2021-04-15;"Trnavský kraj";65;11211;36;11247;NA;88605;101;2021-04-15;87393
2021-04-14;"Trnavský kraj";78;18442;53;18495;NA;88605;131;2021-04-14;87292
2021-04-13;"Trnavský kraj";126;9831;44;9875;NA;88605;170;2021-04-13;87161
2021-04-12;"Trnavský kraj";40;15570;40;15610;NA;88605;80;2021-04-12;86991
2021-04-11;"Trnavský kraj";3;44417;44;44461;NA;88605;47;2021-04-11;86911
2021-04-10;"Trnavský kraj";60;124197;107;124304;NA;88605;167;2021-04-10;86864
2021-04-09;"Trnavský kraj";95;26509;34;26543;NA;88605;129;2021-04-09;86697
2021-04-08;"Trnavský kraj";85;11157;52;11209;NA;88605;137;2021-04-08;86568
2021-04-07;"Trnavský kraj";131;16130;81;16211;NA;88605;212;2021-04-07;86431
2021-04-06;"Trnavský kraj";92;20969;92;21061;NA;88605;184;2021-04-06;86219
2021-04-05;"Trnavský kraj";91;7627;17;7644;NA;88605;108;2021-04-05;86035
2021-04-04;"Trnavský kraj";9;28831;49;28880;NA;88605;58;2021-04-04;85927
2021-04-03;"Trnavský kraj";29;144686;189;144875;NA;88605;218;2021-04-03;85869
2021-04-02;"Trnavský kraj";91;17537;33;17570;NA;88605;124;2021-04-02;85651
2021-04-01;"Trnavský kraj";118;22547;70;22617;NA;88605;188;2021-04-01;85527
2021-03-31;"Trnavský kraj";140;15819;82;15901;NA;88605;222;2021-03-31;85339
2021-03-30;"Trnavský kraj";182;10482;79;10561;NA;88605;261;2021-03-30;85117
2021-03-29;"Trnavský kraj";126;19249;122;19371;NA;88605;248;2021-03-29;84856
2021-03-28;"Trnavský kraj";26;50792;134;50926;NA;88605;160;2021-03-28;84608
2021-03-27;"Trnavský kraj";64;129557;245;129802;NA;88605;309;2021-03-27;84448
2021-03-26;"Trnavský kraj";139;30217;130;30347;NA;88605;269;2021-03-26;84139
2021-03-25;"Trnavský kraj";135;14212;80;14292;NA;88605;215;2021-03-25;83870
2021-03-24;"Trnavský kraj";159;10521;89;10610;NA;88605;248;2021-03-24;83655
2021-03-23;"Trnavský kraj";221;12735;104;12839;NA;88605;325;2021-03-23;83407
2021-03-22;"Trnavský kraj";103;17067;110;17177;NA;88605;213;2021-03-22;83082
2021-03-21;"Trnavský kraj";31;49119;150;49269;NA;88605;181;2021-03-21;82869
2021-03-20;"Trnavský kraj";112;136522;317;136839;NA;88605;429;2021-03-20;82688
2021-03-19;"Trnavský kraj";174;29071;137;29208;NA;88605;311;2021-03-19;82259
2021-03-18;"Trnavský kraj";158;12217;136;12353;NA;88605;294;2021-03-18;81948
2021-03-17;"Trnavský kraj";245;10434;103;10537;NA;88605;348;2021-03-17;81654
2021-03-16;"Trnavský kraj";311;12810;135;12945;NA;88605;446;2021-03-16;81306
2021-03-15;"Trnavský kraj";127;18678;146;18824;NA;88605;273;2021-03-15;80860
2021-03-14;"Trnavský kraj";14;47608;164;47772;NA;88605;178;2021-03-14;80587
2021-03-13;"Trnavský kraj";155;139190;409;139599;NA;88605;564;2021-03-13;80409
2021-03-12;"Trnavský kraj";201;28559;181;28740;NA;88605;382;2021-03-12;79845
2021-03-11;"Trnavský kraj";204;13285;140;13425;NA;88605;344;2021-03-11;79463
2021-03-10;"Trnavský kraj";242;10583;135;10718;NA;88605;377;2021-03-10;79119
2021-03-09;"Trnavský kraj";442;12820;155;12975;NA;88605;597;2021-03-09;78742
2021-03-08;"Trnavský kraj";182;21825;166;21991;NA;88605;348;2021-03-08;78145
2021-03-07;"Trnavský kraj";30;45463;227;45690;NA;88605;257;2021-03-07;77797
2021-03-06;"Trnavský kraj";154;135630;531;136161;NA;88605;685;2021-03-06;77540
2021-03-05;"Trnavský kraj";299;28620;243;28863;NA;88605;542;2021-03-05;76855
2021-03-04;"Trnavský kraj";238;14489;175;14664;NA;88605;413;2021-03-04;76313
2021-03-03;"Trnavský kraj";413;11566;246;11812;NA;88605;659;2021-03-03;75900
2021-03-02;"Trnavský kraj";477;12347;191;12538;NA;88605;668;2021-03-02;75241
2021-03-01;"Trnavský kraj";189;18587;234;18821;NA;88605;423;2021-03-01;74573
2021-02-28;"Trnavský kraj";87;47709;321;48030;NA;88605;408;2021-02-28;74150
2021-02-27;"Trnavský kraj";264;140725;804;141529;NA;88605;1068;2021-02-27;73742
2021-02-26;"Trnavský kraj";362;26951;287;27238;NA;88605;649;2021-02-26;72674
2021-02-25;"Trnavský kraj";433;10490;227;10717;NA;88605;660;2021-02-25;72025
2021-02-24;"Trnavský kraj";407;9110;290;9400;NA;88605;697;2021-02-24;71365
2021-02-23;"Trnavský kraj";469;11322;284;11606;NA;88605;753;2021-02-23;70668
2021-02-22;"Trnavský kraj";206;19896;330;20226;NA;88605;536;2021-02-22;69915
2021-02-21;"Trnavský kraj";38;48221;329;48550;NA;88605;367;2021-02-21;69379
2021-02-20;"Trnavský kraj";273;135825;859;136684;NA;88605;1132;2021-02-20;69012
2021-02-19;"Trnavský kraj";335;26982;347;27329;NA;88605;682;2021-02-19;67880
2021-02-18;"Trnavský kraj";344;11263;348;11611;NA;88605;692;2021-02-18;67198
2021-02-17;"Trnavský kraj";431;8781;416;9197;NA;88605;847;2021-02-17;66506
2021-02-16;"Trnavský kraj";426;11413;295;11708;NA;88605;721;2021-02-16;65659
2021-02-15;"Trnavský kraj";146;18075;291;18366;NA;88605;437;2021-02-15;64938
2021-02-14;"Trnavský kraj";51;57642;495;58137;NA;88605;546;2021-02-14;64501
2021-02-13;"Trnavský kraj";218;137051;994;138045;NA;88605;1212;2021-02-13;63955
2021-02-12;"Trnavský kraj";300;23682;336;24018;NA;88605;636;2021-02-12;62743
2021-02-11;"Trnavský kraj";422;9901;360;10261;NA;88605;782;2021-02-11;62107
2021-02-10;"Trnavský kraj";511;9334;344;9678;NA;88605;855;2021-02-10;61325
2021-02-09;"Trnavský kraj";544;12752;369;13121;NA;88605;913;2021-02-09;60470
2021-02-08;"Trnavský kraj";220;33539;498;34037;NA;88605;718;2021-02-08;59557
2021-02-07;"Trnavský kraj";140;68646;623;69269;NA;88605;763;2021-02-07;58839
2021-02-06;"Trnavský kraj";348;112687;1482;114169;NA;88605;1830;2021-02-06;58076
2021-02-05;"Trnavský kraj";377;16446;400;16846;NA;88605;777;2021-02-05;56246
2021-02-04;"Trnavský kraj";456;7317;456;7773;NA;88605;912;2021-02-04;55469
2021-02-03;"Trnavský kraj";472;6584;434;7018;NA;88605;906;2021-02-03;54557
2021-02-02;"Trnavský kraj";446;14220;424;14644;NA;88605;870;2021-02-02;53651
2021-02-01;"Trnavský kraj";198;38882;679;39561;NA;88605;877;2021-02-01;52781
2021-01-31;"Trnavský kraj";19;64671;817;65488;NA;88605;836;2021-01-31;51904
2021-01-30;"Trnavský kraj";323;111483;1288;112771;NA;88605;1611;2021-01-30;51068
2021-01-29;"Trnavský kraj";421;9690;290;9980;NA;88605;711;2021-01-29;49457
2021-01-28;"Trnavský kraj";389;5815;286;6101;NA;88605;675;2021-01-28;48746
2021-01-27;"Trnavský kraj";433;5300;219;5519;NA;88605;652;2021-01-27;48071
2021-01-26;"Trnavský kraj";565;25392;636;26028;NA;88605;1201;2021-01-26;47419
2021-01-25;"Trnavský kraj";210;41420;607;42027;NA;88605;817;2021-01-25;46218
2021-01-24;"Trnavský kraj";91;66827;789;67616;NA;88605;880;2021-01-24;45401
2021-01-23;"Trnavský kraj";372;117933;1349;119282;NA;88605;1721;2021-01-23;44521
2021-01-22;"Trnavský kraj";217;33122;507;33629;NA;88605;724;2021-01-22;42800
2021-01-21;"Trnavský kraj";311;13922;378;14300;NA;88605;689;2021-01-21;42076
2021-01-20;"Trnavský kraj";503;8118;274;8392;NA;88605;777;2021-01-20;41387
2021-01-19;"Trnavský kraj";415;7013;347;7360;NA;88605;762;2021-01-19;40610
2021-01-18;"Trnavský kraj";247;6234;484;6718;NA;88605;731;2021-01-18;39848
2021-01-17;"Trnavský kraj";128;854;215;1069;NA;88605;343;2021-01-17;39117
2021-01-16;"Trnavský kraj";103;898;24;922;NA;88605;127;2021-01-16;38774
2021-01-15;"Trnavský kraj";278;5457;335;5792;NA;88605;613;2021-01-15;38647
2021-01-14;"Trnavský kraj";452;4001;338;4339;NA;88605;790;2021-01-14;38034
2021-01-13;"Trnavský kraj";457;4751;378;5129;NA;88605;835;2021-01-13;37244
2021-01-12;"Trnavský kraj";469;7175;483;7658;NA;88605;952;2021-01-12;36409
2021-01-11;"Trnavský kraj";370;5012;392;5404;NA;88605;762;2021-01-11;35457
2021-01-10;"Trnavský kraj";71;13;0;13;NA;88605;71;2021-01-10;34695
2021-01-09;"Trnavský kraj";417;1775;100;1875;NA;88605;517;2021-01-09;34624
2021-01-08;"Trnavský kraj";381;6554;532;7086;NA;88605;913;2021-01-08;34107
2021-01-07;"Trnavský kraj";501;4080;390;4470;NA;88605;891;2021-01-07;33194
2021-01-06;"Trnavský kraj";179;758;132;890;NA;88605;311;2021-01-06;32303
2021-01-05;"Trnavský kraj";611;5925;636;6561;NA;88605;1247;2021-01-05;31992
2021-01-04;"Trnavský kraj";302;5239;689;5928;NA;88605;991;2021-01-04;30745
2021-01-03;"Trnavský kraj";60;53;7;60;NA;88605;67;2021-01-03;29754
2021-01-02;"Trnavský kraj";282;417;32;449;NA;88605;314;2021-01-02;29687
2021-01-01;"Trnavský kraj";143;455;76;531;NA;88605;219;2021-01-01;29373
2020-12-31;"Trnavský kraj";498;8488;858;9346;NA;88605;1356;2020-12-31;29154
2020-12-30;"Trnavský kraj";785;5318;612;5930;NA;88605;1397;2020-12-30;27798
2020-12-29;"Trnavský kraj";322;5364;639;6003;NA;88605;961;2020-12-29;26401
2020-12-28;"Trnavský kraj";213;5334;615;5949;NA;88605;828;2020-12-28;25440
2020-12-27;"Trnavský kraj";27;20;4;24;NA;88605;31;2020-12-27;24612
2020-12-26;"Trnavský kraj";148;44;1;45;NA;88605;149;2020-12-26;24581
2020-12-25;"Trnavský kraj";65;49;5;54;NA;88605;70;2020-12-25;24432
2020-12-24;"Trnavský kraj";333;1359;117;1476;NA;88605;450;2020-12-24;24362
2020-12-23;"Trnavský kraj";210;7259;414;7673;NA;88605;624;2020-12-23;23912
2020-12-22;"Trnavský kraj";311;5590;491;6081;NA;88605;802;2020-12-22;23288
2020-12-21;"Trnavský kraj";328;4527;399;4926;NA;88605;727;2020-12-21;22486
2020-12-20;"Trnavský kraj";134;133;12;145;NA;88605;146;2020-12-20;21759
2020-12-19;"Trnavský kraj";201;1407;103;1510;NA;88605;304;2020-12-19;21613
2020-12-18;"Trnavský kraj";341;4898;378;5276;NA;88605;719;2020-12-18;21309
2020-12-17;"Trnavský kraj";375;5271;443;5714;NA;88605;818;2020-12-17;20590
2020-12-16;"Trnavský kraj";312;5249;405;5654;NA;88605;717;2020-12-16;19772
2020-12-15;"Trnavský kraj";492;6623;632;7255;NA;88605;1124;2020-12-15;19055
2020-12-14;"Trnavský kraj";161;3505;292;3797;NA;88605;453;2020-12-14;17931
2020-12-13;"Trnavský kraj";7;7;0;7;NA;88605;7;2020-12-13;17478
2020-12-12;"Trnavský kraj";254;1456;114;1570;NA;88605;368;2020-12-12;17471
2020-12-11;"Trnavský kraj";384;4683;262;4945;NA;88605;646;2020-12-11;17103
2020-12-10;"Trnavský kraj";183;5194;320;5514;NA;88605;503;2020-12-10;16457
2020-12-09;"Trnavský kraj";521;4283;321;4604;NA;88605;842;2020-12-09;15954
2020-12-08;"Trnavský kraj";281;4090;304;4394;NA;88605;585;2020-12-08;15112
2020-12-07;"Trnavský kraj";178;2895;199;3094;NA;88605;377;2020-12-07;14527
2020-12-06;"Trnavský kraj";46;0;0;0;NA;88605;46;2020-12-06;14150
2020-12-05;"Trnavský kraj";129;2218;41;2259;NA;88605;170;2020-12-05;14104
2020-12-04;"Trnavský kraj";242;3948;158;4106;NA;88605;400;2020-12-04;13934
2020-12-03;"Trnavský kraj";248;2770;190;2960;NA;88605;438;2020-12-03;13534
2020-12-02;"Trnavský kraj";284;4516;176;4692;NA;88605;460;2020-12-02;13096
2020-12-01;"Trnavský kraj";253;3190;205;3395;NA;88605;458;2020-12-01;12636
2020-11-30;"Trnavský kraj";200;7256;183;7439;NA;88605;383;2020-11-30;12178
2020-11-29;"Trnavský kraj";17;738;36;774;NA;88605;53;2020-11-29;11795
2020-11-28;"Trnavský kraj";83;1453;77;1530;NA;88605;160;2020-11-28;11742
2020-11-27;"Trnavský kraj";148;1779;85;1864;NA;88605;233;2020-11-27;11582
2020-11-26;"Trnavský kraj";234;1123;68;1191;NA;88605;302;2020-11-26;11349
2020-11-25;"Trnavský kraj";232;1168;74;1242;NA;88605;306;2020-11-25;11047
2020-11-24;"Trnavský kraj";295;1909;96;2005;NA;88605;391;2020-11-24;10741
2020-11-23;"Trnavský kraj";242;7393;129;7522;NA;88605;371;2020-11-23;10350
2020-11-22;"Trnavský kraj";10;82;9;91;NA;88605;19;2020-11-22;9979
2020-11-21;"Trnavský kraj";129;1354;36;1390;NA;88605;165;2020-11-21;9960
2020-11-20;"Trnavský kraj";246;1154;64;1218;NA;88605;310;2020-11-20;9795
2020-11-19;"Trnavský kraj";157;823;64;887;NA;88605;221;2020-11-19;9485
2020-11-18;"Trnavský kraj";235;822;82;904;NA;88605;317;2020-11-18;9264
2020-11-17;"Trnavský kraj";129;705;74;779;NA;88605;203;2020-11-17;8947
2020-11-16;"Trnavský kraj";187;732;32;764;NA;88605;219;2020-11-16;8744
2020-11-15;"Trnavský kraj";23;73;4;77;NA;88605;27;2020-11-15;8525
2020-11-14;"Trnavský kraj";86;397;12;409;NA;88605;98;2020-11-14;8498
2020-11-13;"Trnavský kraj";219;1312;21;1333;NA;88605;240;2020-11-13;8400
2020-11-12;"Trnavský kraj";162;420;18;438;NA;88605;180;2020-11-12;8160
2020-11-11;"Trnavský kraj";257;392;15;407;NA;88605;272;2020-11-11;7980
2020-11-10;"Trnavský kraj";189;889;30;919;NA;88605;219;2020-11-10;7708
2020-11-09;"Trnavský kraj";196;369;23;392;NA;88605;219;2020-11-09;7489
2020-11-08;"Trnavský kraj";55;400;4;404;NA;88605;59;2020-11-08;7270
2020-11-07;"Trnavský kraj";207;6070;74;6144;NA;88605;281;2020-11-07;7211
2020-11-06;"Trnavský kraj";260;1531;19;1550;NA;88605;279;2020-11-06;6930
2020-11-05;"Trnavský kraj";150;220;27;247;NA;88605;177;2020-11-05;6651
2020-11-04;"Trnavský kraj";188;212;10;222;NA;88605;198;2020-11-04;6474
2020-11-03;"Trnavský kraj";317;127;8;135;NA;88605;325;2020-11-03;6276
2020-11-02;"Trnavský kraj";281;1728;31;1759;NA;88605;312;2020-11-02;5951
2020-11-01;"Trnavský kraj";87;494;27;521;NA;88605;114;2020-11-01;5639
2020-10-31;"Trnavský kraj";259;5024;41;5065;NA;88605;300;2020-10-31;5525
2020-10-30;"Trnavský kraj";198;3784;27;3811;NA;88605;225;2020-10-30;5225
2020-10-29;"Trnavský kraj";273;1461;16;1477;NA;88605;289;2020-10-29;5000
2020-10-28;"Trnavský kraj";319;117;16;133;NA;88605;335;2020-10-28;4711
2020-10-27;"Trnavský kraj";199;461;36;497;NA;88605;235;2020-10-27;4376
2020-10-26;"Trnavský kraj";153;29;2;31;NA;88605;155;2020-10-26;4141
2020-10-25;"Trnavský kraj";95;19;1;20;NA;88605;96;2020-10-25;3986
2020-10-24;"Trnavský kraj";158;109;2;111;NA;88605;160;2020-10-24;3890
2020-10-23;"Trnavský kraj";201;89;4;93;NA;88605;205;2020-10-23;3730
2020-10-22;"Trnavský kraj";195;55;2;57;NA;88605;197;2020-10-22;3525
2020-10-21;"Trnavský kraj";134;73;3;76;NA;88605;137;2020-10-21;3328
2020-10-20;"Trnavský kraj";202;82;3;85;NA;88605;205;2020-10-20;3191
2020-10-19;"Trnavský kraj";67;55;0;55;NA;88605;67;2020-10-19;2986
2020-10-18;"Trnavský kraj";84;0;0;0;NA;88605;84;2020-10-18;2919
2020-10-17;"Trnavský kraj";123;0;0;0;NA;88605;123;2020-10-17;2835
2020-10-16;"Trnavský kraj";86;45;2;47;NA;88605;88;2020-10-16;2712
2020-10-15;"Trnavský kraj";155;66;2;68;NA;88605;157;2020-10-15;2624
2020-10-14;"Trnavský kraj";236;468;3;471;NA;88605;239;2020-10-14;2467
2020-10-13;"Trnavský kraj";138;16;2;18;NA;88605;140;2020-10-13;2228
2020-10-12;"Trnavský kraj";33;41;1;42;NA;88605;34;2020-10-12;2088
2020-10-11;"Trnavský kraj";31;0;0;0;NA;88605;31;2020-10-11;2054
2020-10-10;"Trnavský kraj";128;0;0;0;NA;88605;128;2020-10-10;2023
2020-10-09;"Trnavský kraj";156;0;0;0;NA;88605;156;2020-10-09;1895
2020-10-08;"Trnavský kraj";153;0;0;0;NA;88605;153;2020-10-08;1739
2020-10-07;"Trnavský kraj";80;0;0;0;NA;88605;80;2020-10-07;1586
2020-10-06;"Trnavský kraj";112;0;0;0;NA;88605;112;2020-10-06;1506
2020-10-05;"Trnavský kraj";33;0;0;0;NA;88605;33;2020-10-05;1394
2020-10-04;"Trnavský kraj";44;0;0;0;NA;88605;44;2020-10-04;1361
2020-10-03;"Trnavský kraj";60;0;0;0;NA;88605;60;2020-10-03;1317
2020-10-02;"Trnavský kraj";41;0;0;0;NA;88605;41;2020-10-02;1257
2020-10-01;"Trnavský kraj";53;0;0;0;NA;88605;53;2020-10-01;1216
2020-09-30;"Trnavský kraj";91;0;0;0;NA;88605;91;2020-09-30;1163
2020-09-29;"Trnavský kraj";40;0;0;0;NA;88605;40;2020-09-29;1072
2020-09-28;"Trnavský kraj";69;0;0;0;NA;88605;69;2020-09-28;1032
2020-09-27;"Trnavský kraj";30;0;0;0;NA;88605;30;2020-09-27;963
2020-09-26;"Trnavský kraj";46;0;0;0;NA;88605;46;2020-09-26;933
2020-09-25;"Trnavský kraj";32;0;0;0;NA;88605;32;2020-09-25;887
2020-09-24;"Trnavský kraj";42;0;0;0;NA;88605;42;2020-09-24;855
2020-09-23;"Trnavský kraj";43;0;0;0;NA;88605;43;2020-09-23;813
2020-09-22;"Trnavský kraj";55;0;0;0;NA;88605;55;2020-09-22;770
2020-09-21;"Trnavský kraj";41;0;0;0;NA;88605;41;2020-09-21;715
2020-09-20;"Trnavský kraj";17;0;0;0;NA;88605;17;2020-09-20;674
2020-09-19;"Trnavský kraj";4;0;0;0;NA;88605;4;2020-09-19;657
2020-09-18;"Trnavský kraj";33;0;0;0;NA;88605;33;2020-09-18;653
2020-09-17;"Trnavský kraj";42;0;0;0;NA;88605;42;2020-09-17;620
2020-09-16;"Trnavský kraj";49;0;0;0;NA;88605;49;2020-09-16;578
2020-09-15;"Trnavský kraj";5;0;0;0;NA;88605;5;2020-09-15;529
2020-09-14;"Trnavský kraj";26;0;0;0;NA;88605;26;2020-09-14;524
2020-09-13;"Trnavský kraj";9;0;0;0;NA;88605;9;2020-09-13;498
2020-09-12;"Trnavský kraj";12;0;0;0;NA;88605;12;2020-09-12;489
2020-09-11;"Trnavský kraj";16;0;0;0;NA;88605;16;2020-09-11;477
2020-09-10;"Trnavský kraj";32;0;0;0;NA;88605;32;2020-09-10;461
2020-09-09;"Trnavský kraj";14;0;0;0;NA;88605;14;2020-09-09;429
2020-09-08;"Trnavský kraj";11;0;0;0;NA;88605;11;2020-09-08;415
2020-09-07;"Trnavský kraj";7;0;0;0;NA;88605;7;2020-09-07;404
2020-09-06;"Trnavský kraj";5;0;0;0;NA;88605;5;2020-09-06;397
2020-09-05;"Trnavský kraj";7;0;0;0;NA;88605;7;2020-09-05;392
2020-09-04;"Trnavský kraj";16;0;0;0;NA;88605;16;2020-09-04;385
2020-09-03;"Trnavský kraj";8;0;0;0;NA;88605;8;2020-09-03;369
2020-09-02;"Trnavský kraj";7;0;0;0;NA;88605;7;2020-09-02;361
2020-09-01;"Trnavský kraj";1;0;0;0;NA;88605;1;2020-09-01;354
2020-08-31;"Trnavský kraj";6;0;0;0;NA;88605;6;2020-08-31;353
2020-08-30;"Trnavský kraj";1;0;0;0;NA;88605;1;2020-08-30;347
2020-08-29;"Trnavský kraj";3;0;0;0;NA;88605;3;2020-08-29;346
2020-08-28;"Trnavský kraj";14;0;0;0;NA;88605;14;2020-08-28;343
2020-08-27;"Trnavský kraj";6;0;0;0;NA;88605;6;2020-08-27;329
2020-08-26;"Trnavský kraj";4;0;0;0;NA;88605;4;2020-08-26;323
2020-08-25;"Trnavský kraj";7;0;0;0;NA;88605;7;2020-08-25;319
2020-08-24;"Trnavský kraj";1;0;0;0;NA;88605;1;2020-08-24;312
2020-08-23;"Trnavský kraj";6;0;0;0;NA;88605;6;2020-08-23;311
2020-08-22;"Trnavský kraj";3;0;0;0;NA;88605;3;2020-08-22;305
2020-08-21;"Trnavský kraj";4;0;0;0;NA;88605;4;2020-08-21;302
2020-08-20;"Trnavský kraj";23;0;0;0;NA;88605;23;2020-08-20;298
2020-08-19;"Trnavský kraj";13;0;0;0;NA;88605;13;2020-08-19;275
2020-08-18;"Trnavský kraj";20;0;0;0;NA;88605;20;2020-08-18;262
2020-08-17;"Trnavský kraj";3;0;0;0;NA;88605;3;2020-08-17;242
2020-08-16;"Trnavský kraj";0;0;0;0;NA;88605;0;2020-08-16;239
2020-08-15;"Trnavský kraj";7;0;0;0;NA;88605;7;2020-08-15;239
2020-08-14;"Trnavský kraj";6;0;0;0;NA;88605;6;2020-08-14;232
2020-08-13;"Trnavský kraj";10;0;0;0;NA;88605;10;2020-08-13;226
2020-08-12;"Trnavský kraj";2;0;0;0;NA;88605;2;2020-08-12;216
2020-08-11;"Trnavský kraj";30;0;0;0;NA;88605;30;2020-08-11;214
2020-08-10;"Trnavský kraj";0;0;0;0;NA;88605;0;2020-08-10;184
2020-08-09;"Trnavský kraj";0;0;0;0;NA;88605;0;2020-08-09;184
2020-08-08;"Trnavský kraj";13;0;0;0;NA;88605;13;2020-08-08;184
2020-08-07;"Trnavský kraj";4;0;0;0;NA;88605;4;2020-08-07;171
2020-08-06;"Trnavský kraj";4;0;0;0;NA;88605;4;2020-08-06;167
2020-08-05;"Trnavský kraj";0;0;0;0;NA;88605;0;2020-08-05;163
2020-08-04;"Trnavský kraj";1;0;0;0;NA;88605;1;2020-08-04;163
2020-08-03;"Trnavský kraj";2;0;0;0;NA;88605;2;2020-08-03;162
2020-08-02;"Trnavský kraj";1;0;0;0;NA;88605;1;2020-08-02;160
2020-08-01;"Trnavský kraj";0;0;0;0;NA;88605;0;2020-08-01;159
2020-07-31;"Trnavský kraj";7;0;0;0;NA;88605;7;2020-07-31;159
2020-07-30;"Trnavský kraj";6;0;0;0;NA;88605;6;2020-07-30;152
2020-07-29;"Trnavský kraj";0;0;0;0;NA;88605;0;2020-07-29;146
2020-07-28;"Trnavský kraj";1;0;0;0;NA;88605;1;2020-07-28;146
2020-07-27;"Trnavský kraj";2;0;0;0;NA;88605;2;2020-07-27;145
2020-07-26;"Trnavský kraj";0;0;0;0;NA;88605;0;2020-07-26;143
2020-07-25;"Trnavský kraj";0;0;0;0;NA;88605;0;2020-07-25;143
2020-07-24;"Trnavský kraj";1;0;0;0;NA;88605;1;2020-07-24;143
2020-07-23;"Trnavský kraj";2;0;0;0;NA;88605;2;2020-07-23;142
2020-07-22;"Trnavský kraj";1;0;0;0;NA;88605;1;2020-07-22;140
2020-07-21;"Trnavský kraj";2;0;0;0;NA;88605;2;2020-07-21;139
2020-07-20;"Trnavský kraj";0;0;0;0;NA;88605;0;2020-07-20;137
2020-07-19;"Trnavský kraj";0;0;0;0;NA;88605;0;2020-07-19;137
2020-07-18;"Trnavský kraj";0;0;0;0;NA;88605;0;2020-07-18;137
2020-07-17;"Trnavský kraj";0;0;0;0;NA;88605;0;2020-07-17;137
2020-07-16;"Trnavský kraj";0;0;0;0;NA;88605;0;2020-07-16;137
2020-07-15;"Trnavský kraj";1;0;0;0;NA;88605;1;2020-07-15;137
2020-07-14;"Trnavský kraj";0;0;0;0;NA;88605;0;2020-07-14;136
2020-07-13;"Trnavský kraj";0;0;0;0;NA;88605;0;2020-07-13;136
2020-07-12;"Trnavský kraj";0;0;0;0;NA;88605;0;2020-07-12;136
2020-07-11;"Trnavský kraj";0;0;0;0;NA;88605;0;2020-07-11;136
2020-07-10;"Trnavský kraj";0;0;0;0;NA;88605;0;2020-07-10;136
2020-07-09;"Trnavský kraj";0;0;0;0;NA;88605;0;2020-07-09;136
2020-07-08;"Trnavský kraj";3;0;0;0;NA;88605;3;2020-07-08;136
2020-07-07;"Trnavský kraj";4;0;0;0;NA;88605;4;2020-07-07;133
2020-07-06;"Trnavský kraj";0;0;0;0;NA;88605;0;2020-07-06;129
2020-07-05;"Trnavský kraj";0;0;0;0;NA;88605;0;2020-07-05;129
2020-07-04;"Trnavský kraj";0;0;0;0;NA;88605;0;2020-07-04;129
2020-07-03;"Trnavský kraj";0;0;0;0;NA;88605;0;2020-07-03;129
2020-07-02;"Trnavský kraj";3;0;0;0;NA;88605;3;2020-07-02;129
2020-07-01;"Trnavský kraj";0;0;0;0;NA;88605;0;2020-07-01;126
2020-06-30;"Trnavský kraj";0;0;0;0;NA;88605;0;2020-06-30;126
2020-06-29;"Trnavský kraj";0;0;0;0;NA;88605;0;2020-06-29;126
2020-06-28;"Trnavský kraj";0;0;0;0;NA;88605;0;2020-06-28;126
2020-06-27;"Trnavský kraj";0;0;0;0;NA;88605;0;2020-06-27;126
2020-06-26;"Trnavský kraj";0;0;0;0;NA;88605;0;2020-06-26;126
2020-06-25;"Trnavský kraj";0;0;0;0;NA;88605;0;2020-06-25;126
2020-06-24;"Trnavský kraj";0;0;0;0;NA;88605;0;2020-06-24;126
2020-06-23;"Trnavský kraj";0;0;0;0;NA;88605;0;2020-06-23;126
2020-06-22;"Trnavský kraj";0;0;0;0;NA;88605;0;2020-06-22;126
2020-06-21;"Trnavský kraj";0;0;0;0;NA;88605;0;2020-06-21;126
2020-06-20;"Trnavský kraj";0;0;0;0;NA;88605;0;2020-06-20;126
2020-06-19;"Trnavský kraj";0;0;0;0;NA;88605;0;2020-06-19;126
2020-06-18;"Trnavský kraj";2;0;0;0;NA;88605;2;2020-06-18;126
2020-06-17;"Trnavský kraj";0;0;0;0;NA;88605;0;2020-06-17;124
2020-06-16;"Trnavský kraj";0;0;0;0;NA;88605;0;2020-06-16;124
2020-06-14;"Trnavský kraj";0;0;0;0;NA;88605;0;2020-06-14;124
2020-06-13;"Trnavský kraj";0;0;0;0;NA;88605;0;2020-06-13;124
2020-06-12;"Trnavský kraj";0;0;0;0;NA;88605;0;2020-06-12;124
2020-06-11;"Trnavský kraj";0;0;0;0;NA;88605;0;2020-06-11;124
2020-06-10;"Trnavský kraj";0;0;0;0;NA;88605;0;2020-06-10;124
2020-06-09;"Trnavský kraj";0;0;0;0;NA;88605;0;2020-06-09;124
2020-06-08;"Trnavský kraj";0;0;0;0;NA;88605;0;2020-06-08;124
2020-06-07;"Trnavský kraj";0;0;0;0;NA;88605;0;2020-06-07;124
2020-06-05;"Trnavský kraj";0;0;0;0;NA;88605;0;2020-06-05;124
2020-06-03;"Trnavský kraj";0;0;0;0;NA;88605;0;2020-06-03;124
2020-06-02;"Trnavský kraj";0;0;0;0;NA;88605;0;2020-06-02;124
2020-05-31;"Trnavský kraj";0;0;0;0;NA;88605;0;2020-05-31;124
2020-05-29;"Trnavský kraj";0;0;0;0;NA;88605;0;2020-05-29;124
2020-05-27;"Trnavský kraj";0;0;0;0;NA;88605;0;2020-05-27;124
2020-05-26;"Trnavský kraj";0;0;0;0;NA;88605;0;2020-05-26;124
2020-05-25;"Trnavský kraj";1;0;0;0;NA;88605;1;2020-05-25;124
2020-05-24;"Trnavský kraj";0;0;0;0;NA;88605;0;2020-05-24;123
2020-05-23;"Trnavský kraj";2;0;0;0;NA;88605;2;2020-05-23;123
2020-05-22;"Trnavský kraj";0;0;0;0;NA;88605;0;2020-05-22;121
2020-05-21;"Trnavský kraj";0;0;0;0;NA;88605;0;2020-05-21;121
2020-05-20;"Trnavský kraj";2;0;0;0;NA;88605;2;2020-05-20;121
2020-05-19;"Trnavský kraj";0;0;0;0;NA;88605;0;2020-05-19;119
2020-05-17;"Trnavský kraj";0;0;0;0;NA;88605;0;2020-05-17;119
2020-05-16;"Trnavský kraj";0;0;0;0;NA;88605;0;2020-05-16;119
2020-05-15;"Trnavský kraj";1;0;0;0;NA;88605;1;2020-05-15;119
2020-05-14;"Trnavský kraj";0;0;0;0;NA;88605;0;2020-05-14;118
2020-05-13;"Trnavský kraj";0;0;0;0;NA;88605;0;2020-05-13;118
2020-05-12;"Trnavský kraj";0;0;0;0;NA;88605;0;2020-05-12;118
2020-05-11;"Trnavský kraj";2;0;0;0;NA;88605;2;2020-05-11;118
2020-05-09;"Trnavský kraj";0;0;0;0;NA;88605;0;2020-05-09;116
2020-05-07;"Trnavský kraj";0;0;0;0;NA;88605;0;2020-05-07;116
2020-05-06;"Trnavský kraj";0;0;0;0;NA;88605;0;2020-05-06;116
2020-05-05;"Trnavský kraj";0;0;0;0;NA;88605;0;2020-05-05;116
2020-05-04;"Trnavský kraj";0;0;0;0;NA;88605;0;2020-05-04;116
2020-05-03;"Trnavský kraj";0;0;0;0;NA;88605;0;2020-05-03;116
2020-05-02;"Trnavský kraj";0;0;0;0;NA;88605;0;2020-05-02;116
2020-05-01;"Trnavský kraj";0;0;0;0;NA;88605;0;2020-05-01;116
2020-04-30;"Trnavský kraj";0;0;0;0;NA;88605;0;2020-04-30;116
2020-04-29;"Trnavský kraj";0;0;0;0;NA;88605;0;2020-04-29;116
2020-04-28;"Trnavský kraj";1;0;0;0;NA;88605;1;2020-04-28;116
2020-04-27;"Trnavský kraj";0;0;0;0;NA;88605;0;2020-04-27;115
2020-04-26;"Trnavský kraj";0;0;0;0;NA;88605;0;2020-04-26;115
2020-04-25;"Trnavský kraj";2;0;0;0;NA;88605;2;2020-04-25;115
2020-04-24;"Trnavský kraj";4;0;0;0;NA;88605;4;2020-04-24;113
2020-04-23;"Trnavský kraj";5;0;0;0;NA;88605;5;2020-04-23;109
2020-04-22;"Trnavský kraj";10;0;0;0;NA;88605;10;2020-04-22;104
2020-04-21;"Trnavský kraj";5;0;0;0;NA;88605;5;2020-04-21;94
2020-04-20;"Trnavský kraj";0;0;0;0;NA;88605;0;2020-04-20;89
2020-04-19;"Trnavský kraj";1;0;0;0;NA;88605;1;2020-04-19;89
2020-04-18;"Trnavský kraj";4;0;0;0;NA;88605;4;2020-04-18;88
2020-04-17;"Trnavský kraj";7;0;0;0;NA;88605;7;2020-04-17;84
2020-04-16;"Trnavský kraj";5;0;0;0;NA;88605;5;2020-04-16;77
2020-04-15;"Trnavský kraj";5;0;0;0;NA;88605;5;2020-04-15;72
2020-04-14;"Trnavský kraj";1;0;0;0;NA;88605;1;2020-04-14;67
2020-04-13;"Trnavský kraj";0;0;0;0;NA;88605;0;2020-04-13;66
2020-04-12;"Trnavský kraj";0;0;0;0;NA;88605;0;2020-04-12;66
2020-04-11;"Trnavský kraj";0;0;0;0;NA;88605;0;2020-04-11;66
2020-04-10;"Trnavský kraj";2;0;0;0;NA;88605;2;2020-04-10;66
2020-04-09;"Trnavský kraj";3;0;0;0;NA;88605;3;2020-04-09;64
2020-04-08;"Trnavský kraj";4;0;0;0;NA;88605;4;2020-04-08;61
2020-04-07;"Trnavský kraj";6;0;0;0;NA;88605;6;2020-04-07;57
2020-04-06;"Trnavský kraj";6;0;0;0;NA;88605;6;2020-04-06;51
2020-04-05;"Trnavský kraj";1;0;0;0;NA;88605;1;2020-04-05;45
2020-04-04;"Trnavský kraj";1;0;0;0;NA;88605;1;2020-04-04;44
2020-04-03;"Trnavský kraj";3;0;0;0;NA;88605;3;2020-04-03;43
2020-04-02;"Trnavský kraj";4;0;0;0;NA;88605;4;2020-04-02;40
2020-04-01;"Trnavský kraj";0;0;0;0;NA;88605;0;2020-04-01;36
2020-03-31;"Trnavský kraj";3;0;0;0;NA;88605;3;2020-03-31;36
2020-03-30;"Trnavský kraj";4;0;0;0;NA;88605;4;2020-03-30;33
2020-03-29;"Trnavský kraj";1;0;0;0;NA;88605;1;2020-03-29;29
2020-03-28;"Trnavský kraj";3;0;0;0;NA;88605;3;2020-03-28;28
2020-03-27;"Trnavský kraj";5;0;0;0;NA;88605;5;2020-03-27;25
2020-03-26;"Trnavský kraj";5;0;0;0;NA;88605;5;2020-03-26;20
2020-03-25;"Trnavský kraj";1;0;0;0;NA;88605;1;2020-03-25;15
2020-03-24;"Trnavský kraj";0;0;0;0;NA;88605;0;2020-03-24;14
2020-03-23;"Trnavský kraj";2;0;0;0;NA;88605;2;2020-03-23;14
2020-03-22;"Trnavský kraj";1;0;0;0;NA;88605;1;2020-03-22;12
2020-03-21;"Trnavský kraj";5;0;0;0;NA;88605;5;2020-03-21;11
2020-03-20;"Trnavský kraj";0;0;0;0;NA;88605;0;2020-03-20;6
2020-03-19;"Trnavský kraj";0;0;0;0;NA;88605;0;2020-03-19;6
2020-03-18;"Trnavský kraj";0;0;0;0;NA;88605;0;2020-03-18;6
2020-03-17;"Trnavský kraj";3;0;0;0;NA;88605;3;2020-03-17;6
2020-03-16;"Trnavský kraj";1;0;0;0;NA;88605;1;2020-03-16;3
2020-03-15;"Trnavský kraj";0;0;0;0;NA;88605;0;2020-03-15;2
2020-03-14;"Trnavský kraj";0;0;0;0;NA;88605;0;2020-03-14;2
2020-03-13;"Trnavský kraj";1;0;0;0;NA;88605;1;2020-03-13;2
2020-03-12;"Trnavský kraj";1;0;0;0;NA;88605;1;2020-03-12;1
2020-03-11;"Trnavský kraj";0;0;0;0;NA;88605;0;2020-03-11;0
2020-03-09;"Trnavský kraj";0;0;0;0;NA;88605;0;2020-03-09;0
2020-03-08;"Trnavský kraj";0;0;0;0;NA;88605;0;2020-03-08;0
2020-03-07;"Trnavský kraj";0;0;0;0;NA;88605;0;2020-03-07;0
2020-03-06;"Trnavský kraj";0;0;0;0;NA;88605;0;2020-03-06;0
2021-04-29;"Žilinský kraj";77;15705;65;15770;56286;104700;142;2021-04-29;104700
2021-04-28;"Žilinský kraj";76;19053;91;19144;NA;104700;167;2021-04-28;104558
2021-04-27;"Žilinský kraj";97;21694;109;21803;NA;104700;206;2021-04-27;104391
2021-04-26;"Žilinský kraj";114;27949;138;28087;NA;104700;252;2021-04-26;104185
2021-04-25;"Žilinský kraj";38;34773;81;34854;NA;104700;119;2021-04-25;103933
2021-04-24;"Žilinský kraj";93;78909;155;79064;NA;104700;248;2021-04-24;103814
2021-04-23;"Žilinský kraj";144;49313;155;49468;NA;104700;299;2021-04-23;103566
2021-04-22;"Žilinský kraj";110;24871;130;25001;NA;104700;240;2021-04-22;103267
2021-04-21;"Žilinský kraj";118;20463;145;20608;NA;104700;263;2021-04-21;103027
2021-04-20;"Žilinský kraj";128;23494;136;23630;NA;104700;264;2021-04-20;102764
2021-04-19;"Žilinský kraj";164;32611;207;32818;NA;104700;371;2021-04-19;102500
2021-04-18;"Žilinský kraj";18;36727;91;36818;NA;104700;109;2021-04-18;102129
2021-04-17;"Žilinský kraj";108;89202;156;89358;NA;104700;264;2021-04-17;102020
2021-04-16;"Žilinský kraj";185;47229;209;47438;NA;104700;394;2021-04-16;101756
2021-04-15;"Žilinský kraj";108;24625;129;24754;NA;104700;237;2021-04-15;101362
2021-04-14;"Žilinský kraj";135;23341;144;23485;NA;104700;279;2021-04-14;101125
2021-04-13;"Žilinský kraj";171;24753;137;24890;NA;104700;308;2021-04-13;100846
2021-04-12;"Žilinský kraj";266;29888;183;30071;NA;104700;449;2021-04-12;100538
2021-04-11;"Žilinský kraj";19;37044;107;37151;NA;104700;126;2021-04-11;100089
2021-04-10;"Žilinský kraj";111;86173;234;86407;NA;104700;345;2021-04-10;99963
2021-04-09;"Žilinský kraj";195;41671;205;41876;NA;104700;400;2021-04-09;99618
2021-04-08;"Žilinský kraj";179;24149;137;24286;NA;104700;316;2021-04-08;99218
2021-04-07;"Žilinský kraj";309;29183;178;29361;NA;104700;487;2021-04-07;98902
2021-04-06;"Žilinský kraj";308;38918;294;39212;NA;104700;602;2021-04-06;98415
2021-04-05;"Žilinský kraj";17;14747;140;14887;NA;104700;157;2021-04-05;97813
2021-04-04;"Žilinský kraj";17;16284;69;16353;NA;104700;86;2021-04-04;97656
2021-04-03;"Žilinský kraj";180;100913;401;101314;NA;104700;581;2021-04-03;97570
2021-04-02;"Žilinský kraj";73;22481;84;22565;NA;104700;157;2021-04-02;96989
2021-04-01;"Žilinský kraj";334;43024;240;43264;NA;104700;574;2021-04-01;96832
2021-03-31;"Žilinský kraj";170;31632;247;31879;NA;104700;417;2021-03-31;96258
2021-03-30;"Žilinský kraj";406;26379;243;26622;NA;104700;649;2021-03-30;95841
2021-03-29;"Žilinský kraj";297;28022;268;28290;NA;104700;565;2021-03-29;95192
2021-03-28;"Žilinský kraj";21;36206;239;36445;NA;104700;260;2021-03-28;94627
2021-03-27;"Žilinský kraj";151;89102;353;89455;NA;104700;504;2021-03-27;94367
2021-03-26;"Žilinský kraj";312;52263;333;52596;NA;104700;645;2021-03-26;93863
2021-03-25;"Žilinský kraj";281;27620;214;27834;NA;104700;495;2021-03-25;93218
2021-03-24;"Žilinský kraj";280;21425;261;21686;NA;104700;541;2021-03-24;92723
2021-03-23;"Žilinský kraj";418;23176;278;23454;NA;104700;696;2021-03-23;92182
2021-03-22;"Žilinský kraj";293;29289;314;29603;NA;104700;607;2021-03-22;91486
2021-03-21;"Žilinský kraj";32;33705;227;33932;NA;104700;259;2021-03-21;90879
2021-03-20;"Žilinský kraj";165;93422;497;93919;NA;104700;662;2021-03-20;90620
2021-03-19;"Žilinský kraj";357;51763;413;52176;NA;104700;770;2021-03-19;89958
2021-03-18;"Žilinský kraj";329;28451;294;28745;NA;104700;623;2021-03-18;89188
2021-03-17;"Žilinský kraj";395;21916;269;22185;NA;104700;664;2021-03-17;88565
2021-03-16;"Žilinský kraj";514;24341;317;24658;NA;104700;831;2021-03-16;87901
2021-03-15;"Žilinský kraj";341;29607;419;30026;NA;104700;760;2021-03-15;87070
2021-03-14;"Žilinský kraj";87;34121;267;34388;NA;104700;354;2021-03-14;86310
2021-03-13;"Žilinský kraj";113;93756;584;94340;NA;104700;697;2021-03-13;85956
2021-03-12;"Žilinský kraj";520;52109;411;52520;NA;104700;931;2021-03-12;85259
2021-03-11;"Žilinský kraj";399;28477;308;28785;NA;104700;707;2021-03-11;84328
2021-03-10;"Žilinský kraj";368;22366;370;22736;NA;104700;738;2021-03-10;83621
2021-03-09;"Žilinský kraj";537;24857;316;25173;NA;104700;853;2021-03-09;82883
2021-03-08;"Žilinský kraj";387;30839;458;31297;NA;104700;845;2021-03-08;82030
2021-03-07;"Žilinský kraj";48;33469;290;33759;NA;104700;338;2021-03-07;81185
2021-03-06;"Žilinský kraj";173;92398;586;92984;NA;104700;759;2021-03-06;80847
2021-03-05;"Žilinský kraj";369;51748;483;52231;NA;104700;852;2021-03-05;80088
2021-03-04;"Žilinský kraj";467;30036;377;30413;NA;104700;844;2021-03-04;79236
2021-03-03;"Žilinský kraj";448;26261;394;26655;NA;104700;842;2021-03-03;78392
2021-03-02;"Žilinský kraj";551;25669;378;26047;NA;104700;929;2021-03-02;77550
2021-03-01;"Žilinský kraj";375;30493;441;30934;NA;104700;816;2021-03-01;76621
2021-02-28;"Žilinský kraj";61;34802;327;35129;NA;104700;388;2021-02-28;75805
2021-02-27;"Žilinský kraj";159;83781;639;84420;NA;104700;798;2021-02-27;75417
2021-02-26;"Žilinský kraj";459;47494;508;48002;NA;104700;967;2021-02-26;74619
2021-02-25;"Žilinský kraj";347;30879;393;31272;NA;104700;740;2021-02-25;73652
2021-02-24;"Žilinský kraj";339;18745;395;19140;NA;104700;734;2021-02-24;72912
2021-02-23;"Žilinský kraj";437;22418;418;22836;NA;104700;855;2021-02-23;72178
2021-02-22;"Žilinský kraj";345;29268;438;29706;NA;104700;783;2021-02-22;71323
2021-02-21;"Žilinský kraj";36;28686;322;29008;NA;104700;358;2021-02-21;70540
2021-02-20;"Žilinský kraj";152;88723;667;89390;NA;104700;819;2021-02-20;70182
2021-02-19;"Žilinský kraj";337;44806;415;45221;NA;104700;752;2021-02-19;69363
2021-02-18;"Žilinský kraj";263;24679;339;25018;NA;104700;602;2021-02-18;68611
2021-02-17;"Žilinský kraj";269;17932;355;18287;NA;104700;624;2021-02-17;68009
2021-02-16;"Žilinský kraj";321;24298;325;24623;NA;104700;646;2021-02-16;67385
2021-02-15;"Žilinský kraj";230;30420;311;30731;NA;104700;541;2021-02-15;66739
2021-02-14;"Žilinský kraj";30;28574;231;28805;NA;104700;261;2021-02-14;66198
2021-02-13;"Žilinský kraj";91;69659;454;70113;NA;104700;545;2021-02-13;65937
2021-02-12;"Žilinský kraj";242;42686;335;43021;NA;104700;577;2021-02-12;65392
2021-02-11;"Žilinský kraj";228;23521;300;23821;NA;104700;528;2021-02-11;64815
2021-02-10;"Žilinský kraj";259;17438;261;17699;NA;104700;520;2021-02-10;64287
2021-02-09;"Žilinský kraj";377;24921;276;25197;NA;104700;653;2021-02-09;63767
2021-02-08;"Žilinský kraj";160;41238;388;41626;NA;104700;548;2021-02-08;63114
2021-02-07;"Žilinský kraj";24;46446;252;46698;NA;104700;276;2021-02-07;62566
2021-02-06;"Žilinský kraj";71;72880;367;73247;NA;104700;438;2021-02-06;62290
2021-02-05;"Žilinský kraj";248;31982;323;32305;NA;104700;571;2021-02-05;61852
2021-02-04;"Žilinský kraj";238;13128;258;13386;NA;104700;496;2021-02-04;61281
2021-02-03;"Žilinský kraj";194;9187;255;9442;NA;104700;449;2021-02-03;60785
2021-02-02;"Žilinský kraj";216;9446;279;9725;NA;104700;495;2021-02-02;60336
2021-02-01;"Žilinský kraj";220;19507;363;19870;NA;104700;583;2021-02-01;59841
2021-01-31;"Žilinský kraj";11;2652;27;2679;NA;104700;38;2021-01-31;59258
2021-01-30;"Žilinský kraj";85;18447;187;18634;NA;104700;272;2021-01-30;59220
2021-01-29;"Žilinský kraj";209;22892;304;23196;NA;104700;513;2021-01-29;58948
2021-01-28;"Žilinský kraj";240;5623;174;5797;NA;104700;414;2021-01-28;58435
2021-01-27;"Žilinský kraj";256;7142;124;7266;NA;104700;380;2021-01-27;58021
2021-01-26;"Žilinský kraj";245;49562;343;49905;NA;104700;588;2021-01-26;57641
2021-01-25;"Žilinský kraj";159;21143;150;21293;NA;104700;309;2021-01-25;57053
2021-01-24;"Žilinský kraj";22;67338;306;67644;NA;104700;328;2021-01-24;56744
2021-01-23;"Žilinský kraj";91;91262;408;91670;NA;104700;499;2021-01-23;56416
2021-01-22;"Žilinský kraj";163;32018;238;32256;NA;104700;401;2021-01-22;55917
2021-01-21;"Žilinský kraj";116;19841;183;20024;NA;104700;299;2021-01-21;55516
2021-01-20;"Žilinský kraj";236;17484;171;17655;NA;104700;407;2021-01-20;55217
2021-01-19;"Žilinský kraj";245;15619;279;15898;NA;104700;524;2021-01-19;54810
2021-01-18;"Žilinský kraj";236;12537;334;12871;NA;104700;570;2021-01-18;54286
2021-01-17;"Žilinský kraj";95;117;2;119;NA;104700;97;2021-01-17;53716
2021-01-16;"Žilinský kraj";14;758;37;795;NA;104700;51;2021-01-16;53619
2021-01-15;"Žilinský kraj";248;7256;203;7459;NA;104700;451;2021-01-15;53568
2021-01-14;"Žilinský kraj";166;5610;249;5859;NA;104700;415;2021-01-14;53117
2021-01-13;"Žilinský kraj";247;11307;553;11860;NA;104700;800;2021-01-13;52702
2021-01-12;"Žilinský kraj";376;8798;418;9216;NA;104700;794;2021-01-12;51902
2021-01-11;"Žilinský kraj";351;10348;510;10858;NA;104700;861;2021-01-11;51108
2021-01-10;"Žilinský kraj";38;189;7;196;NA;104700;45;2021-01-10;50247
2021-01-09;"Žilinský kraj";192;1992;85;2077;NA;104700;277;2021-01-09;50202
2021-01-08;"Žilinský kraj";413;9234;500;9734;NA;104700;913;2021-01-08;49925
2021-01-07;"Žilinský kraj";438;23513;1881;25394;NA;104700;2319;2021-01-07;49012
2021-01-06;"Žilinský kraj";145;1338;89;1427;NA;104700;234;2021-01-06;46693
2021-01-05;"Žilinský kraj";717;10760;851;11611;NA;104700;1568;2021-01-05;46459
2021-01-04;"Žilinský kraj";479;9763;1023;10786;NA;104700;1502;2021-01-04;44891
2021-01-03;"Žilinský kraj";13;1030;98;1128;NA;104700;111;2021-01-03;43389
2021-01-02;"Žilinský kraj";98;746;86;832;NA;104700;184;2021-01-02;43278
2021-01-01;"Žilinský kraj";118;552;36;588;NA;104700;154;2021-01-01;43094
2020-12-31;"Žilinský kraj";395;10040;814;10854;NA;104700;1209;2020-12-31;42940
2020-12-30;"Žilinský kraj";1038;12026;846;12872;NA;104700;1884;2020-12-30;41731
2020-12-29;"Žilinský kraj";256;10593;1044;11637;NA;104700;1300;2020-12-29;39847
2020-12-28;"Žilinský kraj";406;11231;1061;12292;NA;104700;1467;2020-12-28;38547
2020-12-27;"Žilinský kraj";40;672;80;752;NA;104700;120;2020-12-27;37080
2020-12-26;"Žilinský kraj";135;518;48;566;NA;104700;183;2020-12-26;36960
2020-12-25;"Žilinský kraj";66;111;10;121;NA;104700;76;2020-12-25;36777
2020-12-24;"Žilinský kraj";643;1018;75;1093;NA;104700;718;2020-12-24;36701
2020-12-23;"Žilinský kraj";228;17323;1035;18358;NA;104700;1263;2020-12-23;35983
2020-12-22;"Žilinský kraj";519;13749;1032;14781;NA;104700;1551;2020-12-22;34720
2020-12-21;"Žilinský kraj";444;12622;1100;13722;NA;104700;1544;2020-12-21;33169
2020-12-20;"Žilinský kraj";36;579;73;652;NA;104700;109;2020-12-20;31625
2020-12-19;"Žilinský kraj";208;2080;144;2224;NA;104700;352;2020-12-19;31516
2020-12-18;"Žilinský kraj";333;6899;402;7301;NA;104700;735;2020-12-18;31164
2020-12-17;"Žilinský kraj";500;4248;280;4528;NA;104700;780;2020-12-17;30429
2020-12-16;"Žilinský kraj";333;4000;285;4285;NA;104700;618;2020-12-16;29649
2020-12-15;"Žilinský kraj";528;4182;377;4559;NA;104700;905;2020-12-15;29031
2020-12-14;"Žilinský kraj";321;4273;355;4628;NA;104700;676;2020-12-14;28126
2020-12-13;"Žilinský kraj";26;529;67;596;NA;104700;93;2020-12-13;27450
2020-12-12;"Žilinský kraj";95;1061;53;1114;NA;104700;148;2020-12-12;27357
2020-12-11;"Žilinský kraj";455;4513;274;4787;NA;104700;729;2020-12-11;27209
2020-12-10;"Žilinský kraj";166;9293;830;10123;NA;104700;996;2020-12-10;26480
2020-12-09;"Žilinský kraj";392;2200;131;2331;NA;104700;523;2020-12-09;25484
2020-12-08;"Žilinský kraj";331;3248;123;3371;NA;104700;454;2020-12-08;24961
2020-12-07;"Žilinský kraj";348;2254;127;2381;NA;104700;475;2020-12-07;24507
2020-12-06;"Žilinský kraj";15;128;6;134;NA;104700;21;2020-12-06;24032
2020-12-05;"Žilinský kraj";98;1500;53;1553;NA;104700;151;2020-12-05;24011
2020-12-04;"Žilinský kraj";228;2891;122;3013;NA;104700;350;2020-12-04;23860
2020-12-03;"Žilinský kraj";237;1424;117;1541;NA;104700;354;2020-12-03;23510
2020-12-02;"Žilinský kraj";181;1396;69;1465;NA;104700;250;2020-12-02;23156
2020-12-01;"Žilinský kraj";209;6239;284;6523;NA;104700;493;2020-12-01;22906
2020-11-30;"Žilinský kraj";203;5326;305;5631;NA;104700;508;2020-11-30;22413
2020-11-29;"Žilinský kraj";18;81;7;88;NA;104700;25;2020-11-29;21905
2020-11-28;"Žilinský kraj";99;349;15;364;NA;104700;114;2020-11-28;21880
2020-11-27;"Žilinský kraj";218;914;46;960;NA;104700;264;2020-11-27;21766
2020-11-26;"Žilinský kraj";190;1105;57;1162;NA;104700;247;2020-11-26;21502
2020-11-25;"Žilinský kraj";225;1217;49;1266;NA;104700;274;2020-11-25;21255
2020-11-24;"Žilinský kraj";213;2139;67;2206;NA;104700;280;2020-11-24;20981
2020-11-23;"Žilinský kraj";170;759;44;803;NA;104700;214;2020-11-23;20701
2020-11-22;"Žilinský kraj";11;67;2;69;NA;104700;13;2020-11-22;20487
2020-11-21;"Žilinský kraj";61;505;20;525;NA;104700;81;2020-11-21;20474
2020-11-20;"Žilinský kraj";251;1074;45;1119;NA;104700;296;2020-11-20;20393
2020-11-19;"Žilinský kraj";252;752;61;813;NA;104700;313;2020-11-19;20097
2020-11-18;"Žilinský kraj";346;348;15;363;NA;104700;361;2020-11-18;19784
2020-11-17;"Žilinský kraj";123;490;15;505;NA;104700;138;2020-11-17;19423
2020-11-16;"Žilinský kraj";227;247;15;262;NA;104700;242;2020-11-16;19285
2020-11-15;"Žilinský kraj";63;13;0;13;NA;104700;63;2020-11-15;19043
2020-11-14;"Žilinský kraj";189;1038;11;1049;NA;104700;200;2020-11-14;18980
2020-11-13;"Žilinský kraj";181;125;9;134;NA;104700;190;2020-11-13;18780
2020-11-12;"Žilinský kraj";334;79;2;81;NA;104700;336;2020-11-12;18590
2020-11-11;"Žilinský kraj";489;147;10;157;NA;104700;499;2020-11-11;18254
2020-11-10;"Žilinský kraj";374;519;9;528;NA;104700;383;2020-11-10;17755
2020-11-09;"Žilinský kraj";143;2335;30;2365;NA;104700;173;2020-11-09;17372
2020-11-08;"Žilinský kraj";59;2538;37;2575;NA;104700;96;2020-11-08;17199
2020-11-07;"Žilinský kraj";312;8175;88;8263;NA;104700;400;2020-11-07;17103
2020-11-06;"Žilinský kraj";503;4090;38;4128;NA;104700;541;2020-11-06;16703
2020-11-05;"Žilinský kraj";473;64;4;68;NA;104700;477;2020-11-05;16162
2020-11-04;"Žilinský kraj";423;178;10;188;NA;104700;433;2020-11-04;15685
2020-11-03;"Žilinský kraj";688;889;16;905;NA;104700;704;2020-11-03;15252
2020-11-02;"Žilinský kraj";472;1043;39;1082;NA;104700;511;2020-11-02;14548
2020-11-01;"Žilinský kraj";349;5096;130;5226;NA;104700;479;2020-11-01;14037
2020-10-31;"Žilinský kraj";661;7963;203;8166;NA;104700;864;2020-10-31;13558
2020-10-30;"Žilinský kraj";529;2575;61;2636;NA;104700;590;2020-10-30;12694
2020-10-29;"Žilinský kraj";740;503;17;520;NA;104700;757;2020-10-29;12104
2020-10-28;"Žilinský kraj";635;105;11;116;NA;104700;646;2020-10-28;11347
2020-10-27;"Žilinský kraj";355;154;24;178;NA;104700;379;2020-10-27;10701
2020-10-26;"Žilinský kraj";148;117;28;145;NA;104700;176;2020-10-26;10322
2020-10-25;"Žilinský kraj";436;0;0;0;NA;104700;436;2020-10-25;10146
2020-10-24;"Žilinský kraj";803;0;0;0;NA;104700;803;2020-10-24;9710
2020-10-23;"Žilinský kraj";659;102;13;115;NA;104700;672;2020-10-23;8907
2020-10-22;"Žilinský kraj";525;33;3;36;NA;104700;528;2020-10-22;8235
2020-10-21;"Žilinský kraj";478;74;14;88;NA;104700;492;2020-10-21;7707
2020-10-20;"Žilinský kraj";524;127;8;135;NA;104700;532;2020-10-20;7215
2020-10-19;"Žilinský kraj";70;80;12;92;NA;104700;82;2020-10-19;6683
2020-10-18;"Žilinský kraj";159;0;0;0;NA;104700;159;2020-10-18;6601
2020-10-17;"Žilinský kraj";509;0;0;0;NA;104700;509;2020-10-17;6442
2020-10-16;"Žilinský kraj";603;51;9;60;NA;104700;612;2020-10-16;5933
2020-10-15;"Žilinský kraj";679;61;3;64;NA;104700;682;2020-10-15;5321
2020-10-14;"Žilinský kraj";523;269;6;275;NA;104700;529;2020-10-14;4639
2020-10-13;"Žilinský kraj";367;458;40;498;NA;104700;407;2020-10-13;4110
2020-10-12;"Žilinský kraj";62;0;0;0;NA;104700;62;2020-10-12;3703
2020-10-11;"Žilinský kraj";50;0;0;0;NA;104700;50;2020-10-11;3641
2020-10-10;"Žilinský kraj";213;0;0;0;NA;104700;213;2020-10-10;3591
2020-10-09;"Žilinský kraj";543;0;0;0;NA;104700;543;2020-10-09;3378
2020-10-08;"Žilinský kraj";238;0;0;0;NA;104700;238;2020-10-08;2835
2020-10-07;"Žilinský kraj";168;0;0;0;NA;104700;168;2020-10-07;2597
2020-10-06;"Žilinský kraj";233;0;0;0;NA;104700;233;2020-10-06;2429
2020-10-05;"Žilinský kraj";33;0;0;0;NA;104700;33;2020-10-05;2196
2020-10-04;"Žilinský kraj";35;0;0;0;NA;104700;35;2020-10-04;2163
2020-10-03;"Žilinský kraj";155;0;0;0;NA;104700;155;2020-10-03;2128
2020-10-02;"Žilinský kraj";105;0;0;0;NA;104700;105;2020-10-02;1973
2020-10-01;"Žilinský kraj";147;0;0;0;NA;104700;147;2020-10-01;1868
2020-09-30;"Žilinský kraj";163;0;0;0;NA;104700;163;2020-09-30;1721
2020-09-29;"Žilinský kraj";105;0;0;0;NA;104700;105;2020-09-29;1558
2020-09-28;"Žilinský kraj";34;0;0;0;NA;104700;34;2020-09-28;1453
2020-09-27;"Žilinský kraj";108;0;0;0;NA;104700;108;2020-09-27;1419
2020-09-26;"Žilinský kraj";96;0;0;0;NA;104700;96;2020-09-26;1311
2020-09-25;"Žilinský kraj";69;0;0;0;NA;104700;69;2020-09-25;1215
2020-09-24;"Žilinský kraj";100;0;0;0;NA;104700;100;2020-09-24;1146
2020-09-23;"Žilinský kraj";65;0;0;0;NA;104700;65;2020-09-23;1046
2020-09-22;"Žilinský kraj";65;0;0;0;NA;104700;65;2020-09-22;981
2020-09-21;"Žilinský kraj";47;0;0;0;NA;104700;47;2020-09-21;916
2020-09-20;"Žilinský kraj";4;0;0;0;NA;104700;4;2020-09-20;869
2020-09-19;"Žilinský kraj";6;0;0;0;NA;104700;6;2020-09-19;865
2020-09-18;"Žilinský kraj";82;0;0;0;NA;104700;82;2020-09-18;859
2020-09-17;"Žilinský kraj";30;0;0;0;NA;104700;30;2020-09-17;777
2020-09-16;"Žilinský kraj";34;0;0;0;NA;104700;34;2020-09-16;747
2020-09-15;"Žilinský kraj";12;0;0;0;NA;104700;12;2020-09-15;713
2020-09-14;"Žilinský kraj";39;0;0;0;NA;104700;39;2020-09-14;701
2020-09-13;"Žilinský kraj";6;0;0;0;NA;104700;6;2020-09-13;662
2020-09-12;"Žilinský kraj";4;0;0;0;NA;104700;4;2020-09-12;656
2020-09-11;"Žilinský kraj";31;0;0;0;NA;104700;31;2020-09-11;652
2020-09-10;"Žilinský kraj";31;0;0;0;NA;104700;31;2020-09-10;621
2020-09-09;"Žilinský kraj";23;0;0;0;NA;104700;23;2020-09-09;590
2020-09-08;"Žilinský kraj";25;0;0;0;NA;104700;25;2020-09-08;567
2020-09-07;"Žilinský kraj";11;0;0;0;NA;104700;11;2020-09-07;542
2020-09-06;"Žilinský kraj";0;0;0;0;NA;104700;0;2020-09-06;531
2020-09-05;"Žilinský kraj";2;0;0;0;NA;104700;2;2020-09-05;531
2020-09-04;"Žilinský kraj";33;0;0;0;NA;104700;33;2020-09-04;529
2020-09-03;"Žilinský kraj";18;0;0;0;NA;104700;18;2020-09-03;496
2020-09-02;"Žilinský kraj";16;0;0;0;NA;104700;16;2020-09-02;478
2020-09-01;"Žilinský kraj";4;0;0;0;NA;104700;4;2020-09-01;462
2020-08-31;"Žilinský kraj";5;0;0;0;NA;104700;5;2020-08-31;458
2020-08-30;"Žilinský kraj";3;0;0;0;NA;104700;3;2020-08-30;453
2020-08-29;"Žilinský kraj";5;0;0;0;NA;104700;5;2020-08-29;450
2020-08-28;"Žilinský kraj";13;0;0;0;NA;104700;13;2020-08-28;445
2020-08-27;"Žilinský kraj";18;0;0;0;NA;104700;18;2020-08-27;432
2020-08-26;"Žilinský kraj";8;0;0;0;NA;104700;8;2020-08-26;414
2020-08-25;"Žilinský kraj";2;0;0;0;NA;104700;2;2020-08-25;406
2020-08-24;"Žilinský kraj";5;0;0;0;NA;104700;5;2020-08-24;404
2020-08-23;"Žilinský kraj";0;0;0;0;NA;104700;0;2020-08-23;399
2020-08-22;"Žilinský kraj";0;0;0;0;NA;104700;0;2020-08-22;399
2020-08-21;"Žilinský kraj";10;0;0;0;NA;104700;10;2020-08-21;399
2020-08-20;"Žilinský kraj";13;0;0;0;NA;104700;13;2020-08-20;389
2020-08-19;"Žilinský kraj";7;0;0;0;NA;104700;7;2020-08-19;376
2020-08-18;"Žilinský kraj";9;0;0;0;NA;104700;9;2020-08-18;369
2020-08-17;"Žilinský kraj";1;0;0;0;NA;104700;1;2020-08-17;360
2020-08-16;"Žilinský kraj";0;0;0;0;NA;104700;0;2020-08-16;359
2020-08-15;"Žilinský kraj";0;0;0;0;NA;104700;0;2020-08-15;359
2020-08-14;"Žilinský kraj";4;0;0;0;NA;104700;4;2020-08-14;359
2020-08-13;"Žilinský kraj";2;0;0;0;NA;104700;2;2020-08-13;355
2020-08-12;"Žilinský kraj";0;0;0;0;NA;104700;0;2020-08-12;353
2020-08-11;"Žilinský kraj";4;0;0;0;NA;104700;4;2020-08-11;353
2020-08-10;"Žilinský kraj";1;0;0;0;NA;104700;1;2020-08-10;349
2020-08-09;"Žilinský kraj";0;0;0;0;NA;104700;0;2020-08-09;348
2020-08-08;"Žilinský kraj";3;0;0;0;NA;104700;3;2020-08-08;348
2020-08-07;"Žilinský kraj";8;0;0;0;NA;104700;8;2020-08-07;345
2020-08-06;"Žilinský kraj";1;0;0;0;NA;104700;1;2020-08-06;337
2020-08-05;"Žilinský kraj";1;0;0;0;NA;104700;1;2020-08-05;336
2020-08-04;"Žilinský kraj";2;0;0;0;NA;104700;2;2020-08-04;335
2020-08-03;"Žilinský kraj";0;0;0;0;NA;104700;0;2020-08-03;333
2020-08-02;"Žilinský kraj";1;0;0;0;NA;104700;1;2020-08-02;333
2020-08-01;"Žilinský kraj";0;0;0;0;NA;104700;0;2020-08-01;332
2020-07-31;"Žilinský kraj";4;0;0;0;NA;104700;4;2020-07-31;332
2020-07-30;"Žilinský kraj";2;0;0;0;NA;104700;2;2020-07-30;328
2020-07-29;"Žilinský kraj";2;0;0;0;NA;104700;2;2020-07-29;326
2020-07-28;"Žilinský kraj";4;0;0;0;NA;104700;4;2020-07-28;324
2020-07-27;"Žilinský kraj";6;0;0;0;NA;104700;6;2020-07-27;320
2020-07-26;"Žilinský kraj";0;0;0;0;NA;104700;0;2020-07-26;314
2020-07-25;"Žilinský kraj";0;0;0;0;NA;104700;0;2020-07-25;314
2020-07-24;"Žilinský kraj";2;0;0;0;NA;104700;2;2020-07-24;314
2020-07-23;"Žilinský kraj";0;0;0;0;NA;104700;0;2020-07-23;312
2020-07-22;"Žilinský kraj";1;0;0;0;NA;104700;1;2020-07-22;312
2020-07-21;"Žilinský kraj";2;0;0;0;NA;104700;2;2020-07-21;311
2020-07-20;"Žilinský kraj";3;0;0;0;NA;104700;3;2020-07-20;309
2020-07-19;"Žilinský kraj";0;0;0;0;NA;104700;0;2020-07-19;306
2020-07-18;"Žilinský kraj";0;0;0;0;NA;104700;0;2020-07-18;306
2020-07-17;"Žilinský kraj";2;0;0;0;NA;104700;2;2020-07-17;306
2020-07-16;"Žilinský kraj";2;0;0;0;NA;104700;2;2020-07-16;304
2020-07-15;"Žilinský kraj";2;0;0;0;NA;104700;2;2020-07-15;302
2020-07-14;"Žilinský kraj";1;0;0;0;NA;104700;1;2020-07-14;300
2020-07-13;"Žilinský kraj";0;0;0;0;NA;104700;0;2020-07-13;299
2020-07-12;"Žilinský kraj";0;0;0;0;NA;104700;0;2020-07-12;299
2020-07-11;"Žilinský kraj";2;0;0;0;NA;104700;2;2020-07-11;299
2020-07-10;"Žilinský kraj";3;0;0;0;NA;104700;3;2020-07-10;297
2020-07-09;"Žilinský kraj";2;0;0;0;NA;104700;2;2020-07-09;294
2020-07-08;"Žilinský kraj";10;0;0;0;NA;104700;10;2020-07-08;292
2020-07-07;"Žilinský kraj";7;0;0;0;NA;104700;7;2020-07-07;282
2020-07-06;"Žilinský kraj";0;0;0;0;NA;104700;0;2020-07-06;275
2020-07-05;"Žilinský kraj";0;0;0;0;NA;104700;0;2020-07-05;275
2020-07-04;"Žilinský kraj";10;0;0;0;NA;104700;10;2020-07-04;275
2020-07-03;"Žilinský kraj";18;0;0;0;NA;104700;18;2020-07-03;265
2020-07-02;"Žilinský kraj";7;0;0;0;NA;104700;7;2020-07-02;247
2020-07-01;"Žilinský kraj";0;0;0;0;NA;104700;0;2020-07-01;240
2020-06-30;"Žilinský kraj";4;0;0;0;NA;104700;4;2020-06-30;240
2020-06-29;"Žilinský kraj";0;0;0;0;NA;104700;0;2020-06-29;236
2020-06-28;"Žilinský kraj";1;0;0;0;NA;104700;1;2020-06-28;236
2020-06-27;"Žilinský kraj";3;0;0;0;NA;104700;3;2020-06-27;235
2020-06-26;"Žilinský kraj";5;0;0;0;NA;104700;5;2020-06-26;232
2020-06-25;"Žilinský kraj";7;0;0;0;NA;104700;7;2020-06-25;227
2020-06-24;"Žilinský kraj";11;0;0;0;NA;104700;11;2020-06-24;220
2020-06-23;"Žilinský kraj";9;0;0;0;NA;104700;9;2020-06-23;209
2020-06-22;"Žilinský kraj";0;0;0;0;NA;104700;0;2020-06-22;200
2020-06-21;"Žilinský kraj";1;0;0;0;NA;104700;1;2020-06-21;200
2020-06-20;"Žilinský kraj";1;0;0;0;NA;104700;1;2020-06-20;199
2020-06-19;"Žilinský kraj";4;0;0;0;NA;104700;4;2020-06-19;198
2020-06-18;"Žilinský kraj";1;0;0;0;NA;104700;1;2020-06-18;194
2020-06-17;"Žilinský kraj";0;0;0;0;NA;104700;0;2020-06-17;193
2020-06-16;"Žilinský kraj";1;0;0;0;NA;104700;1;2020-06-16;193
2020-06-14;"Žilinský kraj";0;0;0;0;NA;104700;0;2020-06-14;192
2020-06-13;"Žilinský kraj";0;0;0;0;NA;104700;0;2020-06-13;192
2020-06-12;"Žilinský kraj";0;0;0;0;NA;104700;0;2020-06-12;192
2020-06-11;"Žilinský kraj";0;0;0;0;NA;104700;0;2020-06-11;192
2020-06-10;"Žilinský kraj";0;0;0;0;NA;104700;0;2020-06-10;192
2020-06-09;"Žilinský kraj";1;0;0;0;NA;104700;1;2020-06-09;192
2020-06-08;"Žilinský kraj";0;0;0;0;NA;104700;0;2020-06-08;191
2020-06-07;"Žilinský kraj";0;0;0;0;NA;104700;0;2020-06-07;191
2020-06-05;"Žilinský kraj";0;0;0;0;NA;104700;0;2020-06-05;191
2020-06-03;"Žilinský kraj";0;0;0;0;NA;104700;0;2020-06-03;191
2020-06-02;"Žilinský kraj";0;0;0;0;NA;104700;0;2020-06-02;191
2020-05-31;"Žilinský kraj";0;0;0;0;NA;104700;0;2020-05-31;191
2020-05-29;"Žilinský kraj";0;0;0;0;NA;104700;0;2020-05-29;191
2020-05-27;"Žilinský kraj";1;0;0;0;NA;104700;1;2020-05-27;191
2020-05-26;"Žilinský kraj";1;0;0;0;NA;104700;1;2020-05-26;190
2020-05-25;"Žilinský kraj";0;0;0;0;NA;104700;0;2020-05-25;189
2020-05-24;"Žilinský kraj";0;0;0;0;NA;104700;0;2020-05-24;189
2020-05-23;"Žilinský kraj";0;0;0;0;NA;104700;0;2020-05-23;189
2020-05-22;"Žilinský kraj";0;0;0;0;NA;104700;0;2020-05-22;189
2020-05-21;"Žilinský kraj";0;0;0;0;NA;104700;0;2020-05-21;189
2020-05-20;"Žilinský kraj";0;0;0;0;NA;104700;0;2020-05-20;189
2020-05-19;"Žilinský kraj";1;0;0;0;NA;104700;1;2020-05-19;189
2020-05-17;"Žilinský kraj";0;0;0;0;NA;104700;0;2020-05-17;188
2020-05-16;"Žilinský kraj";0;0;0;0;NA;104700;0;2020-05-16;188
2020-05-15;"Žilinský kraj";0;0;0;0;NA;104700;0;2020-05-15;188
2020-05-14;"Žilinský kraj";0;0;0;0;NA;104700;0;2020-05-14;188
2020-05-13;"Žilinský kraj";0;0;0;0;NA;104700;0;2020-05-13;188
2020-05-12;"Žilinský kraj";0;0;0;0;NA;104700;0;2020-05-12;188
2020-05-11;"Žilinský kraj";0;0;0;0;NA;104700;0;2020-05-11;188
2020-05-09;"Žilinský kraj";0;0;0;0;NA;104700;0;2020-05-09;188
2020-05-07;"Žilinský kraj";0;0;0;0;NA;104700;0;2020-05-07;188
2020-05-06;"Žilinský kraj";2;0;0;0;NA;104700;2;2020-05-06;188
2020-05-05;"Žilinský kraj";3;0;0;0;NA;104700;3;2020-05-05;186
2020-05-04;"Žilinský kraj";3;0;0;0;NA;104700;3;2020-05-04;183
2020-05-03;"Žilinský kraj";1;0;0;0;NA;104700;1;2020-05-03;180
2020-05-02;"Žilinský kraj";0;0;0;0;NA;104700;0;2020-05-02;179
2020-05-01;"Žilinský kraj";1;0;0;0;NA;104700;1;2020-05-01;179
2020-04-30;"Žilinský kraj";0;0;0;0;NA;104700;0;2020-04-30;178
2020-04-29;"Žilinský kraj";0;0;0;0;NA;104700;0;2020-04-29;178
2020-04-28;"Žilinský kraj";0;0;0;0;NA;104700;0;2020-04-28;178
2020-04-27;"Žilinský kraj";0;0;0;0;NA;104700;0;2020-04-27;178
2020-04-26;"Žilinský kraj";0;0;0;0;NA;104700;0;2020-04-26;178
2020-04-25;"Žilinský kraj";2;0;0;0;NA;104700;2;2020-04-25;178
2020-04-24;"Žilinský kraj";1;0;0;0;NA;104700;1;2020-04-24;176
2020-04-23;"Žilinský kraj";2;0;0;0;NA;104700;2;2020-04-23;175
2020-04-22;"Žilinský kraj";9;0;0;0;NA;104700;9;2020-04-22;173
2020-04-21;"Žilinský kraj";1;0;0;0;NA;104700;1;2020-04-21;164
2020-04-20;"Žilinský kraj";4;0;0;0;NA;104700;4;2020-04-20;163
2020-04-19;"Žilinský kraj";0;0;0;0;NA;104700;0;2020-04-19;159
2020-04-18;"Žilinský kraj";49;0;0;0;NA;104700;49;2020-04-18;159
2020-04-17;"Žilinský kraj";3;0;0;0;NA;104700;3;2020-04-17;110
2020-04-16;"Žilinský kraj";4;0;0;0;NA;104700;4;2020-04-16;107
2020-04-15;"Žilinský kraj";7;0;0;0;NA;104700;7;2020-04-15;103
2020-04-14;"Žilinský kraj";1;0;0;0;NA;104700;1;2020-04-14;96
2020-04-13;"Žilinský kraj";2;0;0;0;NA;104700;2;2020-04-13;95
2020-04-12;"Žilinský kraj";5;0;0;0;NA;104700;5;2020-04-12;93
2020-04-11;"Žilinský kraj";2;0;0;0;NA;104700;2;2020-04-11;88
2020-04-10;"Žilinský kraj";1;0;0;0;NA;104700;1;2020-04-10;86
2020-04-09;"Žilinský kraj";1;0;0;0;NA;104700;1;2020-04-09;85
2020-04-08;"Žilinský kraj";3;0;0;0;NA;104700;3;2020-04-08;84
2020-04-07;"Žilinský kraj";5;0;0;0;NA;104700;5;2020-04-07;81
2020-04-06;"Žilinský kraj";6;0;0;0;NA;104700;6;2020-04-06;76
2020-04-05;"Žilinský kraj";8;0;0;0;NA;104700;8;2020-04-05;70
2020-04-04;"Žilinský kraj";0;0;0;0;NA;104700;0;2020-04-04;62
2020-04-03;"Žilinský kraj";3;0;0;0;NA;104700;3;2020-04-03;62
2020-04-02;"Žilinský kraj";5;0;0;0;NA;104700;5;2020-04-02;59
2020-04-01;"Žilinský kraj";4;0;0;0;NA;104700;4;2020-04-01;54
2020-03-31;"Žilinský kraj";1;0;0;0;NA;104700;1;2020-03-31;50
2020-03-30;"Žilinský kraj";3;0;0;0;NA;104700;3;2020-03-30;49
2020-03-29;"Žilinský kraj";0;0;0;0;NA;104700;0;2020-03-29;46
2020-03-28;"Žilinský kraj";1;0;0;0;NA;104700;1;2020-03-28;46
2020-03-27;"Žilinský kraj";9;0;0;0;NA;104700;9;2020-03-27;45
2020-03-26;"Žilinský kraj";4;0;0;0;NA;104700;4;2020-03-26;36
2020-03-25;"Žilinský kraj";1;0;0;0;NA;104700;1;2020-03-25;32
2020-03-24;"Žilinský kraj";2;0;0;0;NA;104700;2;2020-03-24;31
2020-03-23;"Žilinský kraj";3;0;0;0;NA;104700;3;2020-03-23;29
2020-03-22;"Žilinský kraj";1;0;0;0;NA;104700;1;2020-03-22;26
2020-03-21;"Žilinský kraj";2;0;0;0;NA;104700;2;2020-03-21;25
2020-03-20;"Žilinský kraj";4;0;0;0;NA;104700;4;2020-03-20;23
2020-03-19;"Žilinský kraj";2;219;0;219;NA;104700;2;2020-03-19;19
2020-03-18;"Žilinský kraj";1;0;0;0;NA;104700;1;2020-03-18;17
2020-03-17;"Žilinský kraj";5;0;0;0;NA;104700;5;2020-03-17;16
2020-03-16;"Žilinský kraj";1;0;0;0;NA;104700;1;2020-03-16;11
2020-03-15;"Žilinský kraj";2;0;0;0;NA;104700;2;2020-03-15;10
2020-03-14;"Žilinský kraj";1;0;0;0;NA;104700;1;2020-03-14;8
2020-03-13;"Žilinský kraj";5;0;0;0;NA;104700;5;2020-03-13;7
2020-03-12;"Žilinský kraj";1;0;0;0;NA;104700;1;2020-03-12;2
2020-03-11;"Žilinský kraj";0;0;0;0;NA;104700;0;2020-03-11;1
2020-03-09;"Žilinský kraj";1;0;0;0;NA;104700;1;2020-03-09;1
2020-03-08;"Žilinský kraj";0;0;0;0;NA;104700;0;2020-03-08;0
2020-03-07;"Žilinský kraj";0;0;0;0;NA;104700;0;2020-03-07;0
2020-03-06;"Žilinský kraj";0;0;0;0;NA;104700;0;2020-03-06;0
