"Datum";"Region";"PCR_Pos";"Ag_Neg";"Ag_Pos";"Total";"Pocet.potvrdenych";"Potvrdenych";"newcases";"date";"positive"
2021-02-01;"Banskobystrický kraj";75;19430;370;19800;NA;20164;445;2021-02-01;20164
2021-01-31;"Banskobystrický kraj";34;21334;210;21544;NA;20164;244;2021-01-31;19719
2021-01-30;"Banskobystrický kraj";163;39301;353;39654;NA;20164;516;2021-01-30;19475
2021-01-29;"Banskobystrický kraj";130;14469;240;14709;NA;20164;370;2021-01-29;18959
2021-01-28;"Banskobystrický kraj";218;13970;340;14310;NA;20164;558;2021-01-28;18589
2021-01-27;"Banskobystrický kraj";191;10749;197;10946;NA;20164;388;2021-01-27;18031
2021-01-26;"Banskobystrický kraj";238;19759;287;20046;NA;20164;525;2021-01-26;17643
2021-01-25;"Banskobystrický kraj";82;31370;368;31738;NA;20164;450;2021-01-25;17118
2021-01-24;"Banskobystrický kraj";38;27437;227;27664;NA;20164;265;2021-01-24;16668
2021-01-23;"Banskobystrický kraj";142;77481;489;77970;NA;20164;631;2021-01-23;16403
2021-01-22;"Banskobystrický kraj";175;26969;340;27309;NA;20164;515;2021-01-22;15772
2021-01-21;"Banskobystrický kraj";194;16341;354;16695;NA;20164;548;2021-01-21;15257
2021-01-20;"Banskobystrický kraj";231;8860;186;9046;NA;20164;417;2021-01-20;14709
2021-01-19;"Banskobystrický kraj";213;10885;324;11209;NA;20164;537;2021-01-19;14292
2021-01-18;"Banskobystrický kraj";94;6716;330;7046;NA;20164;424;2021-01-18;13755
2021-01-17;"Banskobystrický kraj";110;8150;77;8227;NA;20164;187;2021-01-17;13331
2021-01-16;"Banskobystrický kraj";58;1873;56;1929;NA;20164;114;2021-01-16;13144
2021-01-15;"Banskobystrický kraj";164;6312;203;6515;NA;20164;367;2021-01-15;13030
2021-01-14;"Banskobystrický kraj";220;5443;320;5763;NA;20164;540;2021-01-14;12663
2021-01-13;"Banskobystrický kraj";235;5560;191;5751;NA;20164;426;2021-01-13;12123
2021-01-12;"Banskobystrický kraj";194;6171;414;6585;NA;20164;608;2021-01-12;11697
2021-01-11;"Banskobystrický kraj";76;7034;411;7445;NA;20164;487;2021-01-11;11089
2021-01-10;"Banskobystrický kraj";110;102;4;106;NA;20164;114;2021-01-10;10602
2021-01-09;"Banskobystrický kraj";297;2728;107;2835;NA;20164;404;2021-01-09;10488
2021-01-08;"Banskobystrický kraj";435;8076;383;8459;NA;20164;818;2021-01-08;10084
2021-01-07;"Banskobystrický kraj";127;4037;260;4297;NA;20164;387;2021-01-07;9266
2021-01-06;"Banskobystrický kraj";305;3369;210;3579;NA;20164;515;2021-01-06;8879
2021-01-05;"Banskobystrický kraj";372;6771;501;7272;NA;20164;873;2021-01-05;8364
2021-01-04;"Banskobystrický kraj";130;5668;565;6233;NA;20164;695;2021-01-04;7491
2021-01-03;"Banskobystrický kraj";199;174;13;187;NA;20164;212;2021-01-03;6796
2021-01-02;"Banskobystrický kraj";123;571;83;654;NA;20164;206;2021-01-02;6584
2021-01-01;"Banskobystrický kraj";220;2015;135;2150;NA;20164;355;2021-01-01;6378
2020-12-31;"Banskobystrický kraj";499;6796;724;7520;NA;20164;1223;2020-12-31;6023
2020-12-30;"Banskobystrický kraj";593;7101;536;7637;NA;20164;1129;2020-12-30;4800
2020-12-29;"Banskobystrický kraj";240;7590;738;8328;NA;20164;978;2020-12-29;3671
2020-12-28;"Banskobystrický kraj";131;5575;674;6249;NA;20164;805;2020-12-28;2693
2020-12-27;"Banskobystrický kraj";116;496;25;521;NA;20164;141;2020-12-27;1888
2020-12-26;"Banskobystrický kraj";61;259;32;291;NA;20164;93;2020-12-26;1747
2020-12-25;"Banskobystrický kraj";65;229;6;235;NA;20164;71;2020-12-25;1654
2020-12-24;"Banskobystrický kraj";452;3674;135;3809;NA;20164;587;2020-12-24;1583
2020-12-23;"Banskobystrický kraj";368;9388;470;9858;NA;20164;838;2020-12-23;996
2020-12-22;"Banskobystrický kraj";307;8300;624;8924;NA;20164;931;2020-12-22;158
2020-12-21;"Banskobystrický kraj";286;4898;448;5346;NA;20164;734;2020-12-21;-773
2020-12-20;"Banskobystrický kraj";155;99;14;113;NA;20164;169;2020-12-20;-1507
2020-12-19;"Banskobystrický kraj";170;2488;565;3053;NA;20164;735;2020-12-19;-1676
2020-12-18;"Banskobystrický kraj";432;6454;414;6868;NA;20164;846;2020-12-18;-2411
2020-12-17;"Banskobystrický kraj";468;8474;772;9246;NA;20164;1240;2020-12-17;-3257
2020-12-16;"Banskobystrický kraj";379;10080;557;10637;NA;20164;936;2020-12-16;-4497
2020-12-15;"Banskobystrický kraj";336;5318;430;5748;NA;20164;766;2020-12-15;-5433
2020-12-14;"Banskobystrický kraj";148;3733;259;3992;NA;20164;407;2020-12-14;-6199
2020-12-13;"Banskobystrický kraj";122;19;1;20;NA;20164;123;2020-12-13;-6606
2020-12-12;"Banskobystrický kraj";137;2594;138;2732;NA;20164;275;2020-12-12;-6729
2020-12-11;"Banskobystrický kraj";468;6443;374;6817;NA;20164;842;2020-12-11;-7004
2020-12-10;"Banskobystrický kraj";280;5027;351;5378;NA;20164;631;2020-12-10;-7846
2020-12-09;"Banskobystrický kraj";323;3707;212;3919;NA;20164;535;2020-12-09;-8477
2020-12-08;"Banskobystrický kraj";256;3667;276;3943;NA;20164;532;2020-12-08;-9012
2020-12-07;"Banskobystrický kraj";175;2006;140;2146;NA;20164;315;2020-12-07;-9544
2020-12-06;"Banskobystrický kraj";121;359;9;368;NA;20164;130;2020-12-06;-9859
2020-12-05;"Banskobystrický kraj";109;952;33;985;NA;20164;142;2020-12-05;-9989
2020-12-04;"Banskobystrický kraj";339;3723;174;3897;NA;20164;513;2020-12-04;-10131
2020-12-03;"Banskobystrický kraj";240;2913;227;3140;NA;20164;467;2020-12-03;-10644
2020-12-02;"Banskobystrický kraj";217;4292;186;4478;NA;20164;403;2020-12-02;-11111
2020-12-01;"Banskobystrický kraj";215;2619;134;2753;NA;20164;349;2020-12-01;-11514
2020-11-30;"Banskobystrický kraj";75;3761;226;3987;NA;20164;301;2020-11-30;-11863
2020-11-29;"Banskobystrický kraj";19;80;3;83;NA;20164;22;2020-11-29;-12164
2020-11-28;"Banskobystrický kraj";81;1279;48;1327;NA;20164;129;2020-11-28;-12186
2020-11-27;"Banskobystrický kraj";219;1930;120;2050;NA;20164;339;2020-11-27;-12315
2020-11-26;"Banskobystrický kraj";209;1855;91;1946;NA;20164;300;2020-11-26;-12654
2020-11-25;"Banskobystrický kraj";170;1760;84;1844;NA;20164;254;2020-11-25;-12954
2020-11-24;"Banskobystrický kraj";166;2262;67;2329;NA;20164;233;2020-11-24;-13208
2020-11-23;"Banskobystrický kraj";66;9948;191;10139;NA;20164;257;2020-11-23;-13441
2020-11-22;"Banskobystrický kraj";38;72;1;73;NA;20164;39;2020-11-22;-13698
2020-11-21;"Banskobystrický kraj";52;885;14;899;NA;20164;66;2020-11-21;-13737
2020-11-20;"Banskobystrický kraj";127;1872;105;1977;NA;20164;232;2020-11-20;-13803
2020-11-19;"Banskobystrický kraj";170;1112;82;1194;NA;20164;252;2020-11-19;-14035
2020-11-18;"Banskobystrický kraj";153;587;62;649;NA;20164;215;2020-11-18;-14287
2020-11-17;"Banskobystrický kraj";52;578;35;613;NA;20164;87;2020-11-17;-14502
2020-11-16;"Banskobystrický kraj";106;351;22;373;NA;20164;128;2020-11-16;-14589
2020-11-15;"Banskobystrický kraj";52;64;2;66;NA;20164;54;2020-11-15;-14717
2020-11-14;"Banskobystrický kraj";73;305;2;307;NA;20164;75;2020-11-14;-14771
2020-11-13;"Banskobystrický kraj";157;552;11;563;NA;20164;168;2020-11-13;-14846
2020-11-12;"Banskobystrický kraj";218;952;44;996;NA;20164;262;2020-11-12;-15014
2020-11-11;"Banskobystrický kraj";224;437;9;446;NA;20164;233;2020-11-11;-15276
2020-11-10;"Banskobystrický kraj";263;463;18;481;NA;20164;281;2020-11-10;-15509
2020-11-09;"Banskobystrický kraj";80;2678;31;2709;NA;20164;111;2020-11-09;-15790
2020-11-08;"Banskobystrický kraj";82;783;16;799;NA;20164;98;2020-11-08;-15901
2020-11-07;"Banskobystrický kraj";164;8828;94;8922;NA;20164;258;2020-11-07;-15999
2020-11-06;"Banskobystrický kraj";227;2496;16;2512;NA;20164;243;2020-11-06;-16257
2020-11-05;"Banskobystrický kraj";240;263;33;296;NA;20164;273;2020-11-05;-16500
2020-11-04;"Banskobystrický kraj";254;1366;13;1379;NA;20164;267;2020-11-04;-16773
2020-11-03;"Banskobystrický kraj";246;1332;4;1336;NA;20164;250;2020-11-03;-17040
2020-11-02;"Banskobystrický kraj";90;2247;65;2312;NA;20164;155;2020-11-02;-17290
2020-11-01;"Banskobystrický kraj";101;2671;42;2713;NA;20164;143;2020-11-01;-17445
2020-10-31;"Banskobystrický kraj";198;13516;116;13632;NA;20164;314;2020-10-31;-17588
2020-10-30;"Banskobystrický kraj";254;2829;20;2849;NA;20164;274;2020-10-30;-17902
2020-10-29;"Banskobystrický kraj";372;969;42;1011;NA;20164;414;2020-10-29;-18176
2020-10-28;"Banskobystrický kraj";285;302;30;332;NA;20164;315;2020-10-28;-18590
2020-10-27;"Banskobystrický kraj";266;654;40;694;NA;20164;306;2020-10-27;-18905
2020-10-26;"Banskobystrický kraj";38;232;29;261;NA;20164;67;2020-10-26;-19211
2020-10-25;"Banskobystrický kraj";50;140;11;151;NA;20164;61;2020-10-25;-19278
2020-10-24;"Banskobystrický kraj";315;114;12;126;NA;20164;327;2020-10-24;-19339
2020-10-23;"Banskobystrický kraj";231;230;29;259;NA;20164;260;2020-10-23;-19666
2020-10-22;"Banskobystrický kraj";264;253;24;277;NA;20164;288;2020-10-22;-19926
2020-10-21;"Banskobystrický kraj";209;266;3;269;NA;20164;212;2020-10-21;-20214
2020-10-20;"Banskobystrický kraj";210;66;3;69;NA;20164;213;2020-10-20;-20426
2020-10-19;"Banskobystrický kraj";27;71;12;83;NA;20164;39;2020-10-19;-20639
2020-10-18;"Banskobystrický kraj";49;0;0;0;NA;20164;49;2020-10-18;-20678
2020-10-17;"Banskobystrický kraj";91;0;0;0;NA;20164;91;2020-10-17;-20727
2020-10-16;"Banskobystrický kraj";224;37;3;40;NA;20164;227;2020-10-16;-20818
2020-10-15;"Banskobystrický kraj";133;29;1;30;NA;20164;134;2020-10-15;-21045
2020-10-14;"Banskobystrický kraj";139;31;1;32;NA;20164;140;2020-10-14;-21179
2020-10-13;"Banskobystrický kraj";151;169;11;180;NA;20164;162;2020-10-13;-21319
2020-10-12;"Banskobystrický kraj";11;13;0;13;NA;20164;11;2020-10-12;-21481
2020-10-11;"Banskobystrický kraj";14;0;0;0;NA;20164;14;2020-10-11;-21492
2020-10-10;"Banskobystrický kraj";53;0;0;0;NA;20164;53;2020-10-10;-21506
2020-10-09;"Banskobystrický kraj";128;0;0;0;NA;20164;128;2020-10-09;-21559
2020-10-08;"Banskobystrický kraj";99;0;0;0;NA;20164;99;2020-10-08;-21687
2020-10-07;"Banskobystrický kraj";124;0;0;0;NA;20164;124;2020-10-07;-21786
2020-10-06;"Banskobystrický kraj";68;0;0;0;NA;20164;68;2020-10-06;-21910
2020-10-05;"Banskobystrický kraj";49;0;0;0;NA;20164;49;2020-10-05;-21978
2020-10-04;"Banskobystrický kraj";8;0;0;0;NA;20164;8;2020-10-04;-22027
2020-10-03;"Banskobystrický kraj";37;0;0;0;NA;20164;37;2020-10-03;-22035
2020-10-02;"Banskobystrický kraj";74;0;0;0;NA;20164;74;2020-10-02;-22072
2020-10-01;"Banskobystrický kraj";49;0;0;0;NA;20164;49;2020-10-01;-22146
2020-09-30;"Banskobystrický kraj";60;0;0;0;NA;20164;60;2020-09-30;-22195
2020-09-29;"Banskobystrický kraj";24;0;0;0;NA;20164;24;2020-09-29;-22255
2020-09-27;"Banskobystrický kraj";20;0;0;0;NA;20164;20;2020-09-27;-22279
2020-09-26;"Banskobystrický kraj";24;0;0;0;NA;20164;24;2020-09-26;-22299
2020-09-25;"Banskobystrický kraj";29;0;0;0;NA;20164;29;2020-09-25;-22323
2020-09-24;"Banskobystrický kraj";25;0;0;0;NA;20164;25;2020-09-24;-22352
2020-09-23;"Banskobystrický kraj";17;0;0;0;NA;20164;17;2020-09-23;-22377
2020-09-22;"Banskobystrický kraj";25;0;0;0;NA;20164;25;2020-09-22;-22394
2020-09-21;"Banskobystrický kraj";3;0;0;0;NA;20164;3;2020-09-21;-22419
2020-09-19;"Banskobystrický kraj";3;0;0;0;NA;20164;3;2020-09-19;-22422
2020-09-18;"Banskobystrický kraj";24;0;0;0;NA;20164;24;2020-09-18;-22425
2020-09-17;"Banskobystrický kraj";14;0;0;0;NA;20164;14;2020-09-17;-22449
2020-09-16;"Banskobystrický kraj";6;0;0;0;NA;20164;6;2020-09-16;-22463
2020-09-15;"Banskobystrický kraj";2;0;0;0;NA;20164;2;2020-09-15;-22469
2020-09-14;"Banskobystrický kraj";13;0;0;0;NA;20164;13;2020-09-14;-22471
2020-09-13;"Banskobystrický kraj";1;0;0;0;NA;20164;1;2020-09-13;-22484
2020-09-12;"Banskobystrický kraj";5;0;0;0;NA;20164;5;2020-09-12;-22485
2020-09-11;"Banskobystrický kraj";19;0;0;0;NA;20164;19;2020-09-11;-22490
2020-09-10;"Banskobystrický kraj";11;0;0;0;NA;20164;11;2020-09-10;-22509
2020-09-09;"Banskobystrický kraj";13;0;0;0;NA;20164;13;2020-09-09;-22520
2020-09-08;"Banskobystrický kraj";5;0;0;0;NA;20164;5;2020-09-08;-22533
2020-09-07;"Banskobystrický kraj";2;0;0;0;NA;20164;2;2020-09-07;-22538
2020-09-04;"Banskobystrický kraj";9;0;0;0;NA;20164;9;2020-09-04;-22540
2020-09-03;"Banskobystrický kraj";5;0;0;0;NA;20164;5;2020-09-03;-22549
2021-02-01;"Bratislavský kraj";221;40553;530;41083;NA;22102;751;2021-02-01;22102
2021-01-31;"Bratislavský kraj";180;32384;373;32757;NA;22102;553;2021-01-31;21351
2021-01-30;"Bratislavský kraj";310;35339;364;35703;NA;22102;674;2021-01-30;20798
2021-01-29;"Bratislavský kraj";82;14255;310;14565;NA;22102;392;2021-01-29;20124
2021-01-28;"Bratislavský kraj";307;10155;289;10444;NA;22102;596;2021-01-28;19732
2021-01-27;"Bratislavský kraj";336;22701;348;23049;NA;22102;684;2021-01-27;19136
2021-01-26;"Bratislavský kraj";297;22246;294;22540;NA;22102;591;2021-01-26;18452
2021-01-25;"Bratislavský kraj";356;24005;275;24280;NA;22102;631;2021-01-25;17861
2021-01-24;"Bratislavský kraj";175;33101;333;33434;NA;22102;508;2021-01-24;17230
2021-01-23;"Bratislavský kraj";396;70692;604;71296;NA;22102;1000;2021-01-23;16722
2021-01-22;"Bratislavský kraj";199;39718;341;40059;NA;22102;540;2021-01-22;15722
2021-01-21;"Bratislavský kraj";255;41328;422;41750;NA;22102;677;2021-01-21;15182
2021-01-20;"Bratislavský kraj";360;27647;465;28112;NA;22102;825;2021-01-20;14505
2021-01-19;"Bratislavský kraj";375;13009;316;13325;NA;22102;691;2021-01-19;13680
2021-01-18;"Bratislavský kraj";357;10651;700;11351;NA;22102;1057;2021-01-18;12989
2021-01-17;"Bratislavský kraj";244;286;26;312;NA;22102;270;2021-01-17;11932
2021-01-16;"Bratislavský kraj";70;2705;148;2853;NA;22102;218;2021-01-16;11662
2021-01-15;"Bratislavský kraj";251;7052;235;7287;NA;22102;486;2021-01-15;11444
2021-01-14;"Bratislavský kraj";363;8078;273;8351;NA;22102;636;2021-01-14;10958
2021-01-13;"Bratislavský kraj";336;17791;413;18204;NA;22102;749;2021-01-13;10322
2021-01-12;"Bratislavský kraj";450;9223;444;9667;NA;22102;894;2021-01-12;9573
2021-01-11;"Bratislavský kraj";397;8924;312;9236;NA;22102;709;2021-01-11;8679
2021-01-10;"Bratislavský kraj";252;1341;79;1420;NA;22102;331;2021-01-10;7970
2021-01-09;"Bratislavský kraj";351;4943;291;5234;NA;22102;642;2021-01-09;7639
2021-01-08;"Bratislavský kraj";556;8780;441;9221;NA;22102;997;2021-01-08;6997
2021-01-07;"Bratislavský kraj";537;6895;424;7319;NA;22102;961;2021-01-07;6000
2021-01-06;"Bratislavský kraj";271;3160;230;3390;NA;22102;501;2021-01-06;5039
2021-01-05;"Bratislavský kraj";619;11468;854;12322;NA;22102;1473;2021-01-05;4538
2021-01-04;"Bratislavský kraj";601;7124;627;7751;NA;22102;1228;2021-01-04;3065
2021-01-03;"Bratislavský kraj";77;594;79;673;NA;22102;156;2021-01-03;1837
2021-01-02;"Bratislavský kraj";185;462;35;497;NA;22102;220;2021-01-02;1681
2021-01-01;"Bratislavský kraj";235;3143;130;3273;NA;22102;365;2021-01-01;1461
2020-12-31;"Bratislavský kraj";925;13251;562;13813;NA;22102;1487;2020-12-31;1096
2020-12-30;"Bratislavský kraj";650;9196;518;9714;NA;22102;1168;2020-12-30;-391
2020-12-29;"Bratislavský kraj";303;10407;770;11177;NA;22102;1073;2020-12-29;-1559
2020-12-28;"Bratislavský kraj";255;7608;559;8167;NA;22102;814;2020-12-28;-2632
2020-12-27;"Bratislavský kraj";160;549;67;616;NA;22102;227;2020-12-27;-3446
2020-12-26;"Bratislavský kraj";75;416;23;439;NA;22102;98;2020-12-26;-3673
2020-12-25;"Bratislavský kraj";114;460;38;498;NA;22102;152;2020-12-25;-3771
2020-12-24;"Bratislavský kraj";536;4112;122;4234;NA;22102;658;2020-12-24;-3923
2020-12-23;"Bratislavský kraj";416;12067;482;12549;NA;22102;898;2020-12-23;-4581
2020-12-22;"Bratislavský kraj";327;14938;764;15702;NA;22102;1091;2020-12-22;-5479
2020-12-21;"Bratislavský kraj";392;14725;1998;16723;NA;22102;2390;2020-12-21;-6570
2020-12-20;"Bratislavský kraj";180;558;52;610;NA;22102;232;2020-12-20;-8960
2020-12-19;"Bratislavský kraj";396;3150;129;3279;NA;22102;525;2020-12-19;-9192
2020-12-18;"Bratislavský kraj";306;11002;420;11422;NA;22102;726;2020-12-18;-9717
2020-12-17;"Bratislavský kraj";502;8783;377;9160;NA;22102;879;2020-12-17;-10443
2020-12-16;"Bratislavský kraj";282;9893;428;10321;NA;22102;710;2020-12-16;-11322
2020-12-15;"Bratislavský kraj";423;10277;471;10748;NA;22102;894;2020-12-15;-12032
2020-12-14;"Bratislavský kraj";279;6208;295;6503;NA;22102;574;2020-12-14;-12926
2020-12-13;"Bratislavský kraj";125;108;7;115;NA;22102;132;2020-12-13;-13500
2020-12-12;"Bratislavský kraj";361;3734;157;3891;NA;22102;518;2020-12-12;-13632
2020-12-11;"Bratislavský kraj";326;7059;305;7364;NA;22102;631;2020-12-11;-14150
2020-12-10;"Bratislavský kraj";286;4996;219;5215;NA;22102;505;2020-12-10;-14781
2020-12-09;"Bratislavský kraj";382;5249;207;5456;NA;22102;589;2020-12-09;-15286
2020-12-08;"Bratislavský kraj";234;5427;197;5624;NA;22102;431;2020-12-08;-15875
2020-12-07;"Bratislavský kraj";272;4345;168;4513;NA;22102;440;2020-12-07;-16306
2020-12-06;"Bratislavský kraj";61;1584;52;1636;NA;22102;113;2020-12-06;-16746
2020-12-05;"Bratislavský kraj";266;2144;41;2185;NA;22102;307;2020-12-05;-16859
2020-12-04;"Bratislavský kraj";200;4511;104;4615;NA;22102;304;2020-12-04;-17166
2020-12-03;"Bratislavský kraj";213;5036;102;5138;NA;22102;315;2020-12-03;-17470
2020-12-02;"Bratislavský kraj";204;2452;135;2587;NA;22102;339;2020-12-02;-17785
2020-12-01;"Bratislavský kraj";255;3305;168;3473;NA;22102;423;2020-12-01;-18124
2020-11-30;"Bratislavský kraj";152;1727;103;1830;NA;22102;255;2020-11-30;-18547
2020-11-29;"Bratislavský kraj";52;41;21;62;NA;22102;73;2020-11-29;-18802
2020-11-28;"Bratislavský kraj";232;1983;21;2004;NA;22102;253;2020-11-28;-18875
2020-11-27;"Bratislavský kraj";54;1198;29;1227;NA;22102;83;2020-11-27;-19128
2020-11-26;"Bratislavský kraj";129;1114;25;1139;NA;22102;154;2020-11-26;-19211
2020-11-25;"Bratislavský kraj";140;1133;31;1164;NA;22102;171;2020-11-25;-19365
2020-11-24;"Bratislavský kraj";81;2988;67;3055;NA;22102;148;2020-11-24;-19536
2020-11-23;"Bratislavský kraj";67;7077;58;7135;NA;22102;125;2020-11-23;-19684
2020-11-22;"Bratislavský kraj";36;81;7;88;NA;22102;43;2020-11-22;-19809
2020-11-21;"Bratislavský kraj";109;2126;47;2173;NA;22102;156;2020-11-21;-19852
2020-11-20;"Bratislavský kraj";118;2869;48;2917;NA;22102;166;2020-11-20;-20008
2020-11-19;"Bratislavský kraj";173;987;29;1016;NA;22102;202;2020-11-19;-20174
2020-11-18;"Bratislavský kraj";118;616;75;691;NA;22102;193;2020-11-18;-20376
2020-11-17;"Bratislavský kraj";108;928;23;951;NA;22102;131;2020-11-17;-20569
2020-11-16;"Bratislavský kraj";82;651;9;660;NA;22102;91;2020-11-16;-20700
2020-11-15;"Bratislavský kraj";47;236;0;236;NA;22102;47;2020-11-15;-20791
2020-11-14;"Bratislavský kraj";53;1834;15;1849;NA;22102;68;2020-11-14;-20838
2020-11-13;"Bratislavský kraj";94;2096;21;2117;NA;22102;115;2020-11-13;-20906
2020-11-12;"Bratislavský kraj";141;1727;6;1733;NA;22102;147;2020-11-12;-21021
2020-11-11;"Bratislavský kraj";159;1429;12;1441;NA;22102;171;2020-11-11;-21168
2020-11-10;"Bratislavský kraj";136;805;14;819;NA;22102;150;2020-11-10;-21339
2020-11-09;"Bratislavský kraj";70;609;8;617;NA;22102;78;2020-11-09;-21489
2020-11-08;"Bratislavský kraj";82;869;6;875;NA;22102;88;2020-11-08;-21567
2020-11-07;"Bratislavský kraj";88;4039;17;4056;NA;22102;105;2020-11-07;-21655
2020-11-06;"Bratislavský kraj";281;6441;25;6466;NA;22102;306;2020-11-06;-21760
2020-11-05;"Bratislavský kraj";175;476;11;487;NA;22102;186;2020-11-05;-22066
2020-11-04;"Bratislavský kraj";65;411;10;421;NA;22102;75;2020-11-04;-22252
2020-11-03;"Bratislavský kraj";251;1081;12;1093;NA;22102;263;2020-11-03;-22327
2020-11-02;"Bratislavský kraj";202;3365;22;3387;NA;22102;224;2020-11-02;-22590
2020-11-01;"Bratislavský kraj";227;8694;39;8733;NA;22102;266;2020-11-01;-22814
2020-10-31;"Bratislavský kraj";173;22407;123;22530;NA;22102;296;2020-10-31;-23080
2020-10-30;"Bratislavský kraj";158;17350;138;17488;NA;22102;296;2020-10-30;-23376
2020-10-29;"Bratislavský kraj";262;116;4;120;NA;22102;266;2020-10-29;-23672
2020-10-28;"Bratislavský kraj";220;260;15;275;NA;22102;235;2020-10-28;-23938
2020-10-27;"Bratislavský kraj";256;145;4;149;NA;22102;260;2020-10-27;-24173
2020-10-26;"Bratislavský kraj";123;229;11;240;NA;22102;134;2020-10-26;-24433
2020-10-25;"Bratislavský kraj";152;33;2;35;NA;22102;154;2020-10-25;-24567
2020-10-24;"Bratislavský kraj";170;221;6;227;NA;22102;176;2020-10-24;-24721
2020-10-23;"Bratislavský kraj";151;144;8;152;NA;22102;159;2020-10-23;-24897
2020-10-22;"Bratislavský kraj";192;204;15;219;NA;22102;207;2020-10-22;-25056
2020-10-21;"Bratislavský kraj";66;90;6;96;NA;22102;72;2020-10-21;-25263
2020-10-20;"Bratislavský kraj";183;97;4;101;NA;22102;187;2020-10-20;-25335
2020-10-19;"Bratislavský kraj";148;80;3;83;NA;22102;151;2020-10-19;-25522
2020-10-18;"Bratislavský kraj";75;92;0;92;NA;22102;75;2020-10-18;-25673
2020-10-17;"Bratislavský kraj";136;0;0;0;NA;22102;136;2020-10-17;-25748
2020-10-16;"Bratislavský kraj";103;14;1;15;NA;22102;104;2020-10-16;-25884
2020-10-15;"Bratislavský kraj";135;6;1;7;NA;22102;136;2020-10-15;-25988
2020-10-14;"Bratislavský kraj";127;4;0;4;NA;22102;127;2020-10-14;-26124
2020-10-13;"Bratislavský kraj";86;108;8;116;NA;22102;94;2020-10-13;-26251
2020-10-12;"Bratislavský kraj";46;0;0;0;NA;22102;46;2020-10-12;-26345
2020-10-11;"Bratislavský kraj";80;0;0;0;NA;22102;80;2020-10-11;-26391
2020-10-10;"Bratislavský kraj";55;0;0;0;NA;22102;55;2020-10-10;-26471
2020-10-09;"Bratislavský kraj";148;0;0;0;NA;22102;148;2020-10-09;-26526
2020-10-08;"Bratislavský kraj";100;0;0;0;NA;22102;100;2020-10-08;-26674
2020-10-07;"Bratislavský kraj";107;0;0;0;NA;22102;107;2020-10-07;-26774
2020-10-06;"Bratislavský kraj";108;0;0;0;NA;22102;108;2020-10-06;-26881
2020-10-05;"Bratislavský kraj";30;0;0;0;NA;22102;30;2020-10-05;-26989
2020-10-04;"Bratislavský kraj";49;0;0;0;NA;22102;49;2020-10-04;-27019
2020-10-03;"Bratislavský kraj";82;0;0;0;NA;22102;82;2020-10-03;-27068
2020-10-02;"Bratislavský kraj";101;0;0;0;NA;22102;101;2020-10-02;-27150
2020-10-01;"Bratislavský kraj";72;0;0;0;NA;22102;72;2020-10-01;-27251
2020-09-30;"Bratislavský kraj";91;0;0;0;NA;22102;91;2020-09-30;-27323
2020-09-29;"Bratislavský kraj";74;0;0;0;NA;22102;74;2020-09-29;-27414
2020-09-28;"Bratislavský kraj";29;0;0;0;NA;22102;29;2020-09-28;-27488
2020-09-27;"Bratislavský kraj";48;0;0;0;NA;22102;48;2020-09-27;-27517
2020-09-26;"Bratislavský kraj";86;0;0;0;NA;22102;86;2020-09-26;-27565
2020-09-25;"Bratislavský kraj";97;0;0;0;NA;22102;97;2020-09-25;-27651
2020-09-24;"Bratislavský kraj";73;0;0;0;NA;22102;73;2020-09-24;-27748
2020-09-23;"Bratislavský kraj";55;0;0;0;NA;22102;55;2020-09-23;-27821
2020-09-22;"Bratislavský kraj";81;0;0;0;NA;22102;81;2020-09-22;-27876
2020-09-21;"Bratislavský kraj";32;0;0;0;NA;22102;32;2020-09-21;-27957
2020-09-20;"Bratislavský kraj";25;0;0;0;NA;22102;25;2020-09-20;-27989
2020-09-19;"Bratislavský kraj";59;0;0;0;NA;22102;59;2020-09-19;-28014
2020-09-18;"Bratislavský kraj";42;0;0;0;NA;22102;42;2020-09-18;-28073
2020-09-17;"Bratislavský kraj";52;0;0;0;NA;22102;52;2020-09-17;-28115
2020-09-16;"Bratislavský kraj";32;0;0;0;NA;22102;32;2020-09-16;-28167
2020-09-15;"Bratislavský kraj";26;0;0;0;NA;22102;26;2020-09-15;-28199
2020-09-14;"Bratislavský kraj";24;0;0;0;NA;22102;24;2020-09-14;-28225
2020-09-13;"Bratislavský kraj";11;0;0;0;NA;22102;11;2020-09-13;-28249
2020-09-12;"Bratislavský kraj";24;0;0;0;NA;22102;24;2020-09-12;-28260
2020-09-11;"Bratislavský kraj";50;0;0;0;NA;22102;50;2020-09-11;-28284
2020-09-10;"Bratislavský kraj";47;0;0;0;NA;22102;47;2020-09-10;-28334
2020-09-09;"Bratislavský kraj";40;0;0;0;NA;22102;40;2020-09-09;-28381
2020-09-08;"Bratislavský kraj";58;0;0;0;NA;22102;58;2020-09-08;-28421
2020-09-07;"Bratislavský kraj";39;0;0;0;NA;22102;39;2020-09-07;-28479
2020-09-06;"Bratislavský kraj";11;0;0;0;NA;22102;11;2020-09-06;-28518
2020-09-05;"Bratislavský kraj";37;0;0;0;NA;22102;37;2020-09-05;-28529
2020-09-04;"Bratislavský kraj";87;0;0;0;NA;22102;87;2020-09-04;-28566
2020-09-03;"Bratislavský kraj";51;0;0;0;NA;22102;51;2020-09-03;-28653
2021-02-01;"Košický kraj";415;17402;282;17684;NA;17584;697;2021-02-01;17584
2021-01-31;"Košický kraj";142;50827;556;51383;NA;17584;698;2021-01-31;16887
2021-01-30;"Košický kraj";320;70348;584;70932;NA;17584;904;2021-01-30;16189
2021-01-29;"Košický kraj";258;36082;407;36489;NA;17584;665;2021-01-29;15285
2021-01-28;"Košický kraj";540;8731;230;8961;NA;17584;770;2021-01-28;14620
2021-01-27;"Košický kraj";265;7219;195;7414;NA;17584;460;2021-01-27;13850
2021-01-26;"Košický kraj";530;13755;232;13987;NA;17584;762;2021-01-26;13390
2021-01-25;"Košický kraj";226;26546;394;26940;NA;17584;620;2021-01-25;12628
2021-01-24;"Košický kraj";150;36753;524;37277;NA;17584;674;2021-01-24;12008
2021-01-23;"Košický kraj";232;60945;641;61586;NA;17584;873;2021-01-23;11334
2021-01-22;"Košický kraj";316;19899;241;20140;NA;17584;557;2021-01-22;10461
2021-01-21;"Košický kraj";274;12796;152;12948;NA;17584;426;2021-01-21;9904
2021-01-20;"Košický kraj";374;10566;194;10760;NA;17584;568;2021-01-20;9478
2021-01-19;"Košický kraj";248;9364;177;9541;NA;17584;425;2021-01-19;8910
2021-01-18;"Košický kraj";333;12413;730;13143;NA;17584;1063;2021-01-18;8485
2021-01-17;"Košický kraj";155;535;14;549;NA;17584;169;2021-01-17;7422
2021-01-16;"Košický kraj";153;1551;51;1602;NA;17584;204;2021-01-16;7253
2021-01-15;"Košický kraj";308;6252;212;6464;NA;17584;520;2021-01-15;7049
2021-01-14;"Košický kraj";358;5270;211;5481;NA;17584;569;2021-01-14;6529
2021-01-13;"Košický kraj";421;4753;218;4971;NA;17584;639;2021-01-13;5960
2021-01-12;"Košický kraj";482;6574;247;6821;NA;17584;729;2021-01-12;5321
2021-01-11;"Košický kraj";309;7399;408;7807;NA;17584;717;2021-01-11;4592
2021-01-10;"Košický kraj";193;134;6;140;NA;17584;199;2021-01-10;3875
2021-01-09;"Košický kraj";469;1428;66;1494;NA;17584;535;2021-01-09;3676
2021-01-08;"Košický kraj";551;7861;375;8236;NA;17584;926;2021-01-08;3141
2021-01-07;"Košický kraj";251;5948;388;6336;NA;17584;639;2021-01-07;2215
2021-01-06;"Košický kraj";442;669;49;718;NA;17584;491;2021-01-06;1576
2021-01-05;"Košický kraj";584;7662;528;8190;NA;17584;1112;2021-01-05;1085
2021-01-04;"Košický kraj";407;6525;665;7190;NA;17584;1072;2021-01-04;-27
2021-01-03;"Košický kraj";118;882;31;913;NA;17584;149;2021-01-03;-1099
2021-01-02;"Košický kraj";88;436;43;479;NA;17584;131;2021-01-02;-1248
2021-01-01;"Košický kraj";398;980;66;1046;NA;17584;464;2021-01-01;-1379
2020-12-31;"Košický kraj";625;7411;443;7854;NA;17584;1068;2020-12-31;-1843
2020-12-30;"Košický kraj";590;6351;402;6753;NA;17584;992;2020-12-30;-2911
2020-12-29;"Košický kraj";419;7573;605;8178;NA;17584;1024;2020-12-29;-3903
2020-12-28;"Košický kraj";356;8296;804;9100;NA;17584;1160;2020-12-28;-4927
2020-12-27;"Košický kraj";159;147;16;163;NA;17584;175;2020-12-27;-6087
2020-12-26;"Košický kraj";163;274;23;297;NA;17584;186;2020-12-26;-6262
2020-12-25;"Košický kraj";237;140;10;150;NA;17584;247;2020-12-25;-6448
2020-12-24;"Košický kraj";564;1470;90;1560;NA;17584;654;2020-12-24;-6695
2020-12-23;"Košický kraj";304;7942;354;8296;NA;17584;658;2020-12-23;-7349
2020-12-22;"Košický kraj";438;7920;459;8379;NA;17584;897;2020-12-22;-8007
2020-12-21;"Košický kraj";405;6984;509;7493;NA;17584;914;2020-12-21;-8904
2020-12-20;"Košický kraj";215;48;8;56;NA;17584;223;2020-12-20;-9818
2020-12-19;"Košický kraj";207;1148;59;1207;NA;17584;266;2020-12-19;-10041
2020-12-18;"Košický kraj";310;8484;326;8810;NA;17584;636;2020-12-18;-10307
2020-12-17;"Košický kraj";463;5292;255;5547;NA;17584;718;2020-12-17;-10943
2020-12-16;"Košický kraj";455;5632;582;6214;NA;17584;1037;2020-12-16;-11661
2020-12-15;"Košický kraj";319;5086;338;5424;NA;17584;657;2020-12-15;-12698
2020-12-14;"Košický kraj";256;2893;239;3132;NA;17584;495;2020-12-14;-13355
2020-12-13;"Košický kraj";47;181;2;183;NA;17584;49;2020-12-13;-13850
2020-12-12;"Košický kraj";369;1587;118;1705;NA;17584;487;2020-12-12;-13899
2020-12-11;"Košický kraj";355;5461;258;5719;NA;17584;613;2020-12-11;-14386
2020-12-10;"Košický kraj";283;4064;176;4240;NA;17584;459;2020-12-10;-14999
2020-12-09;"Košický kraj";279;3786;166;3952;NA;17584;445;2020-12-09;-15458
2020-12-08;"Košický kraj";226;4105;355;4460;NA;17584;581;2020-12-08;-15903
2020-12-07;"Košický kraj";270;2111;103;2214;NA;17584;373;2020-12-07;-16484
2020-12-06;"Košický kraj";121;97;20;117;NA;17584;141;2020-12-06;-16857
2020-12-05;"Košický kraj";90;1096;48;1144;NA;17584;138;2020-12-05;-16998
2020-12-04;"Košický kraj";224;2680;82;2762;NA;17584;306;2020-12-04;-17136
2020-12-03;"Košický kraj";211;7717;173;7890;NA;17584;384;2020-12-03;-17442
2020-12-02;"Košický kraj";194;3654;124;3778;NA;17584;318;2020-12-02;-17826
2020-12-01;"Košický kraj";178;2237;124;2361;NA;17584;302;2020-12-01;-18144
2020-11-30;"Košický kraj";171;3754;62;3816;NA;17584;233;2020-11-30;-18446
2020-11-29;"Košický kraj";31;287;16;303;NA;17584;47;2020-11-29;-18679
2020-11-28;"Košický kraj";69;721;52;773;NA;17584;121;2020-11-28;-18726
2020-11-27;"Košický kraj";149;2729;74;2803;NA;17584;223;2020-11-27;-18847
2020-11-26;"Košický kraj";239;1090;55;1145;NA;17584;294;2020-11-26;-19070
2020-11-25;"Košický kraj";237;1664;122;1786;NA;17584;359;2020-11-25;-19364
2020-11-24;"Košický kraj";196;1871;64;1935;NA;17584;260;2020-11-24;-19723
2020-11-23;"Košický kraj";51;3737;54;3791;NA;17584;105;2020-11-23;-19983
2020-11-22;"Košický kraj";57;28;3;31;NA;17584;60;2020-11-22;-20088
2020-11-21;"Košický kraj";87;858;36;894;NA;17584;123;2020-11-21;-20148
2020-11-20;"Košický kraj";176;2989;45;3034;NA;17584;221;2020-11-20;-20271
2020-11-19;"Košický kraj";206;1648;40;1688;NA;17584;246;2020-11-19;-20492
2020-11-18;"Košický kraj";122;443;16;459;NA;17584;138;2020-11-18;-20738
2020-11-17;"Košický kraj";152;82;9;91;NA;17584;161;2020-11-17;-20876
2020-11-16;"Košický kraj";114;531;24;555;NA;17584;138;2020-11-16;-21037
2020-11-15;"Košický kraj";15;338;7;345;NA;17584;22;2020-11-15;-21175
2020-11-14;"Košický kraj";234;520;12;532;NA;17584;246;2020-11-14;-21197
2020-11-13;"Košický kraj";207;664;29;693;NA;17584;236;2020-11-13;-21443
2020-11-12;"Košický kraj";192;736;13;749;NA;17584;205;2020-11-12;-21679
2020-11-11;"Košický kraj";301;593;7;600;NA;17584;308;2020-11-11;-21884
2020-11-10;"Košický kraj";190;541;11;552;NA;17584;201;2020-11-10;-22192
2020-11-09;"Košický kraj";129;380;5;385;NA;17584;134;2020-11-09;-22393
2020-11-08;"Košický kraj";78;1298;8;1306;NA;17584;86;2020-11-08;-22527
2020-11-07;"Košický kraj";192;3909;22;3931;NA;17584;214;2020-11-07;-22613
2020-11-06;"Košický kraj";195;5310;34;5344;NA;17584;229;2020-11-06;-22827
2020-11-05;"Košický kraj";342;330;31;361;NA;17584;373;2020-11-05;-23056
2020-11-04;"Košický kraj";101;154;6;160;NA;17584;107;2020-11-04;-23429
2020-11-03;"Košický kraj";358;1122;13;1135;NA;17584;371;2020-11-03;-23536
2020-11-02;"Košický kraj";111;4368;51;4419;NA;17584;162;2020-11-02;-23907
2020-11-01;"Košický kraj";346;6522;34;6556;NA;17584;380;2020-11-01;-24069
2020-10-31;"Košický kraj";82;13810;105;13915;NA;17584;187;2020-10-31;-24449
2020-10-30;"Košický kraj";379;2835;27;2862;NA;17584;406;2020-10-30;-24636
2020-10-29;"Košický kraj";333;983;13;996;NA;17584;346;2020-10-29;-25042
2020-10-28;"Košický kraj";224;305;13;318;NA;17584;237;2020-10-28;-25388
2020-10-27;"Košický kraj";386;439;21;460;NA;17584;407;2020-10-27;-25625
2020-10-26;"Košický kraj";56;206;10;216;NA;17584;66;2020-10-26;-26032
2020-10-25;"Košický kraj";154;79;2;81;NA;17584;156;2020-10-25;-26098
2020-10-24;"Košický kraj";313;113;15;128;NA;17584;328;2020-10-24;-26254
2020-10-23;"Košický kraj";315;331;8;339;NA;17584;323;2020-10-23;-26582
2020-10-22;"Košický kraj";349;530;16;546;NA;17584;365;2020-10-22;-26905
2020-10-21;"Košický kraj";129;84;2;86;NA;17584;131;2020-10-21;-27270
2020-10-20;"Košický kraj";181;14;1;15;NA;17584;182;2020-10-20;-27401
2020-10-19;"Košický kraj";64;10;0;10;NA;17584;64;2020-10-19;-27583
2020-10-18;"Košický kraj";158;0;0;0;NA;17584;158;2020-10-18;-27647
2020-10-17;"Košický kraj";142;0;0;0;NA;17584;142;2020-10-17;-27805
2020-10-16;"Košický kraj";206;19;0;19;NA;17584;206;2020-10-16;-27947
2020-10-15;"Košický kraj";177;19;5;24;NA;17584;182;2020-10-15;-28153
2020-10-14;"Košický kraj";211;8;0;8;NA;17584;211;2020-10-14;-28335
2020-10-13;"Košický kraj";179;80;3;83;NA;17584;182;2020-10-13;-28546
2020-10-12;"Košický kraj";74;0;0;0;NA;17584;74;2020-10-12;-28728
2020-10-11;"Košický kraj";121;0;0;0;NA;17584;121;2020-10-11;-28802
2020-10-10;"Košický kraj";70;0;0;0;NA;17584;70;2020-10-10;-28923
2020-10-09;"Košický kraj";188;0;0;0;NA;17584;188;2020-10-09;-28993
2020-10-08;"Košický kraj";102;0;0;0;NA;17584;102;2020-10-08;-29181
2020-10-07;"Košický kraj";158;0;0;0;NA;17584;158;2020-10-07;-29283
2020-10-06;"Košický kraj";70;0;0;0;NA;17584;70;2020-10-06;-29441
2020-10-05;"Košický kraj";39;0;0;0;NA;17584;39;2020-10-05;-29511
2020-10-04;"Košický kraj";45;0;0;0;NA;17584;45;2020-10-04;-29550
2020-10-03;"Košický kraj";105;0;0;0;NA;17584;105;2020-10-03;-29595
2020-10-02;"Košický kraj";57;0;0;0;NA;17584;57;2020-10-02;-29700
2020-10-01;"Košický kraj";69;0;0;0;NA;17584;69;2020-10-01;-29757
2020-09-30;"Košický kraj";95;0;0;0;NA;17584;95;2020-09-30;-29826
2020-09-29;"Košický kraj";75;0;0;0;NA;17584;75;2020-09-29;-29921
2020-09-28;"Košický kraj";19;0;0;0;NA;17584;19;2020-09-28;-29996
2020-09-27;"Košický kraj";21;0;0;0;NA;17584;21;2020-09-27;-30015
2020-09-26;"Košický kraj";53;0;0;0;NA;17584;53;2020-09-26;-30036
2020-09-25;"Košický kraj";72;0;0;0;NA;17584;72;2020-09-25;-30089
2020-09-24;"Košický kraj";35;0;0;0;NA;17584;35;2020-09-24;-30161
2020-09-23;"Košický kraj";23;0;0;0;NA;17584;23;2020-09-23;-30196
2020-09-22;"Košický kraj";39;0;0;0;NA;17584;39;2020-09-22;-30219
2020-09-21;"Košický kraj";5;0;0;0;NA;17584;5;2020-09-21;-30258
2020-09-20;"Košický kraj";3;0;0;0;NA;17584;3;2020-09-20;-30263
2020-09-19;"Košický kraj";13;0;0;0;NA;17584;13;2020-09-19;-30266
2020-09-18;"Košický kraj";20;0;0;0;NA;17584;20;2020-09-18;-30279
2020-09-17;"Košický kraj";22;0;0;0;NA;17584;22;2020-09-17;-30299
2020-09-16;"Košický kraj";12;0;0;0;NA;17584;12;2020-09-16;-30321
2020-09-15;"Košický kraj";10;0;0;0;NA;17584;10;2020-09-15;-30333
2020-09-14;"Košický kraj";6;0;0;0;NA;17584;6;2020-09-14;-30343
2020-09-13;"Košický kraj";3;0;0;0;NA;17584;3;2020-09-13;-30349
2020-09-12;"Košický kraj";16;0;0;0;NA;17584;16;2020-09-12;-30352
2020-09-11;"Košický kraj";20;0;0;0;NA;17584;20;2020-09-11;-30368
2020-09-10;"Košický kraj";11;0;0;0;NA;17584;11;2020-09-10;-30388
2020-09-09;"Košický kraj";37;0;0;0;NA;17584;37;2020-09-09;-30399
2020-09-08;"Košický kraj";10;0;0;0;NA;17584;10;2020-09-08;-30436
2020-09-07;"Košický kraj";4;0;0;0;NA;17584;4;2020-09-07;-30446
2020-09-06;"Košický kraj";2;0;0;0;NA;17584;2;2020-09-06;-30450
2020-09-05;"Košický kraj";10;0;0;0;NA;17584;10;2020-09-05;-30452
2020-09-04;"Košický kraj";14;0;0;0;NA;17584;14;2020-09-04;-30462
2020-09-03;"Košický kraj";22;0;0;0;NA;17584;22;2020-09-03;-30476
2021-02-01;"Nitriansky kraj";221;22931;575;23506;NA;33552;796;2021-02-01;33552
2021-01-31;"Nitriansky kraj";9;18499;196;18695;NA;33552;205;2021-01-31;32756
2021-01-30;"Nitriansky kraj";152;70871;677;71548;NA;33552;829;2021-01-30;32551
2021-01-29;"Nitriansky kraj";135;22748;465;23213;NA;33552;600;2021-01-29;31722
2021-01-28;"Nitriansky kraj";269;10753;360;11113;NA;33552;629;2021-01-28;31122
2021-01-27;"Nitriansky kraj";235;6575;293;6868;NA;33552;528;2021-01-27;30493
2021-01-26;"Nitriansky kraj";345;14709;416;15125;NA;33552;761;2021-01-26;29965
2021-01-25;"Nitriansky kraj";201;20082;408;20490;NA;33552;609;2021-01-25;29204
2021-01-24;"Nitriansky kraj";12;61825;587;62412;NA;33552;599;2021-01-24;28595
2021-01-23;"Nitriansky kraj";277;80538;1196;81734;NA;33552;1473;2021-01-23;27996
2021-01-22;"Nitriansky kraj";139;32485;567;33052;NA;33552;706;2021-01-22;26523
2021-01-21;"Nitriansky kraj";305;14680;425;15105;NA;33552;730;2021-01-21;25817
2021-01-20;"Nitriansky kraj";326;11004;590;11594;NA;33552;916;2021-01-20;25087
2021-01-19;"Nitriansky kraj";344;10778;623;11401;NA;33552;967;2021-01-19;24171
2021-01-18;"Nitriansky kraj";367;8479;494;8973;NA;33552;861;2021-01-18;23204
2021-01-17;"Nitriansky kraj";97;15061;275;15336;NA;33552;372;2021-01-17;22343
2021-01-16;"Nitriansky kraj";64;35485;645;36130;NA;33552;709;2021-01-16;21971
2021-01-15;"Nitriansky kraj";373;15947;479;16426;NA;33552;852;2021-01-15;21262
2021-01-14;"Nitriansky kraj";627;10268;440;10708;NA;33552;1067;2021-01-14;20410
2021-01-13;"Nitriansky kraj";663;9167;497;9664;NA;33552;1160;2021-01-13;19343
2021-01-12;"Nitriansky kraj";642;9204;593;9797;NA;33552;1235;2021-01-12;18183
2021-01-11;"Nitriansky kraj";422;8175;515;8690;NA;33552;937;2021-01-11;16948
2021-01-10;"Nitriansky kraj";44;18767;703;19470;NA;33552;747;2021-01-10;16011
2021-01-09;"Nitriansky kraj";532;37075;1090;38165;NA;33552;1622;2021-01-09;15264
2021-01-08;"Nitriansky kraj";817;13685;691;14376;NA;33552;1508;2021-01-08;13642
2021-01-07;"Nitriansky kraj";438;11743;769;12512;NA;33552;1207;2021-01-07;12134
2021-01-06;"Nitriansky kraj";259;2822;457;3279;NA;33552;716;2021-01-06;10927
2021-01-05;"Nitriansky kraj";732;8815;1204;10019;NA;33552;1936;2021-01-05;10211
2021-01-04;"Nitriansky kraj";362;8852;1333;10185;NA;33552;1695;2021-01-04;8275
2021-01-03;"Nitriansky kraj";42;84;20;104;NA;33552;62;2021-01-03;6580
2021-01-02;"Nitriansky kraj";249;1587;34;1621;NA;33552;283;2021-01-02;6518
2021-01-01;"Nitriansky kraj";119;671;94;765;NA;33552;213;2021-01-01;6235
2020-12-31;"Nitriansky kraj";786;6079;693;6772;NA;33552;1479;2020-12-31;6022
2020-12-30;"Nitriansky kraj";1094;8641;1098;9739;NA;33552;2192;2020-12-30;4543
2020-12-29;"Nitriansky kraj";607;7870;1245;9115;NA;33552;1852;2020-12-29;2351
2020-12-28;"Nitriansky kraj";83;6881;1271;8152;NA;33552;1354;2020-12-28;499
2020-12-27;"Nitriansky kraj";22;36;2;38;NA;33552;24;2020-12-27;-855
2020-12-26;"Nitriansky kraj";54;297;56;353;NA;33552;110;2020-12-26;-879
2020-12-25;"Nitriansky kraj";35;47;5;52;NA;33552;40;2020-12-25;-989
2020-12-24;"Nitriansky kraj";514;1861;176;2037;NA;33552;690;2020-12-24;-1029
2020-12-23;"Nitriansky kraj";349;15214;843;16057;NA;33552;1192;2020-12-23;-1719
2020-12-22;"Nitriansky kraj";673;10915;994;11909;NA;33552;1667;2020-12-22;-2911
2020-12-21;"Nitriansky kraj";128;7719;976;8695;NA;33552;1104;2020-12-21;-4578
2020-12-20;"Nitriansky kraj";77;50;10;60;NA;33552;87;2020-12-20;-5682
2020-12-19;"Nitriansky kraj";262;2449;169;2618;NA;33552;431;2020-12-19;-5769
2020-12-18;"Nitriansky kraj";512;8130;541;8671;NA;33552;1053;2020-12-18;-6200
2020-12-17;"Nitriansky kraj";586;6705;514;7219;NA;33552;1100;2020-12-17;-7253
2020-12-16;"Nitriansky kraj";357;8265;513;8778;NA;33552;870;2020-12-16;-8353
2020-12-15;"Nitriansky kraj";461;9365;769;10134;NA;33552;1230;2020-12-15;-9223
2020-12-14;"Nitriansky kraj";217;8089;827;8916;NA;33552;1044;2020-12-14;-10453
2020-12-13;"Nitriansky kraj";12;9;1;10;NA;33552;13;2020-12-13;-11497
2020-12-12;"Nitriansky kraj";341;1832;125;1957;NA;33552;466;2020-12-12;-11510
2020-12-11;"Nitriansky kraj";409;5976;454;6430;NA;33552;863;2020-12-11;-11976
2020-12-10;"Nitriansky kraj";360;5030;326;5356;NA;33552;686;2020-12-10;-12839
2020-12-09;"Nitriansky kraj";362;5726;542;6268;NA;33552;904;2020-12-09;-13525
2020-12-08;"Nitriansky kraj";340;8766;611;9377;NA;33552;951;2020-12-08;-14429
2020-12-07;"Nitriansky kraj";139;6243;573;6816;NA;33552;712;2020-12-07;-15380
2020-12-06;"Nitriansky kraj";15;89;4;93;NA;33552;19;2020-12-06;-16092
2020-12-05;"Nitriansky kraj";136;618;14;632;NA;33552;150;2020-12-05;-16111
2020-12-04;"Nitriansky kraj";232;3047;86;3133;NA;33552;318;2020-12-04;-16261
2020-12-03;"Nitriansky kraj";248;2599;127;2726;NA;33552;375;2020-12-03;-16579
2020-12-02;"Nitriansky kraj";252;3733;163;3896;NA;33552;415;2020-12-02;-16954
2020-12-01;"Nitriansky kraj";331;2940;134;3074;NA;33552;465;2020-12-01;-17369
2020-11-30;"Nitriansky kraj";91;4232;143;4375;NA;33552;234;2020-11-30;-17834
2020-11-29;"Nitriansky kraj";3;620;42;662;NA;33552;45;2020-11-29;-18068
2020-11-28;"Nitriansky kraj";135;892;31;923;NA;33552;166;2020-11-28;-18113
2020-11-27;"Nitriansky kraj";177;1229;43;1272;NA;33552;220;2020-11-27;-18279
2020-11-26;"Nitriansky kraj";191;2262;57;2319;NA;33552;248;2020-11-26;-18499
2020-11-25;"Nitriansky kraj";325;1993;66;2059;NA;33552;391;2020-11-25;-18747
2020-11-24;"Nitriansky kraj";147;1141;50;1191;NA;33552;197;2020-11-24;-19138
2020-11-23;"Nitriansky kraj";102;9562;206;9768;NA;33552;308;2020-11-23;-19335
2020-11-22;"Nitriansky kraj";7;0;0;0;NA;33552;7;2020-11-22;-19643
2020-11-21;"Nitriansky kraj";86;1083;38;1121;NA;33552;124;2020-11-21;-19650
2020-11-20;"Nitriansky kraj";264;4020;101;4121;NA;33552;365;2020-11-20;-19774
2020-11-19;"Nitriansky kraj";185;2953;133;3086;NA;33552;318;2020-11-19;-20139
2020-11-18;"Nitriansky kraj";188;2109;77;2186;NA;33552;265;2020-11-18;-20457
2020-11-17;"Nitriansky kraj";178;596;29;625;NA;33552;207;2020-11-17;-20722
2020-11-16;"Nitriansky kraj";139;1836;75;1911;NA;33552;214;2020-11-16;-20929
2020-11-15;"Nitriansky kraj";14;10;1;11;NA;33552;15;2020-11-15;-21143
2020-11-14;"Nitriansky kraj";114;1131;32;1163;NA;33552;146;2020-11-14;-21158
2020-11-13;"Nitriansky kraj";210;936;46;982;NA;33552;256;2020-11-13;-21304
2020-11-12;"Nitriansky kraj";256;1195;35;1230;NA;33552;291;2020-11-12;-21560
2020-11-11;"Nitriansky kraj";279;1247;22;1269;NA;33552;301;2020-11-11;-21851
2020-11-10;"Nitriansky kraj";192;2623;39;2662;NA;33552;231;2020-11-10;-22152
2020-11-09;"Nitriansky kraj";128;3136;43;3179;NA;33552;171;2020-11-09;-22383
2020-11-08;"Nitriansky kraj";43;1462;32;1494;NA;33552;75;2020-11-08;-22554
2020-11-07;"Nitriansky kraj";130;1046;4;1050;NA;33552;134;2020-11-07;-22629
2020-11-06;"Nitriansky kraj";210;2264;32;2296;NA;33552;242;2020-11-06;-22763
2020-11-05;"Nitriansky kraj";178;312;14;326;NA;33552;192;2020-11-05;-23005
2020-11-04;"Nitriansky kraj";211;297;16;313;NA;33552;227;2020-11-04;-23197
2020-11-03;"Nitriansky kraj";216;435;25;460;NA;33552;241;2020-11-03;-23424
2020-11-02;"Nitriansky kraj";171;4208;46;4254;NA;33552;217;2020-11-02;-23665
2020-11-01;"Nitriansky kraj";130;2546;27;2573;NA;33552;157;2020-11-01;-23882
2020-10-31;"Nitriansky kraj";261;10466;134;10600;NA;33552;395;2020-10-31;-24039
2020-10-30;"Nitriansky kraj";204;2380;21;2401;NA;33552;225;2020-10-30;-24434
2020-10-29;"Nitriansky kraj";293;841;39;880;NA;33552;332;2020-10-29;-24659
2020-10-28;"Nitriansky kraj";216;608;59;667;NA;33552;275;2020-10-28;-24991
2020-10-27;"Nitriansky kraj";296;550;47;597;NA;33552;343;2020-10-27;-25266
2020-10-26;"Nitriansky kraj";69;633;56;689;NA;33552;125;2020-10-26;-25609
2020-10-25;"Nitriansky kraj";50;40;6;46;NA;33552;56;2020-10-25;-25734
2020-10-24;"Nitriansky kraj";169;237;11;248;NA;33552;180;2020-10-24;-25790
2020-10-23;"Nitriansky kraj";282;762;41;803;NA;33552;323;2020-10-23;-25970
2020-10-22;"Nitriansky kraj";137;444;39;483;NA;33552;176;2020-10-22;-26293
2020-10-21;"Nitriansky kraj";146;208;3;211;NA;33552;149;2020-10-21;-26469
2020-10-20;"Nitriansky kraj";197;78;6;84;NA;33552;203;2020-10-20;-26618
2020-10-19;"Nitriansky kraj";148;79;1;80;NA;33552;149;2020-10-19;-26821
2020-10-18;"Nitriansky kraj";22;0;0;0;NA;33552;22;2020-10-18;-26970
2020-10-17;"Nitriansky kraj";67;0;0;0;NA;33552;67;2020-10-17;-26992
2020-10-16;"Nitriansky kraj";133;28;3;31;NA;33552;136;2020-10-16;-27059
2020-10-15;"Nitriansky kraj";106;31;2;33;NA;33552;108;2020-10-15;-27195
2020-10-14;"Nitriansky kraj";80;22;4;26;NA;33552;84;2020-10-14;-27303
2020-10-13;"Nitriansky kraj";101;82;2;84;NA;33552;103;2020-10-13;-27387
2020-10-12;"Nitriansky kraj";36;0;0;0;NA;33552;36;2020-10-12;-27490
2020-10-11;"Nitriansky kraj";8;0;0;0;NA;33552;8;2020-10-11;-27526
2020-10-10;"Nitriansky kraj";107;0;0;0;NA;33552;107;2020-10-10;-27534
2020-10-09;"Nitriansky kraj";120;0;0;0;NA;33552;120;2020-10-09;-27641
2020-10-08;"Nitriansky kraj";132;0;0;0;NA;33552;132;2020-10-08;-27761
2020-10-07;"Nitriansky kraj";81;0;0;0;NA;33552;81;2020-10-07;-27893
2020-10-06;"Nitriansky kraj";48;0;0;0;NA;33552;48;2020-10-06;-27974
2020-10-05;"Nitriansky kraj";20;0;0;0;NA;33552;20;2020-10-05;-28022
2020-10-04;"Nitriansky kraj";17;0;0;0;NA;33552;17;2020-10-04;-28042
2020-10-03;"Nitriansky kraj";96;0;0;0;NA;33552;96;2020-10-03;-28059
2020-10-02;"Nitriansky kraj";108;0;0;0;NA;33552;108;2020-10-02;-28155
2020-10-01;"Nitriansky kraj";95;0;0;0;NA;33552;95;2020-10-01;-28263
2020-09-30;"Nitriansky kraj";100;0;0;0;NA;33552;100;2020-09-30;-28358
2020-09-29;"Nitriansky kraj";50;0;0;0;NA;33552;50;2020-09-29;-28458
2020-09-28;"Nitriansky kraj";22;0;0;0;NA;33552;22;2020-09-28;-28508
2020-09-27;"Nitriansky kraj";16;0;0;0;NA;33552;16;2020-09-27;-28530
2020-09-26;"Nitriansky kraj";64;0;0;0;NA;33552;64;2020-09-26;-28546
2020-09-25;"Nitriansky kraj";90;0;0;0;NA;33552;90;2020-09-25;-28610
2020-09-24;"Nitriansky kraj";51;0;0;0;NA;33552;51;2020-09-24;-28700
2020-09-23;"Nitriansky kraj";70;0;0;0;NA;33552;70;2020-09-23;-28751
2020-09-22;"Nitriansky kraj";18;0;0;0;NA;33552;18;2020-09-22;-28821
2020-09-21;"Nitriansky kraj";10;0;0;0;NA;33552;10;2020-09-21;-28839
2020-09-20;"Nitriansky kraj";4;0;0;0;NA;33552;4;2020-09-20;-28849
2020-09-19;"Nitriansky kraj";14;0;0;0;NA;33552;14;2020-09-19;-28853
2020-09-18;"Nitriansky kraj";19;0;0;0;NA;33552;19;2020-09-18;-28867
2020-09-17;"Nitriansky kraj";30;0;0;0;NA;33552;30;2020-09-17;-28886
2020-09-16;"Nitriansky kraj";6;0;0;0;NA;33552;6;2020-09-16;-28916
2020-09-15;"Nitriansky kraj";19;0;0;0;NA;33552;19;2020-09-15;-28922
2020-09-14;"Nitriansky kraj";28;0;0;0;NA;33552;28;2020-09-14;-28941
2020-09-13;"Nitriansky kraj";3;0;0;0;NA;33552;3;2020-09-13;-28969
2020-09-12;"Nitriansky kraj";12;0;0;0;NA;33552;12;2020-09-12;-28972
2020-09-11;"Nitriansky kraj";23;0;0;0;NA;33552;23;2020-09-11;-28984
2020-09-10;"Nitriansky kraj";29;0;0;0;NA;33552;29;2020-09-10;-29007
2020-09-09;"Nitriansky kraj";19;0;0;0;NA;33552;19;2020-09-09;-29036
2020-09-08;"Nitriansky kraj";17;0;0;0;NA;33552;17;2020-09-08;-29055
2020-09-07;"Nitriansky kraj";17;0;0;0;NA;33552;17;2020-09-07;-29072
2020-09-05;"Nitriansky kraj";22;0;0;0;NA;33552;22;2020-09-05;-29089
2020-09-04;"Nitriansky kraj";34;0;0;0;NA;33552;34;2020-09-04;-29111
2020-09-03;"Nitriansky kraj";15;0;0;0;NA;33552;15;2020-09-03;-29145
2021-02-01;"Prešovský kraj";220;13857;262;14119;NA;26835;482;2021-02-01;26835
2021-01-31;"Prešovský kraj";42;1464;33;1497;NA;26835;75;2021-01-31;26353
2021-01-30;"Prešovský kraj";142;23865;213;24078;NA;26835;355;2021-01-30;26278
2021-01-29;"Prešovský kraj";88;15464;266;15730;NA;26835;354;2021-01-29;25923
2021-01-28;"Prešovský kraj";311;8165;137;8302;NA;26835;448;2021-01-28;25569
2021-01-27;"Prešovský kraj";153;9082;142;9224;NA;26835;295;2021-01-27;25121
2021-01-26;"Prešovský kraj";252;15916;141;16057;NA;26835;393;2021-01-26;24826
2021-01-25;"Prešovský kraj";196;27449;235;27684;NA;26835;431;2021-01-25;24433
2021-01-24;"Prešovský kraj";12;52498;385;52883;NA;26835;397;2021-01-24;24002
2021-01-23;"Prešovský kraj";189;86663;420;87083;NA;26835;609;2021-01-23;23605
2021-01-22;"Prešovský kraj";187;32850;246;33096;NA;26835;433;2021-01-22;22996
2021-01-21;"Prešovský kraj";187;18674;195;18869;NA;26835;382;2021-01-21;22563
2021-01-20;"Prešovský kraj";253;12732;165;12897;NA;26835;418;2021-01-20;22181
2021-01-19;"Prešovský kraj";281;10653;284;10937;NA;26835;565;2021-01-19;21763
2021-01-18;"Prešovský kraj";203;9456;309;9765;NA;26835;512;2021-01-18;21198
2021-01-17;"Prešovský kraj";107;14393;1008;15401;NA;26835;1115;2021-01-17;20686
2021-01-16;"Prešovský kraj";72;1583;76;1659;NA;26835;148;2021-01-16;19571
2021-01-15;"Prešovský kraj";159;6322;209;6531;NA;26835;368;2021-01-15;19423
2021-01-14;"Prešovský kraj";268;5250;238;5488;NA;26835;506;2021-01-14;19055
2021-01-13;"Prešovský kraj";342;5294;208;5502;NA;26835;550;2021-01-13;18549
2021-01-12;"Prešovský kraj";455;8098;370;8468;NA;26835;825;2021-01-12;17999
2021-01-11;"Prešovský kraj";343;7208;435;7643;NA;26835;778;2021-01-11;17174
2021-01-10;"Prešovský kraj";63;476;23;499;NA;26835;86;2021-01-10;16396
2021-01-09;"Prešovský kraj";439;2248;125;2373;NA;26835;564;2021-01-09;16310
2021-01-08;"Prešovský kraj";430;10059;517;10576;NA;26835;947;2021-01-08;15746
2021-01-07;"Prešovský kraj";268;7387;621;8008;NA;26835;889;2021-01-07;14799
2021-01-06;"Prešovský kraj";315;1259;101;1360;NA;26835;416;2021-01-06;13910
2021-01-05;"Prešovský kraj";655;11094;947;12041;NA;26835;1602;2021-01-05;13494
2021-01-04;"Prešovský kraj";371;16400;1688;18088;NA;26835;2059;2021-01-04;11892
2021-01-03;"Prešovský kraj";89;257;37;294;NA;26835;126;2021-01-03;9833
2021-01-02;"Prešovský kraj";65;1559;160;1719;NA;26835;225;2021-01-02;9707
2021-01-01;"Prešovský kraj";174;914;70;984;NA;26835;244;2021-01-01;9482
2020-12-31;"Prešovský kraj";640;11208;695;11903;NA;26835;1335;2020-12-31;9238
2020-12-30;"Prešovský kraj";729;8300;715;9015;NA;26835;1444;2020-12-30;7903
2020-12-29;"Prešovský kraj";435;8286;863;9149;NA;26835;1298;2020-12-29;6459
2020-12-28;"Prešovský kraj";393;8292;1020;9312;NA;26835;1413;2020-12-28;5161
2020-12-27;"Prešovský kraj";40;571;39;610;NA;26835;79;2020-12-27;3748
2020-12-26;"Prešovský kraj";64;176;12;188;NA;26835;76;2020-12-26;3669
2020-12-25;"Prešovský kraj";208;273;13;286;NA;26835;221;2020-12-25;3593
2020-12-24;"Prešovský kraj";452;1214;85;1299;NA;26835;537;2020-12-24;3372
2020-12-23;"Prešovský kraj";361;10229;781;11010;NA;26835;1142;2020-12-23;2835
2020-12-22;"Prešovský kraj";439;8805;666;9471;NA;26835;1105;2020-12-22;1693
2020-12-21;"Prešovský kraj";432;9396;820;10216;NA;26835;1252;2020-12-21;588
2020-12-20;"Prešovský kraj";184;396;20;416;NA;26835;204;2020-12-20;-664
2020-12-19;"Prešovský kraj";276;1658;151;1809;NA;26835;427;2020-12-19;-868
2020-12-18;"Prešovský kraj";396;8850;599;9449;NA;26835;995;2020-12-18;-1295
2020-12-17;"Prešovský kraj";427;10826;891;11717;NA;26835;1318;2020-12-17;-2290
2020-12-16;"Prešovský kraj";466;6017;508;6525;NA;26835;974;2020-12-16;-3608
2020-12-15;"Prešovský kraj";411;5685;584;6269;NA;26835;995;2020-12-15;-4582
2020-12-14;"Prešovský kraj";334;5767;508;6275;NA;26835;842;2020-12-14;-5577
2020-12-13;"Prešovský kraj";89;29;8;37;NA;26835;97;2020-12-13;-6419
2020-12-12;"Prešovský kraj";319;2474;166;2640;NA;26835;485;2020-12-12;-6516
2020-12-11;"Prešovský kraj";560;6042;418;6460;NA;26835;978;2020-12-11;-7001
2020-12-10;"Prešovský kraj";337;5180;440;5620;NA;26835;777;2020-12-10;-7979
2020-12-09;"Prešovský kraj";358;3646;270;3916;NA;26835;628;2020-12-09;-8756
2020-12-08;"Prešovský kraj";350;6436;647;7083;NA;26835;997;2020-12-08;-9384
2020-12-07;"Prešovský kraj";309;3644;337;3981;NA;26835;646;2020-12-07;-10381
2020-12-06;"Prešovský kraj";59;358;26;384;NA;26835;85;2020-12-06;-11027
2020-12-05;"Prešovský kraj";218;984;87;1071;NA;26835;305;2020-12-05;-11112
2020-12-04;"Prešovský kraj";352;4471;281;4752;NA;26835;633;2020-12-04;-11417
2020-12-03;"Prešovský kraj";284;2900;202;3102;NA;26835;486;2020-12-03;-12050
2020-12-02;"Prešovský kraj";232;3361;235;3596;NA;26835;467;2020-12-02;-12536
2020-12-01;"Prešovský kraj";281;2341;213;2554;NA;26835;494;2020-12-01;-13003
2020-11-30;"Prešovský kraj";196;5821;110;5931;NA;26835;306;2020-11-30;-13497
2020-11-29;"Prešovský kraj";27;379;42;421;NA;26835;69;2020-11-29;-13803
2020-11-28;"Prešovský kraj";199;682;62;744;NA;26835;261;2020-11-28;-13872
2020-11-27;"Prešovský kraj";232;2135;119;2254;NA;26835;351;2020-11-27;-14133
2020-11-26;"Prešovský kraj";263;2787;312;3099;NA;26835;575;2020-11-26;-14484
2020-11-25;"Prešovský kraj";302;1642;78;1720;NA;26835;380;2020-11-25;-15059
2020-11-24;"Prešovský kraj";365;1662;140;1802;NA;26835;505;2020-11-24;-15439
2020-11-23;"Prešovský kraj";164;842;42;884;NA;26835;206;2020-11-23;-15944
2020-11-22;"Prešovský kraj";46;30;1;31;NA;26835;47;2020-11-22;-16150
2020-11-21;"Prešovský kraj";205;689;57;746;NA;26835;262;2020-11-21;-16197
2020-11-20;"Prešovský kraj";363;2063;98;2161;NA;26835;461;2020-11-20;-16459
2020-11-19;"Prešovský kraj";359;1973;229;2202;NA;26835;588;2020-11-19;-16920
2020-11-18;"Prešovský kraj";270;373;32;405;NA;26835;302;2020-11-18;-17508
2020-11-17;"Prešovský kraj";347;151;17;168;NA;26835;364;2020-11-17;-17810
2020-11-16;"Prešovský kraj";226;382;51;433;NA;26835;277;2020-11-16;-18174
2020-11-15;"Prešovský kraj";186;39;4;43;NA;26835;190;2020-11-15;-18451
2020-11-14;"Prešovský kraj";261;54;4;58;NA;26835;265;2020-11-14;-18641
2020-11-13;"Prešovský kraj";395;166;8;174;NA;26835;403;2020-11-13;-18906
2020-11-12;"Prešovský kraj";397;229;50;279;NA;26835;447;2020-11-12;-19309
2020-11-11;"Prešovský kraj";516;161;15;176;NA;26835;531;2020-11-11;-19756
2020-11-10;"Prešovský kraj";437;197;9;206;NA;26835;446;2020-11-10;-20287
2020-11-09;"Prešovský kraj";190;4106;945;5051;NA;26835;1135;2020-11-09;-20733
2020-11-08;"Prešovský kraj";97;2817;32;2849;NA;26835;129;2020-11-08;-21868
2020-11-07;"Prešovský kraj";416;8578;81;8659;NA;26835;497;2020-11-07;-21997
2020-11-06;"Prešovský kraj";520;4791;76;4867;NA;26835;596;2020-11-06;-22494
2020-11-05;"Prešovský kraj";397;180;5;185;NA;26835;402;2020-11-05;-23090
2020-11-04;"Prešovský kraj";350;807;8;815;NA;26835;358;2020-11-04;-23492
2020-11-03;"Prešovský kraj";565;98;12;110;NA;26835;577;2020-11-03;-23850
2020-11-02;"Prešovský kraj";203;4158;1004;5162;NA;26835;1207;2020-11-02;-24427
2020-11-01;"Prešovský kraj";386;2906;53;2959;NA;26835;439;2020-11-01;-25634
2020-10-31;"Prešovský kraj";315;10497;170;10667;NA;26835;485;2020-10-31;-26073
2020-10-30;"Prešovský kraj";552;2949;65;3014;NA;26835;617;2020-10-30;-26558
2020-10-29;"Prešovský kraj";594;301;38;339;NA;26835;632;2020-10-29;-27175
2020-10-28;"Prešovský kraj";617;291;46;337;NA;26835;663;2020-10-28;-27807
2020-10-27;"Prešovský kraj";656;268;34;302;NA;26835;690;2020-10-27;-28470
2020-10-26;"Prešovský kraj";137;363;57;420;NA;26835;194;2020-10-26;-29160
2020-10-25;"Prešovský kraj";237;346;11;357;NA;26835;248;2020-10-25;-29354
2020-10-24;"Prešovský kraj";719;200;12;212;NA;26835;731;2020-10-24;-29602
2020-10-23;"Prešovský kraj";750;218;8;226;NA;26835;758;2020-10-23;-30333
2020-10-22;"Prešovský kraj";646;396;30;426;NA;26835;676;2020-10-22;-31091
2020-10-21;"Prešovský kraj";383;58;8;66;NA;26835;391;2020-10-21;-31767
2020-10-20;"Prešovský kraj";493;65;7;72;NA;26835;500;2020-10-20;-32158
2020-10-19;"Prešovský kraj";140;235;15;250;NA;26835;155;2020-10-19;-32658
2020-10-18;"Prešovský kraj";209;0;0;0;NA;26835;209;2020-10-18;-32813
2020-10-17;"Prešovský kraj";342;0;0;0;NA;26835;342;2020-10-17;-33022
2020-10-16;"Prešovský kraj";388;57;3;60;NA;26835;391;2020-10-16;-33364
2020-10-15;"Prešovský kraj";435;85;18;103;NA;26835;453;2020-10-15;-33755
2020-10-14;"Prešovský kraj";451;54;10;64;NA;26835;461;2020-10-14;-34208
2020-10-13;"Prešovský kraj";264;50;6;56;NA;26835;270;2020-10-13;-34669
2020-10-12;"Prešovský kraj";214;334;35;369;NA;26835;249;2020-10-12;-34939
2020-10-11;"Prešovský kraj";127;0;0;0;NA;26835;127;2020-10-11;-35188
2020-10-10;"Prešovský kraj";248;0;0;0;NA;26835;248;2020-10-10;-35315
2020-10-09;"Prešovský kraj";406;0;0;0;NA;26835;406;2020-10-09;-35563
2020-10-08;"Prešovský kraj";245;0;0;0;NA;26835;245;2020-10-08;-35969
2020-10-07;"Prešovský kraj";244;0;0;0;NA;26835;244;2020-10-07;-36214
2020-10-06;"Prešovský kraj";166;0;0;0;NA;26835;166;2020-10-06;-36458
2020-10-05;"Prešovský kraj";84;0;0;0;NA;26835;84;2020-10-05;-36624
2020-10-04;"Prešovský kraj";118;0;0;0;NA;26835;118;2020-10-04;-36708
2020-10-03;"Prešovský kraj";204;0;0;0;NA;26835;204;2020-10-03;-36826
2020-10-02;"Prešovský kraj";149;0;0;0;NA;26835;149;2020-10-02;-37030
2020-10-01;"Prešovský kraj";136;0;0;0;NA;26835;136;2020-10-01;-37179
2020-09-30;"Prešovský kraj";121;0;0;0;NA;26835;121;2020-09-30;-37315
2020-09-29;"Prešovský kraj";156;0;0;0;NA;26835;156;2020-09-29;-37436
2020-09-28;"Prešovský kraj";51;0;0;0;NA;26835;51;2020-09-28;-37592
2020-09-27;"Prešovský kraj";10;0;0;0;NA;26835;10;2020-09-27;-37643
2020-09-26;"Prešovský kraj";72;0;0;0;NA;26835;72;2020-09-26;-37653
2020-09-25;"Prešovský kraj";91;0;0;0;NA;26835;91;2020-09-25;-37725
2020-09-24;"Prešovský kraj";52;0;0;0;NA;26835;52;2020-09-24;-37816
2020-09-23;"Prešovský kraj";55;0;0;0;NA;26835;55;2020-09-23;-37868
2020-09-22;"Prešovský kraj";29;0;0;0;NA;26835;29;2020-09-22;-37923
2020-09-21;"Prešovský kraj";14;0;0;0;NA;26835;14;2020-09-21;-37952
2020-09-20;"Prešovský kraj";5;0;0;0;NA;26835;5;2020-09-20;-37966
2020-09-19;"Prešovský kraj";12;0;0;0;NA;26835;12;2020-09-19;-37971
2020-09-18;"Prešovský kraj";29;0;0;0;NA;26835;29;2020-09-18;-37983
2020-09-17;"Prešovský kraj";25;0;0;0;NA;26835;25;2020-09-17;-38012
2020-09-16;"Prešovský kraj";8;0;0;0;NA;26835;8;2020-09-16;-38037
2020-09-15;"Prešovský kraj";10;0;0;0;NA;26835;10;2020-09-15;-38045
2020-09-14;"Prešovský kraj";47;0;0;0;NA;26835;47;2020-09-14;-38055
2020-09-13;"Prešovský kraj";3;0;0;0;NA;26835;3;2020-09-13;-38102
2020-09-12;"Prešovský kraj";4;0;0;0;NA;26835;4;2020-09-12;-38105
2020-09-11;"Prešovský kraj";15;0;0;0;NA;26835;15;2020-09-11;-38109
2020-09-10;"Prešovský kraj";10;0;0;0;NA;26835;10;2020-09-10;-38124
2020-09-09;"Prešovský kraj";21;0;0;0;NA;26835;21;2020-09-09;-38134
2020-09-08;"Prešovský kraj";23;0;0;0;NA;26835;23;2020-09-08;-38155
2020-09-07;"Prešovský kraj";5;0;0;0;NA;26835;5;2020-09-07;-38178
2020-09-06;"Prešovský kraj";3;0;0;0;NA;26835;3;2020-09-06;-38183
2020-09-05;"Prešovský kraj";7;0;0;0;NA;26835;7;2020-09-05;-38186
2020-09-04;"Prešovský kraj";24;0;0;0;NA;26835;24;2020-09-04;-38193
2020-09-03;"Prešovský kraj";8;0;0;0;NA;26835;8;2020-09-03;-38217
2021-02-01;"Trenčiansky kraj";167;17133;273;17406;NA;23358;440;2021-02-01;23358
2021-01-31;"Trenčiansky kraj";7;15712;132;15844;NA;23358;139;2021-01-31;22918
2021-01-30;"Trenčiansky kraj";228;36876;352;37228;NA;23358;580;2021-01-30;22779
2021-01-29;"Trenčiansky kraj";72;7686;207;7893;NA;23358;279;2021-01-29;22199
2021-01-28;"Trenčiansky kraj";307;5525;167;5692;NA;23358;474;2021-01-28;21920
2021-01-27;"Trenčiansky kraj";166;11735;203;11938;NA;23358;369;2021-01-27;21446
2021-01-26;"Trenčiansky kraj";303;14287;237;14524;NA;23358;540;2021-01-26;21077
2021-01-25;"Trenčiansky kraj";160;34056;367;34423;NA;23358;527;2021-01-25;20537
2021-01-24;"Trenčiansky kraj";51;27365;181;27546;NA;23358;232;2021-01-24;20010
2021-01-23;"Trenčiansky kraj";206;110039;709;110748;NA;23358;915;2021-01-23;19778
2021-01-22;"Trenčiansky kraj";148;13938;174;14112;NA;23358;322;2021-01-22;18863
2021-01-21;"Trenčiansky kraj";143;8294;187;8481;NA;23358;330;2021-01-21;18541
2021-01-20;"Trenčiansky kraj";181;7678;236;7914;NA;23358;417;2021-01-20;18211
2021-01-19;"Trenčiansky kraj";363;6462;275;6737;NA;23358;638;2021-01-19;17794
2021-01-18;"Trenčiansky kraj";72;4484;257;4741;NA;23358;329;2021-01-18;17156
2021-01-17;"Trenčiansky kraj";124;49;10;59;NA;23358;134;2021-01-17;16827
2021-01-16;"Trenčiansky kraj";39;793;62;855;NA;23358;101;2021-01-16;16693
2021-01-15;"Trenčiansky kraj";264;3816;218;4034;NA;23358;482;2021-01-15;16592
2021-01-14;"Trenčiansky kraj";275;2984;153;3137;NA;23358;428;2021-01-14;16110
2021-01-13;"Trenčiansky kraj";222;4052;236;4288;NA;23358;458;2021-01-13;15682
2021-01-12;"Trenčiansky kraj";508;4802;293;5095;NA;23358;801;2021-01-12;15224
2021-01-11;"Trenčiansky kraj";142;3878;294;4172;NA;23358;436;2021-01-11;14423
2021-01-10;"Trenčiansky kraj";89;4939;76;5015;NA;23358;165;2021-01-10;13987
2021-01-09;"Trenčiansky kraj";276;7973;121;8094;NA;23358;397;2021-01-09;13822
2021-01-08;"Trenčiansky kraj";489;6403;467;6870;NA;23358;956;2021-01-08;13425
2021-01-07;"Trenčiansky kraj";420;5711;503;6214;NA;23358;923;2021-01-07;12469
2021-01-06;"Trenčiansky kraj";221;1021;64;1085;NA;23358;285;2021-01-06;11546
2021-01-05;"Trenčiansky kraj";669;6202;867;7069;NA;23358;1536;2021-01-05;11261
2021-01-04;"Trenčiansky kraj";337;4480;637;5117;NA;23358;974;2021-01-04;9725
2021-01-03;"Trenčiansky kraj";38;60;13;73;NA;23358;51;2021-01-03;8751
2021-01-02;"Trenčiansky kraj";129;140;23;163;NA;23358;152;2021-01-02;8700
2021-01-01;"Trenčiansky kraj";329;347;23;370;NA;23358;352;2021-01-01;8548
2020-12-31;"Trenčiansky kraj";597;4943;557;5500;NA;23358;1154;2020-12-31;8196
2020-12-30;"Trenčiansky kraj";836;6782;762;7544;NA;23358;1598;2020-12-30;7042
2020-12-29;"Trenčiansky kraj";459;5979;1018;6997;NA;23358;1477;2020-12-29;5444
2020-12-28;"Trenčiansky kraj";258;3923;777;4700;NA;23358;1035;2020-12-28;3967
2020-12-27;"Trenčiansky kraj";5;202;36;238;NA;23358;41;2020-12-27;2932
2020-12-26;"Trenčiansky kraj";174;74;10;84;NA;23358;184;2020-12-26;2891
2020-12-25;"Trenčiansky kraj";251;325;47;372;NA;23358;298;2020-12-25;2707
2020-12-24;"Trenčiansky kraj";552;2194;256;2450;NA;23358;808;2020-12-24;2409
2020-12-23;"Trenčiansky kraj";421;6305;630;6935;NA;23358;1051;2020-12-23;1601
2020-12-22;"Trenčiansky kraj";673;5610;694;6304;NA;23358;1367;2020-12-22;550
2020-12-21;"Trenčiansky kraj";248;13562;998;14560;NA;23358;1246;2020-12-21;-817
2020-12-20;"Trenčiansky kraj";238;12480;291;12771;NA;23358;529;2020-12-20;-2063
2020-12-19;"Trenčiansky kraj";341;1611;150;1761;NA;23358;491;2020-12-19;-2592
2020-12-18;"Trenčiansky kraj";521;4670;543;5213;NA;23358;1064;2020-12-18;-3083
2020-12-17;"Trenčiansky kraj";670;3690;503;4193;NA;23358;1173;2020-12-17;-4147
2020-12-16;"Trenčiansky kraj";461;4325;622;4947;NA;23358;1083;2020-12-16;-5320
2020-12-15;"Trenčiansky kraj";595;3342;629;3971;NA;23358;1224;2020-12-15;-6403
2020-12-14;"Trenčiansky kraj";318;2627;598;3225;NA;23358;916;2020-12-14;-7627
2020-12-13;"Trenčiansky kraj";77;24;4;28;NA;23358;81;2020-12-13;-8543
2020-12-12;"Trenčiansky kraj";314;985;118;1103;NA;23358;432;2020-12-12;-8624
2020-12-11;"Trenčiansky kraj";750;3643;456;4099;NA;23358;1206;2020-12-11;-9056
2020-12-10;"Trenčiansky kraj";271;3371;477;3848;NA;23358;748;2020-12-10;-10262
2020-12-09;"Trenčiansky kraj";508;3805;470;4275;NA;23358;978;2020-12-09;-11010
2020-12-08;"Trenčiansky kraj";546;3440;522;3962;NA;23358;1068;2020-12-08;-11988
2020-12-07;"Trenčiansky kraj";258;3820;466;4286;NA;23358;724;2020-12-07;-13056
2020-12-06;"Trenčiansky kraj";114;179;10;189;NA;23358;124;2020-12-06;-13780
2020-12-05;"Trenčiansky kraj";223;757;64;821;NA;23358;287;2020-12-05;-13904
2020-12-04;"Trenčiansky kraj";253;2519;215;2734;NA;23358;468;2020-12-04;-14191
2020-12-03;"Trenčiansky kraj";503;1714;178;1892;NA;23358;681;2020-12-03;-14659
2020-12-02;"Trenčiansky kraj";418;1844;232;2076;NA;23358;650;2020-12-02;-15340
2020-12-01;"Trenčiansky kraj";321;5642;351;5993;NA;23358;672;2020-12-01;-15990
2020-11-30;"Trenčiansky kraj";167;8494;489;8983;NA;23358;656;2020-11-30;-16662
2020-11-29;"Trenčiansky kraj";29;18;2;20;NA;23358;31;2020-11-29;-17318
2020-11-28;"Trenčiansky kraj";202;1051;93;1144;NA;23358;295;2020-11-28;-17349
2020-11-27;"Trenčiansky kraj";330;1398;150;1548;NA;23358;480;2020-11-27;-17644
2020-11-26;"Trenčiansky kraj";395;1252;122;1374;NA;23358;517;2020-11-26;-18124
2020-11-25;"Trenčiansky kraj";322;1444;160;1604;NA;23358;482;2020-11-25;-18641
2020-11-24;"Trenčiansky kraj";348;2553;308;2861;NA;23358;656;2020-11-24;-19123
2020-11-23;"Trenčiansky kraj";159;1186;122;1308;NA;23358;281;2020-11-23;-19779
2020-11-22;"Trenčiansky kraj";26;11;1;12;NA;23358;27;2020-11-22;-20060
2020-11-21;"Trenčiansky kraj";255;1323;62;1385;NA;23358;317;2020-11-21;-20087
2020-11-20;"Trenčiansky kraj";316;861;93;954;NA;23358;409;2020-11-20;-20404
2020-11-19;"Trenčiansky kraj";316;740;113;853;NA;23358;429;2020-11-19;-20813
2020-11-18;"Trenčiansky kraj";233;379;66;445;NA;23358;299;2020-11-18;-21242
2020-11-17;"Trenčiansky kraj";222;106;15;121;NA;23358;237;2020-11-17;-21541
2020-11-16;"Trenčiansky kraj";245;236;45;281;NA;23358;290;2020-11-16;-21778
2020-11-15;"Trenčiansky kraj";109;29;6;35;NA;23358;115;2020-11-15;-22068
2020-11-14;"Trenčiansky kraj";190;74;11;85;NA;23358;201;2020-11-14;-22183
2020-11-13;"Trenčiansky kraj";308;131;13;144;NA;23358;321;2020-11-13;-22384
2020-11-12;"Trenčiansky kraj";324;124;5;129;NA;23358;329;2020-11-12;-22705
2020-11-11;"Trenčiansky kraj";366;113;10;123;NA;23358;376;2020-11-11;-23034
2020-11-10;"Trenčiansky kraj";277;106;6;112;NA;23358;283;2020-11-10;-23410
2020-11-09;"Trenčiansky kraj";115;1407;48;1455;NA;23358;163;2020-11-09;-23693
2020-11-08;"Trenčiansky kraj";81;1223;8;1231;NA;23358;89;2020-11-08;-23856
2020-11-07;"Trenčiansky kraj";319;3662;59;3721;NA;23358;378;2020-11-07;-23945
2020-11-06;"Trenčiansky kraj";383;6893;84;6977;NA;23358;467;2020-11-06;-24323
2020-11-05;"Trenčiansky kraj";399;98;15;113;NA;23358;414;2020-11-05;-24790
2020-11-04;"Trenčiansky kraj";370;91;9;100;NA;23358;379;2020-11-04;-25204
2020-11-03;"Trenčiansky kraj";575;97;8;105;NA;23358;583;2020-11-03;-25583
2020-11-02;"Trenčiansky kraj";197;1833;68;1901;NA;23358;265;2020-11-02;-26166
2020-11-01;"Trenčiansky kraj";257;804;23;827;NA;23358;280;2020-11-01;-26431
2020-10-31;"Trenčiansky kraj";332;4719;82;4801;NA;23358;414;2020-10-31;-26711
2020-10-30;"Trenčiansky kraj";299;5283;102;5385;NA;23358;401;2020-10-30;-27125
2020-10-29;"Trenčiansky kraj";496;764;68;832;NA;23358;564;2020-10-29;-27526
2020-10-28;"Trenčiansky kraj";269;192;33;225;NA;23358;302;2020-10-28;-28090
2020-10-27;"Trenčiansky kraj";473;127;27;154;NA;23358;500;2020-10-27;-28392
2020-10-26;"Trenčiansky kraj";177;103;31;134;NA;23358;208;2020-10-26;-28892
2020-10-25;"Trenčiansky kraj";138;9;5;14;NA;23358;143;2020-10-25;-29100
2020-10-24;"Trenčiansky kraj";395;128;6;134;NA;23358;401;2020-10-24;-29243
2020-10-23;"Trenčiansky kraj";301;154;8;162;NA;23358;309;2020-10-23;-29644
2020-10-22;"Trenčiansky kraj";273;82;12;94;NA;23358;285;2020-10-22;-29953
2020-10-21;"Trenčiansky kraj";183;53;9;62;NA;23358;192;2020-10-21;-30238
2020-10-20;"Trenčiansky kraj";212;47;6;53;NA;23358;218;2020-10-20;-30430
2020-10-19;"Trenčiansky kraj";41;83;25;108;NA;23358;66;2020-10-19;-30648
2020-10-18;"Trenčiansky kraj";104;0;0;0;NA;23358;104;2020-10-18;-30714
2020-10-17;"Trenčiansky kraj";157;0;0;0;NA;23358;157;2020-10-17;-30818
2020-10-16;"Trenčiansky kraj";225;42;6;48;NA;23358;231;2020-10-16;-30975
2020-10-15;"Trenčiansky kraj";255;39;4;43;NA;23358;259;2020-10-15;-31206
2020-10-14;"Trenčiansky kraj";162;42;7;49;NA;23358;169;2020-10-14;-31465
2020-10-13;"Trenčiansky kraj";124;105;12;117;NA;23358;136;2020-10-13;-31634
2020-10-12;"Trenčiansky kraj";55;0;0;0;NA;23358;55;2020-10-12;-31770
2020-10-11;"Trenčiansky kraj";73;0;0;0;NA;23358;73;2020-10-11;-31825
2020-10-10;"Trenčiansky kraj";180;0;0;0;NA;23358;180;2020-10-10;-31898
2020-10-09;"Trenčiansky kraj";198;0;0;0;NA;23358;198;2020-10-09;-32078
2020-10-08;"Trenčiansky kraj";115;0;0;0;NA;23358;115;2020-10-08;-32276
2020-10-07;"Trenčiansky kraj";75;0;0;0;NA;23358;75;2020-10-07;-32391
2020-10-06;"Trenčiansky kraj";72;0;0;0;NA;23358;72;2020-10-06;-32466
2020-10-05;"Trenčiansky kraj";32;0;0;0;NA;23358;32;2020-10-05;-32538
2020-10-04;"Trenčiansky kraj";37;0;0;0;NA;23358;37;2020-10-04;-32570
2020-10-03;"Trenčiansky kraj";79;0;0;0;NA;23358;79;2020-10-03;-32607
2020-10-02;"Trenčiansky kraj";69;0;0;0;NA;23358;69;2020-10-02;-32686
2020-10-01;"Trenčiansky kraj";58;0;0;0;NA;23358;58;2020-10-01;-32755
2020-09-30;"Trenčiansky kraj";76;0;0;0;NA;23358;76;2020-09-30;-32813
2020-09-29;"Trenčiansky kraj";43;0;0;0;NA;23358;43;2020-09-29;-32889
2020-09-28;"Trenčiansky kraj";7;0;0;0;NA;23358;7;2020-09-28;-32932
2020-09-27;"Trenčiansky kraj";12;0;0;0;NA;23358;12;2020-09-27;-32939
2020-09-26;"Trenčiansky kraj";37;0;0;0;NA;23358;37;2020-09-26;-32951
2020-09-25;"Trenčiansky kraj";72;0;0;0;NA;23358;72;2020-09-25;-32988
2020-09-24;"Trenčiansky kraj";41;0;0;0;NA;23358;41;2020-09-24;-33060
2020-09-23;"Trenčiansky kraj";32;0;0;0;NA;23358;32;2020-09-23;-33101
2020-09-22;"Trenčiansky kraj";26;0;0;0;NA;23358;26;2020-09-22;-33133
2020-09-21;"Trenčiansky kraj";23;0;0;0;NA;23358;23;2020-09-21;-33159
2020-09-20;"Trenčiansky kraj";21;0;0;0;NA;23358;21;2020-09-20;-33182
2020-09-19;"Trenčiansky kraj";20;0;0;0;NA;23358;20;2020-09-19;-33203
2020-09-18;"Trenčiansky kraj";41;0;0;0;NA;23358;41;2020-09-18;-33223
2020-09-17;"Trenčiansky kraj";20;0;0;0;NA;23358;20;2020-09-17;-33264
2020-09-16;"Trenčiansky kraj";14;0;0;0;NA;23358;14;2020-09-16;-33284
2020-09-15;"Trenčiansky kraj";8;0;0;0;NA;23358;8;2020-09-15;-33298
2020-09-14;"Trenčiansky kraj";5;0;0;0;NA;23358;5;2020-09-14;-33306
2020-09-13;"Trenčiansky kraj";12;0;0;0;NA;23358;12;2020-09-13;-33311
2020-09-12;"Trenčiansky kraj";2;0;0;0;NA;23358;2;2020-09-12;-33323
2020-09-11;"Trenčiansky kraj";27;0;0;0;NA;23358;27;2020-09-11;-33325
2020-09-10;"Trenčiansky kraj";15;0;0;0;NA;23358;15;2020-09-10;-33352
2020-09-09;"Trenčiansky kraj";11;0;0;0;NA;23358;11;2020-09-09;-33367
2020-09-08;"Trenčiansky kraj";12;0;0;0;NA;23358;12;2020-09-08;-33378
2020-09-07;"Trenčiansky kraj";6;0;0;0;NA;23358;6;2020-09-07;-33390
2020-09-06;"Trenčiansky kraj";1;0;0;0;NA;23358;1;2020-09-06;-33396
2020-09-05;"Trenčiansky kraj";3;0;0;0;NA;23358;3;2020-09-05;-33397
2020-09-04;"Trenčiansky kraj";9;0;0;0;NA;23358;9;2020-09-04;-33400
2020-09-03;"Trenčiansky kraj";10;0;0;0;NA;23358;10;2020-09-03;-33409
2021-02-01;"Trnavský kraj";198;36226;609;36835;NA;24032;807;2021-02-01;24032
2021-01-31;"Trnavský kraj";19;58944;720;59664;NA;24032;739;2021-01-31;23225
2021-01-30;"Trnavský kraj";323;105718;1221;106939;NA;24032;1544;2021-01-30;22486
2021-01-29;"Trnavský kraj";196;9040;268;9308;NA;24032;464;2021-01-29;20942
2021-01-28;"Trnavský kraj";389;5815;286;6101;NA;24032;675;2021-01-28;20478
2021-01-27;"Trnavský kraj";433;5276;219;5495;NA;24032;652;2021-01-27;19803
2021-01-26;"Trnavský kraj";565;25345;650;25995;NA;24032;1215;2021-01-26;19151
2021-01-25;"Trnavský kraj";210;44524;1315;45839;NA;24032;1525;2021-01-25;17936
2021-01-24;"Trnavský kraj";91;55073;690;55763;NA;24032;781;2021-01-24;16411
2021-01-23;"Trnavský kraj";372;111855;1253;113108;NA;24032;1625;2021-01-23;15630
2021-01-22;"Trnavský kraj";217;31870;496;32366;NA;24032;713;2021-01-22;14005
2021-01-21;"Trnavský kraj";311;13834;378;14212;NA;24032;689;2021-01-21;13292
2021-01-20;"Trnavský kraj";503;8149;274;8423;NA;24032;777;2021-01-20;12603
2021-01-19;"Trnavský kraj";415;7019;346;7365;NA;24032;761;2021-01-19;11826
2021-01-18;"Trnavský kraj";247;6237;484;6721;NA;24032;731;2021-01-18;11065
2021-01-17;"Trnavský kraj";128;854;215;1069;NA;24032;343;2021-01-17;10334
2021-01-16;"Trnavský kraj";103;599;19;618;NA;24032;122;2021-01-16;9991
2021-01-15;"Trnavský kraj";278;5468;336;5804;NA;24032;614;2021-01-15;9869
2021-01-14;"Trnavský kraj";452;3994;337;4331;NA;24032;789;2021-01-14;9255
2021-01-13;"Trnavský kraj";457;4752;378;5130;NA;24032;835;2021-01-13;8466
2021-01-12;"Trnavský kraj";469;7177;483;7660;NA;24032;952;2021-01-12;7631
2021-01-11;"Trnavský kraj";370;4911;376;5287;NA;24032;746;2021-01-11;6679
2021-01-10;"Trnavský kraj";71;8;0;8;NA;24032;71;2021-01-10;5933
2021-01-09;"Trnavský kraj";417;2310;123;2433;NA;24032;540;2021-01-09;5862
2021-01-08;"Trnavský kraj";381;5814;479;6293;NA;24032;860;2021-01-08;5322
2021-01-07;"Trnavský kraj";501;3539;336;3875;NA;24032;837;2021-01-07;4462
2021-01-06;"Trnavský kraj";179;758;132;890;NA;24032;311;2021-01-06;3625
2021-01-05;"Trnavský kraj";611;6188;705;6893;NA;24032;1316;2021-01-05;3314
2021-01-04;"Trnavský kraj";302;5235;689;5924;NA;24032;991;2021-01-04;1998
2021-01-03;"Trnavský kraj";60;51;7;58;NA;24032;67;2021-01-03;1007
2021-01-02;"Trnavský kraj";282;412;30;442;NA;24032;312;2021-01-02;940
2021-01-01;"Trnavský kraj";143;449;76;525;NA;24032;219;2021-01-01;628
2020-12-31;"Trnavský kraj";498;8474;856;9330;NA;24032;1354;2020-12-31;409
2020-12-30;"Trnavský kraj";785;5319;610;5929;NA;24032;1395;2020-12-30;-945
2020-12-29;"Trnavský kraj";322;5003;593;5596;NA;24032;915;2020-12-29;-2340
2020-12-28;"Trnavský kraj";213;5339;615;5954;NA;24032;828;2020-12-28;-3255
2020-12-27;"Trnavský kraj";27;13;4;17;NA;24032;31;2020-12-27;-4083
2020-12-26;"Trnavský kraj";148;44;1;45;NA;24032;149;2020-12-26;-4114
2020-12-25;"Trnavský kraj";65;49;5;54;NA;24032;70;2020-12-25;-4263
2020-12-24;"Trnavský kraj";333;1359;117;1476;NA;24032;450;2020-12-24;-4333
2020-12-23;"Trnavský kraj";210;6417;375;6792;NA;24032;585;2020-12-23;-4783
2020-12-22;"Trnavský kraj";311;5590;491;6081;NA;24032;802;2020-12-22;-5368
2020-12-21;"Trnavský kraj";328;4527;399;4926;NA;24032;727;2020-12-21;-6170
2020-12-20;"Trnavský kraj";134;110;12;122;NA;24032;146;2020-12-20;-6897
2020-12-19;"Trnavský kraj";201;1046;86;1132;NA;24032;287;2020-12-19;-7043
2020-12-18;"Trnavský kraj";341;4898;378;5276;NA;24032;719;2020-12-18;-7330
2020-12-17;"Trnavský kraj";375;4996;407;5403;NA;24032;782;2020-12-17;-8049
2020-12-16;"Trnavský kraj";312;5249;405;5654;NA;24032;717;2020-12-16;-8831
2020-12-15;"Trnavský kraj";492;6622;632;7254;NA;24032;1124;2020-12-15;-9548
2020-12-14;"Trnavský kraj";161;3505;292;3797;NA;24032;453;2020-12-14;-10672
2020-12-13;"Trnavský kraj";7;0;0;0;NA;24032;7;2020-12-13;-11125
2020-12-12;"Trnavský kraj";254;1456;114;1570;NA;24032;368;2020-12-12;-11132
2020-12-11;"Trnavský kraj";384;4683;262;4945;NA;24032;646;2020-12-11;-11500
2020-12-10;"Trnavský kraj";183;5194;320;5514;NA;24032;503;2020-12-10;-12146
2020-12-09;"Trnavský kraj";521;4272;320;4592;NA;24032;841;2020-12-09;-12649
2020-12-08;"Trnavský kraj";281;4090;304;4394;NA;24032;585;2020-12-08;-13490
2020-12-07;"Trnavský kraj";178;2895;199;3094;NA;24032;377;2020-12-07;-14075
2020-12-06;"Trnavský kraj";46;0;0;0;NA;24032;46;2020-12-06;-14452
2020-12-05;"Trnavský kraj";129;2218;41;2259;NA;24032;170;2020-12-05;-14498
2020-12-04;"Trnavský kraj";242;3948;158;4106;NA;24032;400;2020-12-04;-14668
2020-12-03;"Trnavský kraj";248;2770;190;2960;NA;24032;438;2020-12-03;-15068
2020-12-02;"Trnavský kraj";284;4516;176;4692;NA;24032;460;2020-12-02;-15506
2020-12-01;"Trnavský kraj";253;3190;205;3395;NA;24032;458;2020-12-01;-15966
2020-11-30;"Trnavský kraj";200;7360;186;7546;NA;24032;386;2020-11-30;-16424
2020-11-29;"Trnavský kraj";17;708;34;742;NA;24032;51;2020-11-29;-16810
2020-11-28;"Trnavský kraj";83;1453;77;1530;NA;24032;160;2020-11-28;-16861
2020-11-27;"Trnavský kraj";148;1591;83;1674;NA;24032;231;2020-11-27;-17021
2020-11-26;"Trnavský kraj";234;985;59;1044;NA;24032;293;2020-11-26;-17252
2020-11-25;"Trnavský kraj";232;1029;72;1101;NA;24032;304;2020-11-25;-17545
2020-11-24;"Trnavský kraj";295;1772;91;1863;NA;24032;386;2020-11-24;-17849
2020-11-23;"Trnavský kraj";242;7207;125;7332;NA;24032;367;2020-11-23;-18235
2020-11-22;"Trnavský kraj";10;54;3;57;NA;24032;13;2020-11-22;-18602
2020-11-21;"Trnavský kraj";129;1214;23;1237;NA;24032;152;2020-11-21;-18615
2020-11-20;"Trnavský kraj";246;1027;61;1088;NA;24032;307;2020-11-20;-18767
2020-11-19;"Trnavský kraj";157;694;58;752;NA;24032;215;2020-11-19;-19074
2020-11-18;"Trnavský kraj";235;716;75;791;NA;24032;310;2020-11-18;-19289
2020-11-17;"Trnavský kraj";129;695;72;767;NA;24032;201;2020-11-17;-19599
2020-11-16;"Trnavský kraj";187;682;32;714;NA;24032;219;2020-11-16;-19800
2020-11-15;"Trnavský kraj";23;73;4;77;NA;24032;27;2020-11-15;-20019
2020-11-14;"Trnavský kraj";86;389;10;399;NA;24032;96;2020-11-14;-20046
2020-11-13;"Trnavský kraj";219;1312;21;1333;NA;24032;240;2020-11-13;-20142
2020-11-12;"Trnavský kraj";162;420;18;438;NA;24032;180;2020-11-12;-20382
2020-11-11;"Trnavský kraj";257;392;15;407;NA;24032;272;2020-11-11;-20562
2020-11-10;"Trnavský kraj";189;889;30;919;NA;24032;219;2020-11-10;-20834
2020-11-09;"Trnavský kraj";196;369;23;392;NA;24032;219;2020-11-09;-21053
2020-11-08;"Trnavský kraj";55;306;4;310;NA;24032;59;2020-11-08;-21272
2020-11-07;"Trnavský kraj";207;6070;74;6144;NA;24032;281;2020-11-07;-21331
2020-11-06;"Trnavský kraj";260;1531;19;1550;NA;24032;279;2020-11-06;-21612
2020-11-05;"Trnavský kraj";150;220;27;247;NA;24032;177;2020-11-05;-21891
2020-11-04;"Trnavský kraj";188;212;10;222;NA;24032;198;2020-11-04;-22068
2020-11-03;"Trnavský kraj";317;127;8;135;NA;24032;325;2020-11-03;-22266
2020-11-02;"Trnavský kraj";281;1728;31;1759;NA;24032;312;2020-11-02;-22591
2020-11-01;"Trnavský kraj";87;494;27;521;NA;24032;114;2020-11-01;-22903
2020-10-31;"Trnavský kraj";259;5024;41;5065;NA;24032;300;2020-10-31;-23017
2020-10-30;"Trnavský kraj";198;3784;27;3811;NA;24032;225;2020-10-30;-23317
2020-10-29;"Trnavský kraj";273;1461;16;1477;NA;24032;289;2020-10-29;-23542
2020-10-28;"Trnavský kraj";319;117;16;133;NA;24032;335;2020-10-28;-23831
2020-10-27;"Trnavský kraj";199;461;36;497;NA;24032;235;2020-10-27;-24166
2020-10-26;"Trnavský kraj";153;29;2;31;NA;24032;155;2020-10-26;-24401
2020-10-25;"Trnavský kraj";95;19;1;20;NA;24032;96;2020-10-25;-24556
2020-10-24;"Trnavský kraj";158;109;2;111;NA;24032;160;2020-10-24;-24652
2020-10-23;"Trnavský kraj";201;89;4;93;NA;24032;205;2020-10-23;-24812
2020-10-22;"Trnavský kraj";195;55;2;57;NA;24032;197;2020-10-22;-25017
2020-10-21;"Trnavský kraj";134;73;3;76;NA;24032;137;2020-10-21;-25214
2020-10-20;"Trnavský kraj";202;82;3;85;NA;24032;205;2020-10-20;-25351
2020-10-19;"Trnavský kraj";67;55;0;55;NA;24032;67;2020-10-19;-25556
2020-10-18;"Trnavský kraj";84;0;0;0;NA;24032;84;2020-10-18;-25623
2020-10-17;"Trnavský kraj";123;0;0;0;NA;24032;123;2020-10-17;-25707
2020-10-16;"Trnavský kraj";86;45;2;47;NA;24032;88;2020-10-16;-25830
2020-10-15;"Trnavský kraj";155;66;2;68;NA;24032;157;2020-10-15;-25918
2020-10-14;"Trnavský kraj";236;468;3;471;NA;24032;239;2020-10-14;-26075
2020-10-13;"Trnavský kraj";138;16;2;18;NA;24032;140;2020-10-13;-26314
2020-10-12;"Trnavský kraj";33;41;1;42;NA;24032;34;2020-10-12;-26454
2020-10-11;"Trnavský kraj";31;0;0;0;NA;24032;31;2020-10-11;-26488
2020-10-10;"Trnavský kraj";128;0;0;0;NA;24032;128;2020-10-10;-26519
2020-10-09;"Trnavský kraj";156;0;0;0;NA;24032;156;2020-10-09;-26647
2020-10-08;"Trnavský kraj";153;0;0;0;NA;24032;153;2020-10-08;-26803
2020-10-07;"Trnavský kraj";80;0;0;0;NA;24032;80;2020-10-07;-26956
2020-10-06;"Trnavský kraj";112;0;0;0;NA;24032;112;2020-10-06;-27036
2020-10-05;"Trnavský kraj";33;0;0;0;NA;24032;33;2020-10-05;-27148
2020-10-04;"Trnavský kraj";44;0;0;0;NA;24032;44;2020-10-04;-27181
2020-10-03;"Trnavský kraj";60;0;0;0;NA;24032;60;2020-10-03;-27225
2020-10-02;"Trnavský kraj";41;0;0;0;NA;24032;41;2020-10-02;-27285
2020-10-01;"Trnavský kraj";53;0;0;0;NA;24032;53;2020-10-01;-27326
2020-09-30;"Trnavský kraj";91;0;0;0;NA;24032;91;2020-09-30;-27379
2020-09-29;"Trnavský kraj";40;0;0;0;NA;24032;40;2020-09-29;-27470
2020-09-28;"Trnavský kraj";69;0;0;0;NA;24032;69;2020-09-28;-27510
2020-09-27;"Trnavský kraj";30;0;0;0;NA;24032;30;2020-09-27;-27579
2020-09-26;"Trnavský kraj";46;0;0;0;NA;24032;46;2020-09-26;-27609
2020-09-25;"Trnavský kraj";32;0;0;0;NA;24032;32;2020-09-25;-27655
2020-09-24;"Trnavský kraj";42;0;0;0;NA;24032;42;2020-09-24;-27687
2020-09-23;"Trnavský kraj";43;0;0;0;NA;24032;43;2020-09-23;-27729
2020-09-22;"Trnavský kraj";55;0;0;0;NA;24032;55;2020-09-22;-27772
2020-09-21;"Trnavský kraj";41;0;0;0;NA;24032;41;2020-09-21;-27827
2020-09-20;"Trnavský kraj";17;0;0;0;NA;24032;17;2020-09-20;-27868
2020-09-19;"Trnavský kraj";4;0;0;0;NA;24032;4;2020-09-19;-27885
2020-09-18;"Trnavský kraj";33;0;0;0;NA;24032;33;2020-09-18;-27889
2020-09-17;"Trnavský kraj";42;0;0;0;NA;24032;42;2020-09-17;-27922
2020-09-16;"Trnavský kraj";49;0;0;0;NA;24032;49;2020-09-16;-27964
2020-09-15;"Trnavský kraj";5;0;0;0;NA;24032;5;2020-09-15;-28013
2020-09-14;"Trnavský kraj";26;0;0;0;NA;24032;26;2020-09-14;-28018
2020-09-13;"Trnavský kraj";9;0;0;0;NA;24032;9;2020-09-13;-28044
2020-09-12;"Trnavský kraj";12;0;0;0;NA;24032;12;2020-09-12;-28053
2020-09-11;"Trnavský kraj";16;0;0;0;NA;24032;16;2020-09-11;-28065
2020-09-10;"Trnavský kraj";32;0;0;0;NA;24032;32;2020-09-10;-28081
2020-09-09;"Trnavský kraj";14;0;0;0;NA;24032;14;2020-09-09;-28113
2020-09-08;"Trnavský kraj";11;0;0;0;NA;24032;11;2020-09-08;-28127
2020-09-07;"Trnavský kraj";7;0;0;0;NA;24032;7;2020-09-07;-28138
2020-09-06;"Trnavský kraj";5;0;0;0;NA;24032;5;2020-09-06;-28145
2020-09-05;"Trnavský kraj";7;0;0;0;NA;24032;7;2020-09-05;-28150
2020-09-04;"Trnavský kraj";16;0;0;0;NA;24032;16;2020-09-04;-28157
2020-09-03;"Trnavský kraj";8;0;0;0;NA;24032;8;2020-09-03;-28173
2021-02-01;"Žilinský kraj";220;18595;334;18929;NA;23642;554;2021-02-01;23642
2021-01-31;"Žilinský kraj";11;42;1;43;NA;23642;12;2021-01-31;23088
2021-01-30;"Žilinský kraj";85;15097;143;15240;NA;23642;228;2021-01-30;23076
2021-01-29;"Žilinský kraj";30;16069;198;16267;NA;23642;228;2021-01-29;22848
2021-01-28;"Žilinský kraj";240;5518;168;5686;NA;23642;408;2021-01-28;22620
2021-01-27;"Žilinský kraj";256;6836;264;7100;NA;23642;520;2021-01-27;22212
2021-01-26;"Žilinský kraj";245;49404;342;49746;NA;23642;587;2021-01-26;21692
2021-01-25;"Žilinský kraj";159;18791;136;18927;NA;23642;295;2021-01-25;21105
2021-01-24;"Žilinský kraj";22;32341;137;32478;NA;23642;159;2021-01-24;20810
2021-01-23;"Žilinský kraj";91;85460;379;85839;NA;23642;470;2021-01-23;20651
2021-01-22;"Žilinský kraj";163;26980;225;27205;NA;23642;388;2021-01-22;20181
2021-01-21;"Žilinský kraj";116;19271;181;19452;NA;23642;297;2021-01-21;19793
2021-01-20;"Žilinský kraj";236;16681;165;16846;NA;23642;401;2021-01-20;19496
2021-01-19;"Žilinský kraj";245;17911;411;18322;NA;23642;656;2021-01-19;19095
2021-01-18;"Žilinský kraj";236;12391;430;12821;NA;23642;666;2021-01-18;18439
2021-01-17;"Žilinský kraj";95;113;2;115;NA;23642;97;2021-01-17;17773
2021-01-16;"Žilinský kraj";14;314;8;322;NA;23642;22;2021-01-16;17676
2021-01-15;"Žilinský kraj";248;7149;202;7351;NA;23642;450;2021-01-15;17654
2021-01-14;"Žilinský kraj";166;5641;253;5894;NA;23642;419;2021-01-14;17204
2021-01-13;"Žilinský kraj";247;11341;554;11895;NA;23642;801;2021-01-13;16785
2021-01-12;"Žilinský kraj";376;8924;426;9350;NA;23642;802;2021-01-12;15984
2021-01-11;"Žilinský kraj";351;10596;518;11114;NA;23642;869;2021-01-11;15182
2021-01-10;"Žilinský kraj";38;189;7;196;NA;23642;45;2021-01-10;14313
2021-01-09;"Žilinský kraj";192;1992;85;2077;NA;23642;277;2021-01-09;14268
2021-01-08;"Žilinský kraj";413;9378;527;9905;NA;23642;940;2021-01-08;13991
2021-01-07;"Žilinský kraj";438;24459;1966;26425;NA;23642;2404;2021-01-07;13051
2021-01-06;"Žilinský kraj";145;1337;89;1426;NA;23642;234;2021-01-06;10647
2021-01-05;"Žilinský kraj";717;11311;929;12240;NA;23642;1646;2021-01-05;10413
2021-01-04;"Žilinský kraj";479;9612;1005;10617;NA;23642;1484;2021-01-04;8767
2021-01-03;"Žilinský kraj";13;33;4;37;NA;23642;17;2021-01-03;7283
2021-01-02;"Žilinský kraj";98;792;67;859;NA;23642;165;2021-01-02;7266
2021-01-01;"Žilinský kraj";118;552;36;588;NA;23642;154;2021-01-01;7101
2020-12-31;"Žilinský kraj";395;10587;835;11422;NA;23642;1230;2020-12-31;6947
2020-12-30;"Žilinský kraj";1038;12450;914;13364;NA;23642;1952;2020-12-30;5717
2020-12-29;"Žilinský kraj";256;11104;1111;12215;NA;23642;1367;2020-12-29;3765
2020-12-28;"Žilinský kraj";406;10770;1002;11772;NA;23642;1408;2020-12-28;2398
2020-12-27;"Žilinský kraj";40;662;80;742;NA;23642;120;2020-12-27;990
2020-12-26;"Žilinský kraj";135;124;14;138;NA;23642;149;2020-12-26;870
2020-12-25;"Žilinský kraj";66;111;10;121;NA;23642;76;2020-12-25;721
2020-12-24;"Žilinský kraj";643;1018;75;1093;NA;23642;718;2020-12-24;645
2020-12-23;"Žilinský kraj";228;17718;1049;18767;NA;23642;1277;2020-12-23;-73
2020-12-22;"Žilinský kraj";519;13188;1023;14211;NA;23642;1542;2020-12-22;-1350
2020-12-21;"Žilinský kraj";444;12703;1107;13810;NA;23642;1551;2020-12-21;-2892
2020-12-20;"Žilinský kraj";36;579;73;652;NA;23642;109;2020-12-20;-4443
2020-12-19;"Žilinský kraj";208;2080;144;2224;NA;23642;352;2020-12-19;-4552
2020-12-18;"Žilinský kraj";333;7027;402;7429;NA;23642;735;2020-12-18;-4904
2020-12-17;"Žilinský kraj";500;4333;281;4614;NA;23642;781;2020-12-17;-5639
2020-12-16;"Žilinský kraj";333;4365;305;4670;NA;23642;638;2020-12-16;-6420
2020-12-15;"Žilinský kraj";528;4700;414;5114;NA;23642;942;2020-12-15;-7058
2020-12-14;"Žilinský kraj";321;4688;419;5107;NA;23642;740;2020-12-14;-8000
2020-12-13;"Žilinský kraj";26;515;64;579;NA;23642;90;2020-12-13;-8740
2020-12-12;"Žilinský kraj";95;1061;53;1114;NA;23642;148;2020-12-12;-8830
2020-12-11;"Žilinský kraj";455;5089;318;5407;NA;23642;773;2020-12-11;-8978
2020-12-10;"Žilinský kraj";166;9279;977;10256;NA;23642;1143;2020-12-10;-9751
2020-12-09;"Žilinský kraj";392;2570;164;2734;NA;23642;556;2020-12-09;-10894
2020-12-08;"Žilinský kraj";331;3915;188;4103;NA;23642;519;2020-12-08;-11450
2020-12-07;"Žilinský kraj";348;2274;121;2395;NA;23642;469;2020-12-07;-11969
2020-12-06;"Žilinský kraj";15;134;4;138;NA;23642;19;2020-12-06;-12438
2020-12-05;"Žilinský kraj";98;1237;45;1282;NA;23642;143;2020-12-05;-12457
2020-12-04;"Žilinský kraj";228;2847;120;2967;NA;23642;348;2020-12-04;-12600
2020-12-03;"Žilinský kraj";237;1412;119;1531;NA;23642;356;2020-12-03;-12948
2020-12-02;"Žilinský kraj";181;1553;82;1635;NA;23642;263;2020-12-02;-13304
2020-12-01;"Žilinský kraj";209;6529;309;6838;NA;23642;518;2020-12-01;-13567
2020-11-30;"Žilinský kraj";202;5232;291;5523;NA;23642;493;2020-11-30;-14085
2020-11-29;"Žilinský kraj";18;81;7;88;NA;23642;25;2020-11-29;-14578
2020-11-28;"Žilinský kraj";99;349;15;364;NA;23642;114;2020-11-28;-14603
2020-11-27;"Žilinský kraj";218;913;46;959;NA;23642;264;2020-11-27;-14717
2020-11-26;"Žilinský kraj";189;1104;57;1161;NA;23642;246;2020-11-26;-14981
2020-11-25;"Žilinský kraj";225;1217;49;1266;NA;23642;274;2020-11-25;-15227
2020-11-24;"Žilinský kraj";213;2092;67;2159;NA;23642;280;2020-11-24;-15501
2020-11-23;"Žilinský kraj";170;759;44;803;NA;23642;214;2020-11-23;-15781
2020-11-22;"Žilinský kraj";11;0;0;0;NA;23642;11;2020-11-22;-15995
2020-11-21;"Žilinský kraj";61;505;20;525;NA;23642;81;2020-11-21;-16006
2020-11-20;"Žilinský kraj";251;1074;45;1119;NA;23642;296;2020-11-20;-16087
2020-11-19;"Žilinský kraj";252;752;61;813;NA;23642;313;2020-11-19;-16383
2020-11-18;"Žilinský kraj";346;348;15;363;NA;23642;361;2020-11-18;-16696
2020-11-17;"Žilinský kraj";123;490;15;505;NA;23642;138;2020-11-17;-17057
2020-11-16;"Žilinský kraj";227;206;13;219;NA;23642;240;2020-11-16;-17195
2020-11-15;"Žilinský kraj";63;13;0;13;NA;23642;63;2020-11-15;-17435
2020-11-14;"Žilinský kraj";189;1038;11;1049;NA;23642;200;2020-11-14;-17498
2020-11-13;"Žilinský kraj";181;125;9;134;NA;23642;190;2020-11-13;-17698
2020-11-12;"Žilinský kraj";334;79;2;81;NA;23642;336;2020-11-12;-17888
2020-11-11;"Žilinský kraj";489;147;10;157;NA;23642;499;2020-11-11;-18224
2020-11-10;"Žilinský kraj";374;519;9;528;NA;23642;383;2020-11-10;-18723
2020-11-09;"Žilinský kraj";143;2335;30;2365;NA;23642;173;2020-11-09;-19106
2020-11-08;"Žilinský kraj";59;2196;35;2231;NA;23642;94;2020-11-08;-19279
2020-11-07;"Žilinský kraj";312;8175;88;8263;NA;23642;400;2020-11-07;-19373
2020-11-06;"Žilinský kraj";503;4090;38;4128;NA;23642;541;2020-11-06;-19773
2020-11-05;"Žilinský kraj";473;64;4;68;NA;23642;477;2020-11-05;-20314
2020-11-04;"Žilinský kraj";423;168;10;178;NA;23642;433;2020-11-04;-20791
2020-11-03;"Žilinský kraj";688;889;16;905;NA;23642;704;2020-11-03;-21224
2020-11-02;"Žilinský kraj";472;1043;39;1082;NA;23642;511;2020-11-02;-21928
2020-11-01;"Žilinský kraj";349;5096;130;5226;NA;23642;479;2020-11-01;-22439
2020-10-31;"Žilinský kraj";662;7963;203;8166;NA;23642;865;2020-10-31;-22918
2020-10-30;"Žilinský kraj";529;2575;61;2636;NA;23642;590;2020-10-30;-23783
2020-10-29;"Žilinský kraj";740;503;17;520;NA;23642;757;2020-10-29;-24373
2020-10-28;"Žilinský kraj";635;105;11;116;NA;23642;646;2020-10-28;-25130
2020-10-27;"Žilinský kraj";355;154;24;178;NA;23642;379;2020-10-27;-25776
2020-10-26;"Žilinský kraj";148;117;28;145;NA;23642;176;2020-10-26;-26155
2020-10-25;"Žilinský kraj";436;0;0;0;NA;23642;436;2020-10-25;-26331
2020-10-24;"Žilinský kraj";803;0;0;0;NA;23642;803;2020-10-24;-26767
2020-10-23;"Žilinský kraj";659;102;13;115;NA;23642;672;2020-10-23;-27570
2020-10-22;"Žilinský kraj";525;33;3;36;NA;23642;528;2020-10-22;-28242
2020-10-21;"Žilinský kraj";478;74;14;88;NA;23642;492;2020-10-21;-28770
2020-10-20;"Žilinský kraj";524;127;8;135;NA;23642;532;2020-10-20;-29262
2020-10-19;"Žilinský kraj";70;80;12;92;NA;23642;82;2020-10-19;-29794
2020-10-18;"Žilinský kraj";159;0;0;0;NA;23642;159;2020-10-18;-29876
2020-10-17;"Žilinský kraj";509;0;0;0;NA;23642;509;2020-10-17;-30035
2020-10-16;"Žilinský kraj";603;51;9;60;NA;23642;612;2020-10-16;-30544
2020-10-15;"Žilinský kraj";679;61;3;64;NA;23642;682;2020-10-15;-31156
2020-10-14;"Žilinský kraj";523;269;6;275;NA;23642;529;2020-10-14;-31838
2020-10-13;"Žilinský kraj";367;458;40;498;NA;23642;407;2020-10-13;-32367
2020-10-12;"Žilinský kraj";62;0;0;0;NA;23642;62;2020-10-12;-32774
2020-10-11;"Žilinský kraj";50;0;0;0;NA;23642;50;2020-10-11;-32836
2020-10-10;"Žilinský kraj";213;0;0;0;NA;23642;213;2020-10-10;-32886
2020-10-09;"Žilinský kraj";543;0;0;0;NA;23642;543;2020-10-09;-33099
2020-10-08;"Žilinský kraj";238;0;0;0;NA;23642;238;2020-10-08;-33642
2020-10-07;"Žilinský kraj";168;0;0;0;NA;23642;168;2020-10-07;-33880
2020-10-06;"Žilinský kraj";233;0;0;0;NA;23642;233;2020-10-06;-34048
2020-10-05;"Žilinský kraj";33;0;0;0;NA;23642;33;2020-10-05;-34281
2020-10-04;"Žilinský kraj";35;0;0;0;NA;23642;35;2020-10-04;-34314
2020-10-03;"Žilinský kraj";155;0;0;0;NA;23642;155;2020-10-03;-34349
2020-10-02;"Žilinský kraj";105;0;0;0;NA;23642;105;2020-10-02;-34504
2020-10-01;"Žilinský kraj";147;0;0;0;NA;23642;147;2020-10-01;-34609
2020-09-30;"Žilinský kraj";163;0;0;0;NA;23642;163;2020-09-30;-34756
2020-09-29;"Žilinský kraj";105;0;0;0;NA;23642;105;2020-09-29;-34919
2020-09-28;"Žilinský kraj";34;0;0;0;NA;23642;34;2020-09-28;-35024
2020-09-27;"Žilinský kraj";108;0;0;0;NA;23642;108;2020-09-27;-35058
2020-09-26;"Žilinský kraj";96;0;0;0;NA;23642;96;2020-09-26;-35166
2020-09-25;"Žilinský kraj";69;0;0;0;NA;23642;69;2020-09-25;-35262
2020-09-24;"Žilinský kraj";100;0;0;0;NA;23642;100;2020-09-24;-35331
2020-09-23;"Žilinský kraj";65;0;0;0;NA;23642;65;2020-09-23;-35431
2020-09-22;"Žilinský kraj";65;0;0;0;NA;23642;65;2020-09-22;-35496
2020-09-21;"Žilinský kraj";47;0;0;0;NA;23642;47;2020-09-21;-35561
2020-09-20;"Žilinský kraj";4;0;0;0;NA;23642;4;2020-09-20;-35608
2020-09-19;"Žilinský kraj";6;0;0;0;NA;23642;6;2020-09-19;-35612
2020-09-18;"Žilinský kraj";82;0;0;0;NA;23642;82;2020-09-18;-35618
2020-09-17;"Žilinský kraj";30;0;0;0;NA;23642;30;2020-09-17;-35700
2020-09-16;"Žilinský kraj";34;0;0;0;NA;23642;34;2020-09-16;-35730
2020-09-15;"Žilinský kraj";12;0;0;0;NA;23642;12;2020-09-15;-35764
2020-09-14;"Žilinský kraj";39;0;0;0;NA;23642;39;2020-09-14;-35776
2020-09-13;"Žilinský kraj";6;0;0;0;NA;23642;6;2020-09-13;-35815
2020-09-12;"Žilinský kraj";4;0;0;0;NA;23642;4;2020-09-12;-35821
2020-09-11;"Žilinský kraj";31;0;0;0;NA;23642;31;2020-09-11;-35825
2020-09-10;"Žilinský kraj";31;0;0;0;NA;23642;31;2020-09-10;-35856
2020-09-09;"Žilinský kraj";23;0;0;0;NA;23642;23;2020-09-09;-35887
2020-09-08;"Žilinský kraj";25;0;0;0;NA;23642;25;2020-09-08;-35910
2020-09-07;"Žilinský kraj";11;0;0;0;NA;23642;11;2020-09-07;-35935
2020-09-05;"Žilinský kraj";2;0;0;0;NA;23642;2;2020-09-05;-35946
2020-09-04;"Žilinský kraj";33;0;0;0;NA;23642;33;2020-09-04;-35948
2020-09-03;"Žilinský kraj";18;0;0;0;NA;23642;18;2020-09-03;-35981
