"Datum";"Region";"PCR_Pos";"Ag_Neg";"Ag_Pos";"Total";"Pocet.potvrdenych";"Potvrdenych";"newcases";"date";"positive"
2021-02-18;"Banskobystrický kraj";241;16075;407;16482;27010;53124;648;2021-02-18;53124
2021-02-17;"Banskobystrický kraj";415;15764;384;16148;NA;53124;799;2021-02-17;52476
2021-02-16;"Banskobystrický kraj";338;20216;380;20596;NA;53124;718;2021-02-16;51677
2021-02-15;"Banskobystrický kraj";118;34474;554;35028;NA;53124;672;2021-02-15;50959
2021-02-14;"Banskobystrický kraj";60;14810;127;14937;NA;53124;187;2021-02-14;50287
2021-02-13;"Banskobystrický kraj";202;42021;399;42420;NA;53124;601;2021-02-13;50100
2021-02-12;"Banskobystrický kraj";312;34882;521;35403;NA;53124;833;2021-02-12;49499
2021-02-11;"Banskobystrický kraj";305;21337;384;21721;NA;53124;689;2021-02-11;48666
2021-02-10;"Banskobystrický kraj";333;13538;320;13858;NA;53124;653;2021-02-10;47977
2021-02-09;"Banskobystrický kraj";329;17502;349;17851;NA;53124;678;2021-02-09;47324
2021-02-08;"Banskobystrický kraj";103;40946;589;41535;NA;53124;692;2021-02-08;46646
2021-02-07;"Banskobystrický kraj";70;23531;142;23673;NA;53124;212;2021-02-07;45954
2021-02-06;"Banskobystrický kraj";178;63027;545;63572;NA;53124;723;2021-02-06;45742
2021-02-05;"Banskobystrický kraj";282;23556;358;23914;NA;53124;640;2021-02-05;45019
2021-02-04;"Banskobystrický kraj";240;13170;413;13583;NA;53124;653;2021-02-04;44379
2021-02-03;"Banskobystrický kraj";350;9060;243;9303;NA;53124;593;2021-02-03;43726
2021-02-02;"Banskobystrický kraj";277;14665;319;14984;NA;53124;596;2021-02-02;43133
2021-02-01;"Banskobystrický kraj";75;19072;379;19451;NA;53124;454;2021-02-01;42537
2021-01-31;"Banskobystrický kraj";34;24501;219;24720;NA;53124;253;2021-01-31;42083
2021-01-30;"Banskobystrický kraj";163;46091;379;46470;NA;53124;542;2021-01-30;41830
2021-01-29;"Banskobystrický kraj";130;15194;237;15431;NA;53124;367;2021-01-29;41288
2021-01-28;"Banskobystrický kraj";218;13804;342;14146;NA;53124;560;2021-01-28;40921
2021-01-27;"Banskobystrický kraj";191;10631;197;10828;NA;53124;388;2021-01-27;40361
2021-01-26;"Banskobystrický kraj";238;19673;288;19961;NA;53124;526;2021-01-26;39973
2021-01-25;"Banskobystrický kraj";82;31377;369;31746;NA;53124;451;2021-01-25;39447
2021-01-24;"Banskobystrický kraj";38;29267;239;29506;NA;53124;277;2021-01-24;38996
2021-01-23;"Banskobystrický kraj";142;83610;503;84113;NA;53124;645;2021-01-23;38719
2021-01-22;"Banskobystrický kraj";175;26799;341;27140;NA;53124;516;2021-01-22;38074
2021-01-21;"Banskobystrický kraj";194;16009;351;16360;NA;53124;545;2021-01-21;37558
2021-01-20;"Banskobystrický kraj";231;8860;186;9046;NA;53124;417;2021-01-20;37013
2021-01-19;"Banskobystrický kraj";213;10646;321;10967;NA;53124;534;2021-01-19;36596
2021-01-18;"Banskobystrický kraj";94;5171;277;5448;NA;53124;371;2021-01-18;36062
2021-01-17;"Banskobystrický kraj";110;8150;77;8227;NA;53124;187;2021-01-17;35691
2021-01-16;"Banskobystrický kraj";58;1873;56;1929;NA;53124;114;2021-01-16;35504
2021-01-15;"Banskobystrický kraj";164;6312;203;6515;NA;53124;367;2021-01-15;35390
2021-01-14;"Banskobystrický kraj";220;5443;320;5763;NA;53124;540;2021-01-14;35023
2021-01-13;"Banskobystrický kraj";235;5560;191;5751;NA;53124;426;2021-01-13;34483
2021-01-12;"Banskobystrický kraj";194;6298;287;6585;NA;53124;481;2021-01-12;34057
2021-01-11;"Banskobystrický kraj";76;7034;411;7445;NA;53124;487;2021-01-11;33576
2021-01-10;"Banskobystrický kraj";110;102;4;106;NA;53124;114;2021-01-10;33089
2021-01-09;"Banskobystrický kraj";297;2728;107;2835;NA;53124;404;2021-01-09;32975
2021-01-08;"Banskobystrický kraj";435;8076;383;8459;NA;53124;818;2021-01-08;32571
2021-01-07;"Banskobystrický kraj";127;4037;260;4297;NA;53124;387;2021-01-07;31753
2021-01-06;"Banskobystrický kraj";305;3369;210;3579;NA;53124;515;2021-01-06;31366
2021-01-05;"Banskobystrický kraj";372;6380;480;6860;NA;53124;852;2021-01-05;30851
2021-01-04;"Banskobystrický kraj";130;5762;571;6333;NA;53124;701;2021-01-04;29999
2021-01-03;"Banskobystrický kraj";199;162;13;175;NA;53124;212;2021-01-03;29298
2021-01-02;"Banskobystrický kraj";123;583;83;666;NA;53124;206;2021-01-02;29086
2021-01-01;"Banskobystrický kraj";220;2015;135;2150;NA;53124;355;2021-01-01;28880
2020-12-31;"Banskobystrický kraj";499;6743;719;7462;NA;53124;1218;2020-12-31;28525
2020-12-30;"Banskobystrický kraj";593;7409;550;7959;NA;53124;1143;2020-12-30;27307
2020-12-29;"Banskobystrický kraj";240;7769;738;8507;NA;53124;978;2020-12-29;26164
2020-12-28;"Banskobystrický kraj";131;5659;703;6362;NA;53124;834;2020-12-28;25186
2020-12-27;"Banskobystrický kraj";116;496;25;521;NA;53124;141;2020-12-27;24352
2020-12-26;"Banskobystrický kraj";61;259;32;291;NA;53124;93;2020-12-26;24211
2020-12-25;"Banskobystrický kraj";65;229;6;235;NA;53124;71;2020-12-25;24118
2020-12-24;"Banskobystrický kraj";452;3674;135;3809;NA;53124;587;2020-12-24;24047
2020-12-23;"Banskobystrický kraj";368;10110;507;10617;NA;53124;875;2020-12-23;23460
2020-12-22;"Banskobystrický kraj";307;8434;624;9058;NA;53124;931;2020-12-22;22585
2020-12-21;"Banskobystrický kraj";286;4898;448;5346;NA;53124;734;2020-12-21;21654
2020-12-20;"Banskobystrický kraj";155;99;14;113;NA;53124;169;2020-12-20;20920
2020-12-19;"Banskobystrický kraj";170;2918;135;3053;NA;53124;305;2020-12-19;20751
2020-12-18;"Banskobystrický kraj";432;6454;414;6868;NA;53124;846;2020-12-18;20446
2020-12-17;"Banskobystrický kraj";468;8474;772;9246;NA;53124;1240;2020-12-17;19600
2020-12-16;"Banskobystrický kraj";379;10080;557;10637;NA;53124;936;2020-12-16;18360
2020-12-15;"Banskobystrický kraj";336;5318;430;5748;NA;53124;766;2020-12-15;17424
2020-12-14;"Banskobystrický kraj";148;3733;259;3992;NA;53124;407;2020-12-14;16658
2020-12-13;"Banskobystrický kraj";122;19;1;20;NA;53124;123;2020-12-13;16251
2020-12-12;"Banskobystrický kraj";137;2594;138;2732;NA;53124;275;2020-12-12;16128
2020-12-11;"Banskobystrický kraj";468;6443;374;6817;NA;53124;842;2020-12-11;15853
2020-12-10;"Banskobystrický kraj";280;5027;351;5378;NA;53124;631;2020-12-10;15011
2020-12-09;"Banskobystrický kraj";323;3707;212;3919;NA;53124;535;2020-12-09;14380
2020-12-08;"Banskobystrický kraj";256;3667;276;3943;NA;53124;532;2020-12-08;13845
2020-12-07;"Banskobystrický kraj";175;2006;140;2146;NA;53124;315;2020-12-07;13313
2020-12-06;"Banskobystrický kraj";121;359;9;368;NA;53124;130;2020-12-06;12998
2020-12-05;"Banskobystrický kraj";109;952;33;985;NA;53124;142;2020-12-05;12868
2020-12-04;"Banskobystrický kraj";339;3723;174;3897;NA;53124;513;2020-12-04;12726
2020-12-03;"Banskobystrický kraj";240;2913;227;3140;NA;53124;467;2020-12-03;12213
2020-12-02;"Banskobystrický kraj";217;4292;186;4478;NA;53124;403;2020-12-02;11746
2020-12-01;"Banskobystrický kraj";215;2619;134;2753;NA;53124;349;2020-12-01;11343
2020-11-30;"Banskobystrický kraj";75;3761;226;3987;NA;53124;301;2020-11-30;10994
2020-11-29;"Banskobystrický kraj";19;80;3;83;NA;53124;22;2020-11-29;10693
2020-11-28;"Banskobystrický kraj";81;1279;48;1327;NA;53124;129;2020-11-28;10671
2020-11-27;"Banskobystrický kraj";219;1930;120;2050;NA;53124;339;2020-11-27;10542
2020-11-26;"Banskobystrický kraj";209;1855;91;1946;NA;53124;300;2020-11-26;10203
2020-11-25;"Banskobystrický kraj";170;1760;84;1844;NA;53124;254;2020-11-25;9903
2020-11-24;"Banskobystrický kraj";166;2262;67;2329;NA;53124;233;2020-11-24;9649
2020-11-23;"Banskobystrický kraj";66;9948;191;10139;NA;53124;257;2020-11-23;9416
2020-11-22;"Banskobystrický kraj";38;72;1;73;NA;53124;39;2020-11-22;9159
2020-11-21;"Banskobystrický kraj";52;885;14;899;NA;53124;66;2020-11-21;9120
2020-11-20;"Banskobystrický kraj";127;1872;105;1977;NA;53124;232;2020-11-20;9054
2020-11-19;"Banskobystrický kraj";170;1112;82;1194;NA;53124;252;2020-11-19;8822
2020-11-18;"Banskobystrický kraj";153;587;62;649;NA;53124;215;2020-11-18;8570
2020-11-17;"Banskobystrický kraj";52;578;35;613;NA;53124;87;2020-11-17;8355
2020-11-16;"Banskobystrický kraj";106;351;22;373;NA;53124;128;2020-11-16;8268
2020-11-15;"Banskobystrický kraj";52;64;2;66;NA;53124;54;2020-11-15;8140
2020-11-14;"Banskobystrický kraj";73;305;2;307;NA;53124;75;2020-11-14;8086
2020-11-13;"Banskobystrický kraj";157;552;11;563;NA;53124;168;2020-11-13;8011
2020-11-12;"Banskobystrický kraj";218;952;44;996;NA;53124;262;2020-11-12;7843
2020-11-11;"Banskobystrický kraj";224;437;9;446;NA;53124;233;2020-11-11;7581
2020-11-10;"Banskobystrický kraj";263;463;18;481;NA;53124;281;2020-11-10;7348
2020-11-09;"Banskobystrický kraj";80;2678;31;2709;NA;53124;111;2020-11-09;7067
2020-11-08;"Banskobystrický kraj";82;783;16;799;NA;53124;98;2020-11-08;6956
2020-11-07;"Banskobystrický kraj";164;8828;94;8922;NA;53124;258;2020-11-07;6858
2020-11-06;"Banskobystrický kraj";227;2496;16;2512;NA;53124;243;2020-11-06;6600
2020-11-05;"Banskobystrický kraj";240;263;33;296;NA;53124;273;2020-11-05;6357
2020-11-04;"Banskobystrický kraj";254;1366;13;1379;NA;53124;267;2020-11-04;6084
2020-11-03;"Banskobystrický kraj";246;1332;4;1336;NA;53124;250;2020-11-03;5817
2020-11-02;"Banskobystrický kraj";90;2247;65;2312;NA;53124;155;2020-11-02;5567
2020-11-01;"Banskobystrický kraj";101;2671;42;2713;NA;53124;143;2020-11-01;5412
2020-10-31;"Banskobystrický kraj";198;13516;116;13632;NA;53124;314;2020-10-31;5269
2020-10-30;"Banskobystrický kraj";254;2829;20;2849;NA;53124;274;2020-10-30;4955
2020-10-29;"Banskobystrický kraj";372;969;42;1011;NA;53124;414;2020-10-29;4681
2020-10-28;"Banskobystrický kraj";285;302;30;332;NA;53124;315;2020-10-28;4267
2020-10-27;"Banskobystrický kraj";266;654;40;694;NA;53124;306;2020-10-27;3952
2020-10-26;"Banskobystrický kraj";38;232;29;261;NA;53124;67;2020-10-26;3646
2020-10-25;"Banskobystrický kraj";50;140;11;151;NA;53124;61;2020-10-25;3579
2020-10-24;"Banskobystrický kraj";315;114;12;126;NA;53124;327;2020-10-24;3518
2020-10-23;"Banskobystrický kraj";231;230;29;259;NA;53124;260;2020-10-23;3191
2020-10-22;"Banskobystrický kraj";264;253;24;277;NA;53124;288;2020-10-22;2931
2020-10-21;"Banskobystrický kraj";209;266;3;269;NA;53124;212;2020-10-21;2643
2020-10-20;"Banskobystrický kraj";210;66;3;69;NA;53124;213;2020-10-20;2431
2020-10-19;"Banskobystrický kraj";27;71;12;83;NA;53124;39;2020-10-19;2218
2020-10-18;"Banskobystrický kraj";49;0;0;0;NA;53124;49;2020-10-18;2179
2020-10-17;"Banskobystrický kraj";91;0;0;0;NA;53124;91;2020-10-17;2130
2020-10-16;"Banskobystrický kraj";224;37;3;40;NA;53124;227;2020-10-16;2039
2020-10-15;"Banskobystrický kraj";133;29;1;30;NA;53124;134;2020-10-15;1812
2020-10-14;"Banskobystrický kraj";139;31;1;32;NA;53124;140;2020-10-14;1678
2020-10-13;"Banskobystrický kraj";151;169;11;180;NA;53124;162;2020-10-13;1538
2020-10-12;"Banskobystrický kraj";11;13;0;13;NA;53124;11;2020-10-12;1376
2020-10-11;"Banskobystrický kraj";14;0;0;0;NA;53124;14;2020-10-11;1365
2020-10-10;"Banskobystrický kraj";53;0;0;0;NA;53124;53;2020-10-10;1351
2020-10-09;"Banskobystrický kraj";128;0;0;0;NA;53124;128;2020-10-09;1298
2020-10-08;"Banskobystrický kraj";99;0;0;0;NA;53124;99;2020-10-08;1170
2020-10-07;"Banskobystrický kraj";124;0;0;0;NA;53124;124;2020-10-07;1071
2020-10-06;"Banskobystrický kraj";68;0;0;0;NA;53124;68;2020-10-06;947
2020-10-05;"Banskobystrický kraj";49;0;0;0;NA;53124;49;2020-10-05;879
2020-10-04;"Banskobystrický kraj";8;0;0;0;NA;53124;8;2020-10-04;830
2020-10-03;"Banskobystrický kraj";37;0;0;0;NA;53124;37;2020-10-03;822
2020-10-02;"Banskobystrický kraj";74;0;0;0;NA;53124;74;2020-10-02;785
2020-10-01;"Banskobystrický kraj";49;0;0;0;NA;53124;49;2020-10-01;711
2020-09-30;"Banskobystrický kraj";60;0;0;0;NA;53124;60;2020-09-30;662
2020-09-29;"Banskobystrický kraj";24;0;0;0;NA;53124;24;2020-09-29;602
2020-09-27;"Banskobystrický kraj";20;0;0;0;NA;53124;20;2020-09-27;578
2020-09-26;"Banskobystrický kraj";24;0;0;0;NA;53124;24;2020-09-26;558
2020-09-25;"Banskobystrický kraj";29;0;0;0;NA;53124;29;2020-09-25;534
2020-09-24;"Banskobystrický kraj";25;0;0;0;NA;53124;25;2020-09-24;505
2020-09-23;"Banskobystrický kraj";17;0;0;0;NA;53124;17;2020-09-23;480
2020-09-22;"Banskobystrický kraj";25;0;0;0;NA;53124;25;2020-09-22;463
2020-09-21;"Banskobystrický kraj";3;0;0;0;NA;53124;3;2020-09-21;438
2020-09-19;"Banskobystrický kraj";3;0;0;0;NA;53124;3;2020-09-19;435
2020-09-18;"Banskobystrický kraj";24;0;0;0;NA;53124;24;2020-09-18;432
2020-09-17;"Banskobystrický kraj";14;0;0;0;NA;53124;14;2020-09-17;408
2020-09-16;"Banskobystrický kraj";6;0;0;0;NA;53124;6;2020-09-16;394
2020-09-15;"Banskobystrický kraj";2;0;0;0;NA;53124;2;2020-09-15;388
2020-09-14;"Banskobystrický kraj";13;0;0;0;NA;53124;13;2020-09-14;386
2020-09-13;"Banskobystrický kraj";1;0;0;0;NA;53124;1;2020-09-13;373
2020-09-12;"Banskobystrický kraj";5;0;0;0;NA;53124;5;2020-09-12;372
2020-09-11;"Banskobystrický kraj";19;0;0;0;NA;53124;19;2020-09-11;367
2020-09-10;"Banskobystrický kraj";11;0;0;0;NA;53124;11;2020-09-10;348
2020-09-09;"Banskobystrický kraj";13;0;0;0;NA;53124;13;2020-09-09;337
2020-09-08;"Banskobystrický kraj";5;0;0;0;NA;53124;5;2020-09-08;324
2020-09-07;"Banskobystrický kraj";2;0;0;0;NA;53124;2;2020-09-07;319
2020-09-04;"Banskobystrický kraj";9;0;0;0;NA;53124;9;2020-09-04;317
2020-09-03;"Banskobystrický kraj";5;0;0;0;NA;53124;5;2020-09-03;308
2021-02-18;"Bratislavský kraj";263;17682;254;17936;35007;63380;517;2021-02-18;63380
2021-02-17;"Bratislavský kraj";264;18323;251;18574;NA;63380;515;2021-02-17;62863
2021-02-16;"Bratislavský kraj";289;21708;252;21960;NA;63380;541;2021-02-16;62348
2021-02-15;"Bratislavský kraj";248;31608;322;31930;NA;63380;570;2021-02-15;61807
2021-02-14;"Bratislavský kraj";153;35828;241;36069;NA;63380;394;2021-02-14;61237
2021-02-13;"Bratislavský kraj";173;53067;418;53485;NA;63380;591;2021-02-13;60843
2021-02-12;"Bratislavský kraj";282;29195;252;29447;NA;63380;534;2021-02-12;60252
2021-02-11;"Bratislavský kraj";337;20910;247;21157;NA;63380;584;2021-02-11;59718
2021-02-10;"Bratislavský kraj";314;19273;305;19578;NA;63380;619;2021-02-10;59134
2021-02-09;"Bratislavský kraj";287;31709;392;32101;NA;63380;679;2021-02-09;58515
2021-02-08;"Bratislavský kraj";484;30885;359;31244;NA;63380;843;2021-02-08;57836
2021-02-07;"Bratislavský kraj";243;46281;383;46664;NA;63380;626;2021-02-07;56993
2021-02-06;"Bratislavský kraj";116;58455;478;58933;NA;63380;594;2021-02-06;56367
2021-02-05;"Bratislavský kraj";327;23779;345;24124;NA;63380;672;2021-02-05;55773
2021-02-04;"Bratislavský kraj";555;14355;320;14675;NA;63380;875;2021-02-04;55101
2021-02-03;"Bratislavský kraj";161;11535;302;11837;NA;63380;463;2021-02-03;54226
2021-02-02;"Bratislavský kraj";397;26308;407;26715;NA;63380;804;2021-02-02;53763
2021-02-01;"Bratislavský kraj";221;36991;442;37433;NA;63380;663;2021-02-01;52959
2021-01-31;"Bratislavský kraj";180;32747;375;33122;NA;63380;555;2021-01-31;52296
2021-01-30;"Bratislavský kraj";310;37774;413;38187;NA;63380;723;2021-01-30;51741
2021-01-29;"Bratislavský kraj";82;14562;323;14885;NA;63380;405;2021-01-29;51018
2021-01-28;"Bratislavský kraj";307;10148;289;10437;NA;63380;596;2021-01-28;50613
2021-01-27;"Bratislavský kraj";336;22701;348;23049;NA;63380;684;2021-01-27;50017
2021-01-26;"Bratislavský kraj";297;21825;279;22104;NA;63380;576;2021-01-26;49333
2021-01-25;"Bratislavský kraj";356;21951;230;22181;NA;63380;586;2021-01-25;48757
2021-01-24;"Bratislavský kraj";175;33901;342;34243;NA;63380;517;2021-01-24;48171
2021-01-23;"Bratislavský kraj";396;73435;636;74071;NA;63380;1032;2021-01-23;47654
2021-01-22;"Bratislavský kraj";199;39241;341;39582;NA;63380;540;2021-01-22;46622
2021-01-21;"Bratislavský kraj";255;103730;1292;105022;NA;63380;1547;2021-01-21;46082
2021-01-20;"Bratislavský kraj";360;26722;453;27175;NA;63380;813;2021-01-20;44535
2021-01-19;"Bratislavský kraj";375;13352;328;13680;NA;63380;703;2021-01-19;43722
2021-01-18;"Bratislavský kraj";357;11645;706;12351;NA;63380;1063;2021-01-18;43019
2021-01-17;"Bratislavský kraj";244;410;26;436;NA;63380;270;2021-01-17;41956
2021-01-16;"Bratislavský kraj";70;2749;156;2905;NA;63380;226;2021-01-16;41686
2021-01-15;"Bratislavský kraj";251;7632;254;7886;NA;63380;505;2021-01-15;41460
2021-01-14;"Bratislavský kraj";363;8078;273;8351;NA;63380;636;2021-01-14;40955
2021-01-13;"Bratislavský kraj";336;7886;328;8214;NA;63380;664;2021-01-13;40319
2021-01-12;"Bratislavský kraj";450;9435;463;9898;NA;63380;913;2021-01-12;39655
2021-01-11;"Bratislavský kraj";397;18828;376;19204;NA;63380;773;2021-01-11;38742
2021-01-10;"Bratislavský kraj";252;1341;79;1420;NA;63380;331;2021-01-10;37969
2021-01-09;"Bratislavský kraj";351;4946;291;5237;NA;63380;642;2021-01-09;37638
2021-01-08;"Bratislavský kraj";556;8833;425;9258;NA;63380;981;2021-01-08;36996
2021-01-07;"Bratislavský kraj";537;6855;398;7253;NA;63380;935;2021-01-07;36015
2021-01-06;"Bratislavský kraj";271;3018;216;3234;NA;63380;487;2021-01-06;35080
2021-01-05;"Bratislavský kraj";619;11367;832;12199;NA;63380;1451;2021-01-05;34593
2021-01-04;"Bratislavský kraj";601;7142;598;7740;NA;63380;1199;2021-01-04;33142
2021-01-03;"Bratislavský kraj";77;389;41;430;NA;63380;118;2021-01-03;31943
2021-01-02;"Bratislavský kraj";185;370;56;426;NA;63380;241;2021-01-02;31825
2021-01-01;"Bratislavský kraj";235;3143;130;3273;NA;63380;365;2021-01-01;31584
2020-12-31;"Bratislavský kraj";925;13824;590;14414;NA;63380;1515;2020-12-31;31219
2020-12-30;"Bratislavský kraj";650;9195;519;9714;NA;63380;1169;2020-12-30;29704
2020-12-29;"Bratislavský kraj";303;10109;772;10881;NA;63380;1075;2020-12-29;28535
2020-12-28;"Bratislavský kraj";255;7608;559;8167;NA;63380;814;2020-12-28;27460
2020-12-27;"Bratislavský kraj";160;646;76;722;NA;63380;236;2020-12-27;26646
2020-12-26;"Bratislavský kraj";75;416;23;439;NA;63380;98;2020-12-26;26410
2020-12-25;"Bratislavský kraj";114;460;38;498;NA;63380;152;2020-12-25;26312
2020-12-24;"Bratislavský kraj";536;3373;102;3475;NA;63380;638;2020-12-24;26160
2020-12-23;"Bratislavský kraj";416;12814;491;13305;NA;63380;907;2020-12-23;25522
2020-12-22;"Bratislavský kraj";327;14940;762;15702;NA;63380;1089;2020-12-22;24615
2020-12-21;"Bratislavský kraj";392;14755;1998;16753;NA;63380;2390;2020-12-21;23526
2020-12-20;"Bratislavský kraj";180;634;54;688;NA;63380;234;2020-12-20;21136
2020-12-19;"Bratislavský kraj";396;3150;129;3279;NA;63380;525;2020-12-19;20902
2020-12-18;"Bratislavský kraj";306;10477;413;10890;NA;63380;719;2020-12-18;20377
2020-12-17;"Bratislavský kraj";502;9964;403;10367;NA;63380;905;2020-12-17;19658
2020-12-16;"Bratislavský kraj";282;10408;456;10864;NA;63380;738;2020-12-16;18753
2020-12-15;"Bratislavský kraj";423;10682;488;11170;NA;63380;911;2020-12-15;18015
2020-12-14;"Bratislavský kraj";279;6549;306;6855;NA;63380;585;2020-12-14;17104
2020-12-13;"Bratislavský kraj";125;108;7;115;NA;63380;132;2020-12-13;16519
2020-12-12;"Bratislavský kraj";361;3734;157;3891;NA;63380;518;2020-12-12;16387
2020-12-11;"Bratislavský kraj";326;6967;302;7269;NA;63380;628;2020-12-11;15869
2020-12-10;"Bratislavský kraj";286;5088;222;5310;NA;63380;508;2020-12-10;15241
2020-12-09;"Bratislavský kraj";382;4778;188;4966;NA;63380;570;2020-12-09;14733
2020-12-08;"Bratislavský kraj";234;5900;213;6113;NA;63380;447;2020-12-08;14163
2020-12-07;"Bratislavský kraj";272;4345;168;4513;NA;63380;440;2020-12-07;13716
2020-12-06;"Bratislavský kraj";61;1584;52;1636;NA;63380;113;2020-12-06;13276
2020-12-05;"Bratislavský kraj";266;2134;40;2174;NA;63380;306;2020-12-05;13163
2020-12-04;"Bratislavský kraj";200;4511;104;4615;NA;63380;304;2020-12-04;12857
2020-12-03;"Bratislavský kraj";213;5036;102;5138;NA;63380;315;2020-12-03;12553
2020-12-02;"Bratislavský kraj";204;2504;83;2587;NA;63380;287;2020-12-02;12238
2020-12-01;"Bratislavský kraj";255;3305;168;3473;NA;63380;423;2020-12-01;11951
2020-11-30;"Bratislavský kraj";152;2061;123;2184;NA;63380;275;2020-11-30;11528
2020-11-29;"Bratislavský kraj";52;41;21;62;NA;63380;73;2020-11-29;11253
2020-11-28;"Bratislavský kraj";232;1983;21;2004;NA;63380;253;2020-11-28;11180
2020-11-27;"Bratislavský kraj";54;1198;29;1227;NA;63380;83;2020-11-27;10927
2020-11-26;"Bratislavský kraj";129;1114;25;1139;NA;63380;154;2020-11-26;10844
2020-11-25;"Bratislavský kraj";140;1133;31;1164;NA;63380;171;2020-11-25;10690
2020-11-24;"Bratislavský kraj";81;2988;67;3055;NA;63380;148;2020-11-24;10519
2020-11-23;"Bratislavský kraj";67;405;13;418;NA;63380;80;2020-11-23;10371
2020-11-22;"Bratislavský kraj";36;81;7;88;NA;63380;43;2020-11-22;10291
2020-11-21;"Bratislavský kraj";109;2126;47;2173;NA;63380;156;2020-11-21;10248
2020-11-20;"Bratislavský kraj";118;2869;48;2917;NA;63380;166;2020-11-20;10092
2020-11-19;"Bratislavský kraj";173;987;29;1016;NA;63380;202;2020-11-19;9926
2020-11-18;"Bratislavský kraj";118;616;75;691;NA;63380;193;2020-11-18;9724
2020-11-17;"Bratislavský kraj";108;928;23;951;NA;63380;131;2020-11-17;9531
2020-11-16;"Bratislavský kraj";82;651;9;660;NA;63380;91;2020-11-16;9400
2020-11-15;"Bratislavský kraj";47;236;0;236;NA;63380;47;2020-11-15;9309
2020-11-14;"Bratislavský kraj";53;1834;15;1849;NA;63380;68;2020-11-14;9262
2020-11-13;"Bratislavský kraj";94;2096;21;2117;NA;63380;115;2020-11-13;9194
2020-11-12;"Bratislavský kraj";141;1727;6;1733;NA;63380;147;2020-11-12;9079
2020-11-11;"Bratislavský kraj";159;1429;12;1441;NA;63380;171;2020-11-11;8932
2020-11-10;"Bratislavský kraj";136;805;14;819;NA;63380;150;2020-11-10;8761
2020-11-09;"Bratislavský kraj";70;466;1;467;NA;63380;71;2020-11-09;8611
2020-11-08;"Bratislavský kraj";82;869;6;875;NA;63380;88;2020-11-08;8540
2020-11-07;"Bratislavský kraj";88;4039;17;4056;NA;63380;105;2020-11-07;8452
2020-11-06;"Bratislavský kraj";281;6441;25;6466;NA;63380;306;2020-11-06;8347
2020-11-05;"Bratislavský kraj";175;476;11;487;NA;63380;186;2020-11-05;8041
2020-11-04;"Bratislavský kraj";65;411;10;421;NA;63380;75;2020-11-04;7855
2020-11-03;"Bratislavský kraj";251;944;5;949;NA;63380;256;2020-11-03;7780
2020-11-02;"Bratislavský kraj";202;3365;22;3387;NA;63380;224;2020-11-02;7524
2020-11-01;"Bratislavský kraj";227;8694;39;8733;NA;63380;266;2020-11-01;7300
2020-10-31;"Bratislavský kraj";173;22407;123;22530;NA;63380;296;2020-10-31;7034
2020-10-30;"Bratislavský kraj";158;17350;138;17488;NA;63380;296;2020-10-30;6738
2020-10-29;"Bratislavský kraj";262;116;4;120;NA;63380;266;2020-10-29;6442
2020-10-28;"Bratislavský kraj";220;260;15;275;NA;63380;235;2020-10-28;6176
2020-10-27;"Bratislavský kraj";256;145;4;149;NA;63380;260;2020-10-27;5941
2020-10-26;"Bratislavský kraj";123;229;11;240;NA;63380;134;2020-10-26;5681
2020-10-25;"Bratislavský kraj";152;33;2;35;NA;63380;154;2020-10-25;5547
2020-10-24;"Bratislavský kraj";170;221;6;227;NA;63380;176;2020-10-24;5393
2020-10-23;"Bratislavský kraj";151;144;8;152;NA;63380;159;2020-10-23;5217
2020-10-22;"Bratislavský kraj";192;204;15;219;NA;63380;207;2020-10-22;5058
2020-10-21;"Bratislavský kraj";66;90;6;96;NA;63380;72;2020-10-21;4851
2020-10-20;"Bratislavský kraj";183;97;4;101;NA;63380;187;2020-10-20;4779
2020-10-19;"Bratislavský kraj";148;80;3;83;NA;63380;151;2020-10-19;4592
2020-10-18;"Bratislavský kraj";75;92;0;92;NA;63380;75;2020-10-18;4441
2020-10-17;"Bratislavský kraj";136;0;0;0;NA;63380;136;2020-10-17;4366
2020-10-16;"Bratislavský kraj";103;14;1;15;NA;63380;104;2020-10-16;4230
2020-10-15;"Bratislavský kraj";135;6;1;7;NA;63380;136;2020-10-15;4126
2020-10-14;"Bratislavský kraj";127;4;0;4;NA;63380;127;2020-10-14;3990
2020-10-13;"Bratislavský kraj";86;108;8;116;NA;63380;94;2020-10-13;3863
2020-10-12;"Bratislavský kraj";46;0;0;0;NA;63380;46;2020-10-12;3769
2020-10-11;"Bratislavský kraj";80;0;0;0;NA;63380;80;2020-10-11;3723
2020-10-10;"Bratislavský kraj";55;0;0;0;NA;63380;55;2020-10-10;3643
2020-10-09;"Bratislavský kraj";148;0;0;0;NA;63380;148;2020-10-09;3588
2020-10-08;"Bratislavský kraj";100;0;0;0;NA;63380;100;2020-10-08;3440
2020-10-07;"Bratislavský kraj";107;0;0;0;NA;63380;107;2020-10-07;3340
2020-10-06;"Bratislavský kraj";108;0;0;0;NA;63380;108;2020-10-06;3233
2020-10-05;"Bratislavský kraj";30;0;0;0;NA;63380;30;2020-10-05;3125
2020-10-04;"Bratislavský kraj";49;0;0;0;NA;63380;49;2020-10-04;3095
2020-10-03;"Bratislavský kraj";82;0;0;0;NA;63380;82;2020-10-03;3046
2020-10-02;"Bratislavský kraj";101;0;0;0;NA;63380;101;2020-10-02;2964
2020-10-01;"Bratislavský kraj";72;0;0;0;NA;63380;72;2020-10-01;2863
2020-09-30;"Bratislavský kraj";91;0;0;0;NA;63380;91;2020-09-30;2791
2020-09-29;"Bratislavský kraj";74;0;0;0;NA;63380;74;2020-09-29;2700
2020-09-28;"Bratislavský kraj";29;0;0;0;NA;63380;29;2020-09-28;2626
2020-09-27;"Bratislavský kraj";48;0;0;0;NA;63380;48;2020-09-27;2597
2020-09-26;"Bratislavský kraj";86;0;0;0;NA;63380;86;2020-09-26;2549
2020-09-25;"Bratislavský kraj";97;0;0;0;NA;63380;97;2020-09-25;2463
2020-09-24;"Bratislavský kraj";73;0;0;0;NA;63380;73;2020-09-24;2366
2020-09-23;"Bratislavský kraj";55;0;0;0;NA;63380;55;2020-09-23;2293
2020-09-22;"Bratislavský kraj";81;0;0;0;NA;63380;81;2020-09-22;2238
2020-09-21;"Bratislavský kraj";32;0;0;0;NA;63380;32;2020-09-21;2157
2020-09-20;"Bratislavský kraj";25;0;0;0;NA;63380;25;2020-09-20;2125
2020-09-19;"Bratislavský kraj";59;0;0;0;NA;63380;59;2020-09-19;2100
2020-09-18;"Bratislavský kraj";42;0;0;0;NA;63380;42;2020-09-18;2041
2020-09-17;"Bratislavský kraj";52;0;0;0;NA;63380;52;2020-09-17;1999
2020-09-16;"Bratislavský kraj";32;0;0;0;NA;63380;32;2020-09-16;1947
2020-09-15;"Bratislavský kraj";26;0;0;0;NA;63380;26;2020-09-15;1915
2020-09-14;"Bratislavský kraj";24;0;0;0;NA;63380;24;2020-09-14;1889
2020-09-13;"Bratislavský kraj";11;0;0;0;NA;63380;11;2020-09-13;1865
2020-09-12;"Bratislavský kraj";24;0;0;0;NA;63380;24;2020-09-12;1854
2020-09-11;"Bratislavský kraj";50;0;0;0;NA;63380;50;2020-09-11;1830
2020-09-10;"Bratislavský kraj";47;0;0;0;NA;63380;47;2020-09-10;1780
2020-09-09;"Bratislavský kraj";40;0;0;0;NA;63380;40;2020-09-09;1733
2020-09-08;"Bratislavský kraj";58;0;0;0;NA;63380;58;2020-09-08;1693
2020-09-07;"Bratislavský kraj";39;0;0;0;NA;63380;39;2020-09-07;1635
2020-09-06;"Bratislavský kraj";11;0;0;0;NA;63380;11;2020-09-06;1596
2020-09-05;"Bratislavský kraj";37;0;0;0;NA;63380;37;2020-09-05;1585
2020-09-04;"Bratislavský kraj";87;0;0;0;NA;63380;87;2020-09-04;1548
2020-09-03;"Bratislavský kraj";51;0;0;0;NA;63380;51;2020-09-03;1461
2021-02-18;"Košický kraj";397;15446;285;15731;37189;63809;682;2021-02-18;63809
2021-02-17;"Košický kraj";322;17173;423;17596;NA;63809;745;2021-02-17;63127
2021-02-16;"Košický kraj";600;21229;448;21677;NA;63809;1048;2021-02-16;62382
2021-02-15;"Košický kraj";216;24107;349;24456;NA;63809;565;2021-02-15;61334
2021-02-14;"Košický kraj";241;56518;517;57035;NA;63809;758;2021-02-14;60769
2021-02-13;"Košický kraj";206;90308;734;91042;NA;63809;940;2021-02-13;60011
2021-02-12;"Košický kraj";448;48817;590;49407;NA;63809;1038;2021-02-12;59071
2021-02-11;"Košický kraj";435;14069;320;14389;NA;63809;755;2021-02-11;58033
2021-02-10;"Košický kraj";360;19926;434;20360;NA;63809;794;2021-02-10;57278
2021-02-09;"Košický kraj";545;23520;442;23962;NA;63809;987;2021-02-09;56484
2021-02-08;"Košický kraj";237;28365;433;28798;NA;63809;670;2021-02-08;55497
2021-02-07;"Košický kraj";208;56347;605;56952;NA;63809;813;2021-02-07;54827
2021-02-06;"Košický kraj";318;100588;858;101446;NA;63809;1176;2021-02-06;54014
2021-02-05;"Košický kraj";384;41709;487;42196;NA;63809;871;2021-02-05;52838
2021-02-04;"Košický kraj";391;14112;358;14470;NA;63809;749;2021-02-04;51967
2021-02-03;"Košický kraj";296;32359;1101;33460;NA;63809;1397;2021-02-03;51218
2021-02-02;"Košický kraj";473;23281;429;23710;NA;63809;902;2021-02-02;49821
2021-02-01;"Košický kraj";415;20014;341;20355;NA;63809;756;2021-02-01;48919
2021-01-31;"Košický kraj";142;53674;585;54259;NA;63809;727;2021-01-31;48163
2021-01-30;"Košický kraj";320;76985;673;77658;NA;63809;993;2021-01-30;47436
2021-01-29;"Košický kraj";258;36814;450;37264;NA;63809;708;2021-01-29;46443
2021-01-28;"Košický kraj";540;8833;233;9066;NA;63809;773;2021-01-28;45735
2021-01-27;"Košický kraj";265;7245;195;7440;NA;63809;460;2021-01-27;44962
2021-01-26;"Košický kraj";530;13909;240;14149;NA;63809;770;2021-01-26;44502
2021-01-25;"Košický kraj";226;27207;446;27653;NA;63809;672;2021-01-25;43732
2021-01-24;"Košický kraj";150;44453;592;45045;NA;63809;742;2021-01-24;43060
2021-01-23;"Košický kraj";232;82016;843;82859;NA;63809;1075;2021-01-23;42318
2021-01-22;"Košický kraj";316;19674;262;19936;NA;63809;578;2021-01-22;41243
2021-01-21;"Košický kraj";274;13644;159;13803;NA;63809;433;2021-01-21;40665
2021-01-20;"Košický kraj";374;10521;194;10715;NA;63809;568;2021-01-20;40232
2021-01-19;"Košický kraj";248;10904;194;11098;NA;63809;442;2021-01-19;39664
2021-01-18;"Košický kraj";333;5408;203;5611;NA;63809;536;2021-01-18;39222
2021-01-17;"Košický kraj";155;535;14;549;NA;63809;169;2021-01-17;38686
2021-01-16;"Košický kraj";153;1403;47;1450;NA;63809;200;2021-01-16;38517
2021-01-15;"Košický kraj";308;6271;210;6481;NA;63809;518;2021-01-15;38317
2021-01-14;"Košický kraj";358;5331;213;5544;NA;63809;571;2021-01-14;37799
2021-01-13;"Košický kraj";421;4781;218;4999;NA;63809;639;2021-01-13;37228
2021-01-12;"Košický kraj";482;6555;247;6802;NA;63809;729;2021-01-12;36589
2021-01-11;"Košický kraj";309;7770;295;8065;NA;63809;604;2021-01-11;35860
2021-01-10;"Košický kraj";193;134;6;140;NA;63809;199;2021-01-10;35256
2021-01-09;"Košický kraj";469;1134;45;1179;NA;63809;514;2021-01-09;35057
2021-01-08;"Košický kraj";551;7944;377;8321;NA;63809;928;2021-01-08;34543
2021-01-07;"Košický kraj";251;6136;404;6540;NA;63809;655;2021-01-07;33615
2021-01-06;"Košický kraj";442;429;33;462;NA;63809;475;2021-01-06;32960
2021-01-05;"Košický kraj";584;7591;515;8106;NA;63809;1099;2021-01-05;32485
2021-01-04;"Košický kraj";407;6822;690;7512;NA;63809;1097;2021-01-04;31386
2021-01-03;"Košický kraj";118;661;22;683;NA;63809;140;2021-01-03;30289
2021-01-02;"Košický kraj";88;440;52;492;NA;63809;140;2021-01-02;30149
2021-01-01;"Košický kraj";398;725;49;774;NA;63809;447;2021-01-01;30009
2020-12-31;"Košický kraj";625;7877;461;8338;NA;63809;1086;2020-12-31;29562
2020-12-30;"Košický kraj";590;6477;412;6889;NA;63809;1002;2020-12-30;28476
2020-12-29;"Košický kraj";419;7573;605;8178;NA;63809;1024;2020-12-29;27474
2020-12-28;"Košický kraj";356;8296;804;9100;NA;63809;1160;2020-12-28;26450
2020-12-27;"Košický kraj";159;147;16;163;NA;63809;175;2020-12-27;25290
2020-12-26;"Košický kraj";163;274;23;297;NA;63809;186;2020-12-26;25115
2020-12-25;"Košický kraj";237;140;10;150;NA;63809;247;2020-12-25;24929
2020-12-24;"Košický kraj";564;1470;90;1560;NA;63809;654;2020-12-24;24682
2020-12-23;"Košický kraj";304;7942;354;8296;NA;63809;658;2020-12-23;24028
2020-12-22;"Košický kraj";438;7920;459;8379;NA;63809;897;2020-12-22;23370
2020-12-21;"Košický kraj";405;6984;509;7493;NA;63809;914;2020-12-21;22473
2020-12-20;"Košický kraj";215;48;8;56;NA;63809;223;2020-12-20;21559
2020-12-19;"Košický kraj";207;1148;59;1207;NA;63809;266;2020-12-19;21336
2020-12-18;"Košický kraj";310;8484;326;8810;NA;63809;636;2020-12-18;21070
2020-12-17;"Košický kraj";463;5292;255;5547;NA;63809;718;2020-12-17;20434
2020-12-16;"Košický kraj";455;5898;316;6214;NA;63809;771;2020-12-16;19716
2020-12-15;"Košický kraj";319;5086;338;5424;NA;63809;657;2020-12-15;18945
2020-12-14;"Košický kraj";256;2893;239;3132;NA;63809;495;2020-12-14;18288
2020-12-13;"Košický kraj";47;181;2;183;NA;63809;49;2020-12-13;17793
2020-12-12;"Košický kraj";369;1587;118;1705;NA;63809;487;2020-12-12;17744
2020-12-11;"Košický kraj";355;5461;258;5719;NA;63809;613;2020-12-11;17257
2020-12-10;"Košický kraj";283;4064;176;4240;NA;63809;459;2020-12-10;16644
2020-12-09;"Košický kraj";279;3786;166;3952;NA;63809;445;2020-12-09;16185
2020-12-08;"Košický kraj";226;4105;355;4460;NA;63809;581;2020-12-08;15740
2020-12-07;"Košický kraj";270;2111;103;2214;NA;63809;373;2020-12-07;15159
2020-12-06;"Košický kraj";121;97;20;117;NA;63809;141;2020-12-06;14786
2020-12-05;"Košický kraj";90;1096;48;1144;NA;63809;138;2020-12-05;14645
2020-12-04;"Košický kraj";224;2680;82;2762;NA;63809;306;2020-12-04;14507
2020-12-03;"Košický kraj";211;7717;173;7890;NA;63809;384;2020-12-03;14201
2020-12-02;"Košický kraj";194;10881;655;11536;NA;63809;849;2020-12-02;13817
2020-12-01;"Košický kraj";178;2237;124;2361;NA;63809;302;2020-12-01;12968
2020-11-30;"Košický kraj";171;3754;62;3816;NA;63809;233;2020-11-30;12666
2020-11-29;"Košický kraj";31;287;16;303;NA;63809;47;2020-11-29;12433
2020-11-28;"Košický kraj";69;721;52;773;NA;63809;121;2020-11-28;12386
2020-11-27;"Košický kraj";149;2729;74;2803;NA;63809;223;2020-11-27;12265
2020-11-26;"Košický kraj";239;1090;55;1145;NA;63809;294;2020-11-26;12042
2020-11-25;"Košický kraj";237;1664;122;1786;NA;63809;359;2020-11-25;11748
2020-11-24;"Košický kraj";196;1871;64;1935;NA;63809;260;2020-11-24;11389
2020-11-23;"Košický kraj";51;3737;54;3791;NA;63809;105;2020-11-23;11129
2020-11-22;"Košický kraj";57;28;3;31;NA;63809;60;2020-11-22;11024
2020-11-21;"Košický kraj";87;858;36;894;NA;63809;123;2020-11-21;10964
2020-11-20;"Košický kraj";176;2989;45;3034;NA;63809;221;2020-11-20;10841
2020-11-19;"Košický kraj";206;1648;40;1688;NA;63809;246;2020-11-19;10620
2020-11-18;"Košický kraj";122;443;16;459;NA;63809;138;2020-11-18;10374
2020-11-17;"Košický kraj";152;82;9;91;NA;63809;161;2020-11-17;10236
2020-11-16;"Košický kraj";114;531;24;555;NA;63809;138;2020-11-16;10075
2020-11-15;"Košický kraj";15;338;7;345;NA;63809;22;2020-11-15;9937
2020-11-14;"Košický kraj";234;520;12;532;NA;63809;246;2020-11-14;9915
2020-11-13;"Košický kraj";207;664;29;693;NA;63809;236;2020-11-13;9669
2020-11-12;"Košický kraj";192;736;13;749;NA;63809;205;2020-11-12;9433
2020-11-11;"Košický kraj";301;593;7;600;NA;63809;308;2020-11-11;9228
2020-11-10;"Košický kraj";190;541;11;552;NA;63809;201;2020-11-10;8920
2020-11-09;"Košický kraj";129;380;5;385;NA;63809;134;2020-11-09;8719
2020-11-08;"Košický kraj";78;1298;8;1306;NA;63809;86;2020-11-08;8585
2020-11-07;"Košický kraj";192;3909;22;3931;NA;63809;214;2020-11-07;8499
2020-11-06;"Košický kraj";195;5310;34;5344;NA;63809;229;2020-11-06;8285
2020-11-05;"Košický kraj";342;330;31;361;NA;63809;373;2020-11-05;8056
2020-11-04;"Košický kraj";101;154;6;160;NA;63809;107;2020-11-04;7683
2020-11-03;"Košický kraj";358;1122;13;1135;NA;63809;371;2020-11-03;7576
2020-11-02;"Košický kraj";111;4368;51;4419;NA;63809;162;2020-11-02;7205
2020-11-01;"Košický kraj";346;6522;34;6556;NA;63809;380;2020-11-01;7043
2020-10-31;"Košický kraj";82;13810;105;13915;NA;63809;187;2020-10-31;6663
2020-10-30;"Košický kraj";379;2835;27;2862;NA;63809;406;2020-10-30;6476
2020-10-29;"Košický kraj";333;983;13;996;NA;63809;346;2020-10-29;6070
2020-10-28;"Košický kraj";224;305;13;318;NA;63809;237;2020-10-28;5724
2020-10-27;"Košický kraj";386;439;21;460;NA;63809;407;2020-10-27;5487
2020-10-26;"Košický kraj";56;206;10;216;NA;63809;66;2020-10-26;5080
2020-10-25;"Košický kraj";154;79;2;81;NA;63809;156;2020-10-25;5014
2020-10-24;"Košický kraj";313;113;15;128;NA;63809;328;2020-10-24;4858
2020-10-23;"Košický kraj";315;331;8;339;NA;63809;323;2020-10-23;4530
2020-10-22;"Košický kraj";349;530;16;546;NA;63809;365;2020-10-22;4207
2020-10-21;"Košický kraj";129;84;2;86;NA;63809;131;2020-10-21;3842
2020-10-20;"Košický kraj";181;14;1;15;NA;63809;182;2020-10-20;3711
2020-10-19;"Košický kraj";64;10;0;10;NA;63809;64;2020-10-19;3529
2020-10-18;"Košický kraj";158;0;0;0;NA;63809;158;2020-10-18;3465
2020-10-17;"Košický kraj";142;0;0;0;NA;63809;142;2020-10-17;3307
2020-10-16;"Košický kraj";206;19;0;19;NA;63809;206;2020-10-16;3165
2020-10-15;"Košický kraj";177;19;5;24;NA;63809;182;2020-10-15;2959
2020-10-14;"Košický kraj";211;8;0;8;NA;63809;211;2020-10-14;2777
2020-10-13;"Košický kraj";179;80;3;83;NA;63809;182;2020-10-13;2566
2020-10-12;"Košický kraj";74;0;0;0;NA;63809;74;2020-10-12;2384
2020-10-11;"Košický kraj";121;0;0;0;NA;63809;121;2020-10-11;2310
2020-10-10;"Košický kraj";70;0;0;0;NA;63809;70;2020-10-10;2189
2020-10-09;"Košický kraj";188;0;0;0;NA;63809;188;2020-10-09;2119
2020-10-08;"Košický kraj";102;0;0;0;NA;63809;102;2020-10-08;1931
2020-10-07;"Košický kraj";158;0;0;0;NA;63809;158;2020-10-07;1829
2020-10-06;"Košický kraj";70;0;0;0;NA;63809;70;2020-10-06;1671
2020-10-05;"Košický kraj";39;0;0;0;NA;63809;39;2020-10-05;1601
2020-10-04;"Košický kraj";45;0;0;0;NA;63809;45;2020-10-04;1562
2020-10-03;"Košický kraj";105;0;0;0;NA;63809;105;2020-10-03;1517
2020-10-02;"Košický kraj";57;0;0;0;NA;63809;57;2020-10-02;1412
2020-10-01;"Košický kraj";69;0;0;0;NA;63809;69;2020-10-01;1355
2020-09-30;"Košický kraj";95;0;0;0;NA;63809;95;2020-09-30;1286
2020-09-29;"Košický kraj";75;0;0;0;NA;63809;75;2020-09-29;1191
2020-09-28;"Košický kraj";19;0;0;0;NA;63809;19;2020-09-28;1116
2020-09-27;"Košický kraj";21;0;0;0;NA;63809;21;2020-09-27;1097
2020-09-26;"Košický kraj";53;0;0;0;NA;63809;53;2020-09-26;1076
2020-09-25;"Košický kraj";72;0;0;0;NA;63809;72;2020-09-25;1023
2020-09-24;"Košický kraj";35;0;0;0;NA;63809;35;2020-09-24;951
2020-09-23;"Košický kraj";23;0;0;0;NA;63809;23;2020-09-23;916
2020-09-22;"Košický kraj";39;0;0;0;NA;63809;39;2020-09-22;893
2020-09-21;"Košický kraj";5;0;0;0;NA;63809;5;2020-09-21;854
2020-09-20;"Košický kraj";3;0;0;0;NA;63809;3;2020-09-20;849
2020-09-19;"Košický kraj";13;0;0;0;NA;63809;13;2020-09-19;846
2020-09-18;"Košický kraj";20;0;0;0;NA;63809;20;2020-09-18;833
2020-09-17;"Košický kraj";22;0;0;0;NA;63809;22;2020-09-17;813
2020-09-16;"Košický kraj";12;0;0;0;NA;63809;12;2020-09-16;791
2020-09-15;"Košický kraj";10;0;0;0;NA;63809;10;2020-09-15;779
2020-09-14;"Košický kraj";6;0;0;0;NA;63809;6;2020-09-14;769
2020-09-13;"Košický kraj";3;0;0;0;NA;63809;3;2020-09-13;763
2020-09-12;"Košický kraj";16;0;0;0;NA;63809;16;2020-09-12;760
2020-09-11;"Košický kraj";20;0;0;0;NA;63809;20;2020-09-11;744
2020-09-10;"Košický kraj";11;0;0;0;NA;63809;11;2020-09-10;724
2020-09-09;"Košický kraj";37;0;0;0;NA;63809;37;2020-09-09;713
2020-09-08;"Košický kraj";10;0;0;0;NA;63809;10;2020-09-08;676
2020-09-07;"Košický kraj";4;0;0;0;NA;63809;4;2020-09-07;666
2020-09-06;"Košický kraj";2;0;0;0;NA;63809;2;2020-09-06;662
2020-09-05;"Košický kraj";10;0;0;0;NA;63809;10;2020-09-05;660
2020-09-04;"Košický kraj";14;0;0;0;NA;63809;14;2020-09-04;650
2020-09-03;"Košický kraj";22;0;0;0;NA;63809;22;2020-09-03;636
2021-02-18;"Nitriansky kraj";202;12976;198;13174;32748;74680;400;2021-02-18;74680
2021-02-17;"Nitriansky kraj";198;10465;262;10727;NA;74680;460;2021-02-17;74280
2021-02-16;"Nitriansky kraj";284;23454;383;23837;NA;74680;667;2021-02-16;73820
2021-02-15;"Nitriansky kraj";122;24119;431;24550;NA;74680;553;2021-02-15;73153
2021-02-14;"Nitriansky kraj";8;33732;192;33924;NA;74680;200;2021-02-14;72600
2021-02-13;"Nitriansky kraj";127;98724;545;99269;NA;74680;672;2021-02-13;72400
2021-02-12;"Nitriansky kraj";162;32762;398;33160;NA;74680;560;2021-02-12;71728
2021-02-11;"Nitriansky kraj";195;12365;271;12636;NA;74680;466;2021-02-11;71168
2021-02-10;"Nitriansky kraj";186;17614;642;18256;NA;74680;828;2021-02-10;70702
2021-02-09;"Nitriansky kraj";260;18596;382;18978;NA;74680;642;2021-02-09;69874
2021-02-08;"Nitriansky kraj";177;43646;657;44303;NA;74680;834;2021-02-08;69232
2021-02-07;"Nitriansky kraj";20;48758;467;49225;NA;74680;487;2021-02-07;68398
2021-02-06;"Nitriansky kraj";129;95190;828;96018;NA;74680;957;2021-02-06;67911
2021-02-05;"Nitriansky kraj";244;34291;616;34907;NA;74680;860;2021-02-05;66954
2021-02-04;"Nitriansky kraj";308;15655;500;16155;NA;74680;808;2021-02-04;66094
2021-02-03;"Nitriansky kraj";191;10708;330;11038;NA;74680;521;2021-02-03;65286
2021-02-02;"Nitriansky kraj";327;17393;365;17758;NA;74680;692;2021-02-02;64765
2021-02-01;"Nitriansky kraj";221;24322;448;24770;NA;74680;669;2021-02-01;64073
2021-01-31;"Nitriansky kraj";9;22581;240;22821;NA;74680;249;2021-01-31;63404
2021-01-30;"Nitriansky kraj";152;78143;768;78911;NA;74680;920;2021-01-30;63155
2021-01-29;"Nitriansky kraj";135;23548;475;24023;NA;74680;610;2021-01-29;62235
2021-01-28;"Nitriansky kraj";269;10951;372;11323;NA;74680;641;2021-01-28;61625
2021-01-27;"Nitriansky kraj";235;13314;380;13694;NA;74680;615;2021-01-27;60984
2021-01-26;"Nitriansky kraj";345;17175;461;17636;NA;74680;806;2021-01-26;60369
2021-01-25;"Nitriansky kraj";201;23658;443;24101;NA;74680;644;2021-01-25;59563
2021-01-24;"Nitriansky kraj";12;64769;642;65411;NA;74680;654;2021-01-24;58919
2021-01-23;"Nitriansky kraj";277;104017;1580;105597;NA;74680;1857;2021-01-23;58265
2021-01-22;"Nitriansky kraj";139;35232;607;35839;NA;74680;746;2021-01-22;56408
2021-01-21;"Nitriansky kraj";305;14309;406;14715;NA;74680;711;2021-01-21;55662
2021-01-20;"Nitriansky kraj";326;11510;612;12122;NA;74680;938;2021-01-20;54951
2021-01-19;"Nitriansky kraj";344;10778;623;11401;NA;74680;967;2021-01-19;54013
2021-01-18;"Nitriansky kraj";367;8479;494;8973;NA;74680;861;2021-01-18;53046
2021-01-17;"Nitriansky kraj";97;15061;275;15336;NA;74680;372;2021-01-17;52185
2021-01-16;"Nitriansky kraj";64;36365;654;37019;NA;74680;718;2021-01-16;51813
2021-01-15;"Nitriansky kraj";373;15666;465;16131;NA;74680;838;2021-01-15;51095
2021-01-14;"Nitriansky kraj";627;10268;440;10708;NA;74680;1067;2021-01-14;50257
2021-01-13;"Nitriansky kraj";663;9167;497;9664;NA;74680;1160;2021-01-13;49190
2021-01-12;"Nitriansky kraj";642;8992;574;9566;NA;74680;1216;2021-01-12;48030
2021-01-11;"Nitriansky kraj";422;8175;515;8690;NA;74680;937;2021-01-11;46814
2021-01-10;"Nitriansky kraj";44;19841;730;20571;NA;74680;774;2021-01-10;45877
2021-01-09;"Nitriansky kraj";532;37075;1090;38165;NA;74680;1622;2021-01-09;45103
2021-01-08;"Nitriansky kraj";817;14004;719;14723;NA;74680;1536;2021-01-08;43481
2021-01-07;"Nitriansky kraj";438;10465;784;11249;NA;74680;1222;2021-01-07;41945
2021-01-06;"Nitriansky kraj";259;3347;239;3586;NA;74680;498;2021-01-06;40723
2021-01-05;"Nitriansky kraj";732;8815;1204;10019;NA;74680;1936;2021-01-05;40225
2021-01-04;"Nitriansky kraj";362;8247;1270;9517;NA;74680;1632;2021-01-04;38289
2021-01-03;"Nitriansky kraj";42;84;20;104;NA;74680;62;2021-01-03;36657
2021-01-02;"Nitriansky kraj";249;1090;26;1116;NA;74680;275;2021-01-02;36595
2021-01-01;"Nitriansky kraj";119;671;94;765;NA;74680;213;2021-01-01;36320
2020-12-31;"Nitriansky kraj";786;7646;962;8608;NA;74680;1748;2020-12-31;36107
2020-12-30;"Nitriansky kraj";1094;9430;1160;10590;NA;74680;2254;2020-12-30;34359
2020-12-29;"Nitriansky kraj";607;8175;1286;9461;NA;74680;1893;2020-12-29;32105
2020-12-28;"Nitriansky kraj";83;6881;1271;8152;NA;74680;1354;2020-12-28;30212
2020-12-27;"Nitriansky kraj";22;36;2;38;NA;74680;24;2020-12-27;28858
2020-12-26;"Nitriansky kraj";54;297;56;353;NA;74680;110;2020-12-26;28834
2020-12-25;"Nitriansky kraj";35;47;5;52;NA;74680;40;2020-12-25;28724
2020-12-24;"Nitriansky kraj";514;1861;176;2037;NA;74680;690;2020-12-24;28684
2020-12-23;"Nitriansky kraj";349;15214;843;16057;NA;74680;1192;2020-12-23;27994
2020-12-22;"Nitriansky kraj";673;10915;994;11909;NA;74680;1667;2020-12-22;26802
2020-12-21;"Nitriansky kraj";128;7719;976;8695;NA;74680;1104;2020-12-21;25135
2020-12-20;"Nitriansky kraj";77;50;10;60;NA;74680;87;2020-12-20;24031
2020-12-19;"Nitriansky kraj";262;2259;159;2418;NA;74680;421;2020-12-19;23944
2020-12-18;"Nitriansky kraj";512;8320;551;8871;NA;74680;1063;2020-12-18;23523
2020-12-17;"Nitriansky kraj";586;6705;514;7219;NA;74680;1100;2020-12-17;22460
2020-12-16;"Nitriansky kraj";357;8670;546;9216;NA;74680;903;2020-12-16;21360
2020-12-15;"Nitriansky kraj";461;9365;769;10134;NA;74680;1230;2020-12-15;20457
2020-12-14;"Nitriansky kraj";217;8089;827;8916;NA;74680;1044;2020-12-14;19227
2020-12-13;"Nitriansky kraj";12;9;1;10;NA;74680;13;2020-12-13;18183
2020-12-12;"Nitriansky kraj";341;1832;125;1957;NA;74680;466;2020-12-12;18170
2020-12-11;"Nitriansky kraj";409;6193;465;6658;NA;74680;874;2020-12-11;17704
2020-12-10;"Nitriansky kraj";360;5030;326;5356;NA;74680;686;2020-12-10;16830
2020-12-09;"Nitriansky kraj";362;5726;542;6268;NA;74680;904;2020-12-09;16144
2020-12-08;"Nitriansky kraj";340;8766;611;9377;NA;74680;951;2020-12-08;15240
2020-12-07;"Nitriansky kraj";139;6243;573;6816;NA;74680;712;2020-12-07;14289
2020-12-06;"Nitriansky kraj";15;89;4;93;NA;74680;19;2020-12-06;13577
2020-12-05;"Nitriansky kraj";136;618;14;632;NA;74680;150;2020-12-05;13558
2020-12-04;"Nitriansky kraj";232;3047;86;3133;NA;74680;318;2020-12-04;13408
2020-12-03;"Nitriansky kraj";248;2599;127;2726;NA;74680;375;2020-12-03;13090
2020-12-02;"Nitriansky kraj";252;3733;163;3896;NA;74680;415;2020-12-02;12715
2020-12-01;"Nitriansky kraj";331;2941;133;3074;NA;74680;464;2020-12-01;12300
2020-11-30;"Nitriansky kraj";91;4836;207;5043;NA;74680;298;2020-11-30;11836
2020-11-29;"Nitriansky kraj";3;620;42;662;NA;74680;45;2020-11-29;11538
2020-11-28;"Nitriansky kraj";135;892;31;923;NA;74680;166;2020-11-28;11493
2020-11-27;"Nitriansky kraj";177;1229;43;1272;NA;74680;220;2020-11-27;11327
2020-11-26;"Nitriansky kraj";191;2262;57;2319;NA;74680;248;2020-11-26;11107
2020-11-25;"Nitriansky kraj";325;1993;66;2059;NA;74680;391;2020-11-25;10859
2020-11-24;"Nitriansky kraj";147;1141;50;1191;NA;74680;197;2020-11-24;10468
2020-11-23;"Nitriansky kraj";102;9562;206;9768;NA;74680;308;2020-11-23;10271
2020-11-22;"Nitriansky kraj";7;0;0;0;NA;74680;7;2020-11-22;9963
2020-11-21;"Nitriansky kraj";86;1083;38;1121;NA;74680;124;2020-11-21;9956
2020-11-20;"Nitriansky kraj";264;4020;101;4121;NA;74680;365;2020-11-20;9832
2020-11-19;"Nitriansky kraj";185;2953;133;3086;NA;74680;318;2020-11-19;9467
2020-11-18;"Nitriansky kraj";188;2109;77;2186;NA;74680;265;2020-11-18;9149
2020-11-17;"Nitriansky kraj";178;596;29;625;NA;74680;207;2020-11-17;8884
2020-11-16;"Nitriansky kraj";139;1836;75;1911;NA;74680;214;2020-11-16;8677
2020-11-15;"Nitriansky kraj";14;10;1;11;NA;74680;15;2020-11-15;8463
2020-11-14;"Nitriansky kraj";114;1131;32;1163;NA;74680;146;2020-11-14;8448
2020-11-13;"Nitriansky kraj";210;936;46;982;NA;74680;256;2020-11-13;8302
2020-11-12;"Nitriansky kraj";256;1195;35;1230;NA;74680;291;2020-11-12;8046
2020-11-11;"Nitriansky kraj";279;1247;22;1269;NA;74680;301;2020-11-11;7755
2020-11-10;"Nitriansky kraj";192;2623;39;2662;NA;74680;231;2020-11-10;7454
2020-11-09;"Nitriansky kraj";128;3136;43;3179;NA;74680;171;2020-11-09;7223
2020-11-08;"Nitriansky kraj";43;1462;32;1494;NA;74680;75;2020-11-08;7052
2020-11-07;"Nitriansky kraj";130;1046;4;1050;NA;74680;134;2020-11-07;6977
2020-11-06;"Nitriansky kraj";210;2264;32;2296;NA;74680;242;2020-11-06;6843
2020-11-05;"Nitriansky kraj";178;295;12;307;NA;74680;190;2020-11-05;6601
2020-11-04;"Nitriansky kraj";211;297;16;313;NA;74680;227;2020-11-04;6411
2020-11-03;"Nitriansky kraj";216;435;25;460;NA;74680;241;2020-11-03;6184
2020-11-02;"Nitriansky kraj";171;4208;46;4254;NA;74680;217;2020-11-02;5943
2020-11-01;"Nitriansky kraj";130;2546;27;2573;NA;74680;157;2020-11-01;5726
2020-10-31;"Nitriansky kraj";261;10466;134;10600;NA;74680;395;2020-10-31;5569
2020-10-30;"Nitriansky kraj";204;2380;21;2401;NA;74680;225;2020-10-30;5174
2020-10-29;"Nitriansky kraj";293;841;39;880;NA;74680;332;2020-10-29;4949
2020-10-28;"Nitriansky kraj";216;608;59;667;NA;74680;275;2020-10-28;4617
2020-10-27;"Nitriansky kraj";296;550;47;597;NA;74680;343;2020-10-27;4342
2020-10-26;"Nitriansky kraj";69;633;56;689;NA;74680;125;2020-10-26;3999
2020-10-25;"Nitriansky kraj";50;40;6;46;NA;74680;56;2020-10-25;3874
2020-10-24;"Nitriansky kraj";169;237;11;248;NA;74680;180;2020-10-24;3818
2020-10-23;"Nitriansky kraj";282;762;41;803;NA;74680;323;2020-10-23;3638
2020-10-22;"Nitriansky kraj";137;444;39;483;NA;74680;176;2020-10-22;3315
2020-10-21;"Nitriansky kraj";146;208;3;211;NA;74680;149;2020-10-21;3139
2020-10-20;"Nitriansky kraj";197;78;6;84;NA;74680;203;2020-10-20;2990
2020-10-19;"Nitriansky kraj";148;79;1;80;NA;74680;149;2020-10-19;2787
2020-10-18;"Nitriansky kraj";22;0;0;0;NA;74680;22;2020-10-18;2638
2020-10-17;"Nitriansky kraj";67;0;0;0;NA;74680;67;2020-10-17;2616
2020-10-16;"Nitriansky kraj";133;28;3;31;NA;74680;136;2020-10-16;2549
2020-10-15;"Nitriansky kraj";106;31;2;33;NA;74680;108;2020-10-15;2413
2020-10-14;"Nitriansky kraj";80;22;4;26;NA;74680;84;2020-10-14;2305
2020-10-13;"Nitriansky kraj";101;82;2;84;NA;74680;103;2020-10-13;2221
2020-10-12;"Nitriansky kraj";36;0;0;0;NA;74680;36;2020-10-12;2118
2020-10-11;"Nitriansky kraj";8;0;0;0;NA;74680;8;2020-10-11;2082
2020-10-10;"Nitriansky kraj";107;0;0;0;NA;74680;107;2020-10-10;2074
2020-10-09;"Nitriansky kraj";120;0;0;0;NA;74680;120;2020-10-09;1967
2020-10-08;"Nitriansky kraj";132;0;0;0;NA;74680;132;2020-10-08;1847
2020-10-07;"Nitriansky kraj";81;0;0;0;NA;74680;81;2020-10-07;1715
2020-10-06;"Nitriansky kraj";48;0;0;0;NA;74680;48;2020-10-06;1634
2020-10-05;"Nitriansky kraj";20;0;0;0;NA;74680;20;2020-10-05;1586
2020-10-04;"Nitriansky kraj";17;0;0;0;NA;74680;17;2020-10-04;1566
2020-10-03;"Nitriansky kraj";96;0;0;0;NA;74680;96;2020-10-03;1549
2020-10-02;"Nitriansky kraj";108;0;0;0;NA;74680;108;2020-10-02;1453
2020-10-01;"Nitriansky kraj";95;0;0;0;NA;74680;95;2020-10-01;1345
2020-09-30;"Nitriansky kraj";100;0;0;0;NA;74680;100;2020-09-30;1250
2020-09-29;"Nitriansky kraj";50;0;0;0;NA;74680;50;2020-09-29;1150
2020-09-28;"Nitriansky kraj";22;0;0;0;NA;74680;22;2020-09-28;1100
2020-09-27;"Nitriansky kraj";16;0;0;0;NA;74680;16;2020-09-27;1078
2020-09-26;"Nitriansky kraj";64;0;0;0;NA;74680;64;2020-09-26;1062
2020-09-25;"Nitriansky kraj";90;0;0;0;NA;74680;90;2020-09-25;998
2020-09-24;"Nitriansky kraj";51;0;0;0;NA;74680;51;2020-09-24;908
2020-09-23;"Nitriansky kraj";70;0;0;0;NA;74680;70;2020-09-23;857
2020-09-22;"Nitriansky kraj";18;0;0;0;NA;74680;18;2020-09-22;787
2020-09-21;"Nitriansky kraj";10;0;0;0;NA;74680;10;2020-09-21;769
2020-09-20;"Nitriansky kraj";4;0;0;0;NA;74680;4;2020-09-20;759
2020-09-19;"Nitriansky kraj";14;0;0;0;NA;74680;14;2020-09-19;755
2020-09-18;"Nitriansky kraj";19;0;0;0;NA;74680;19;2020-09-18;741
2020-09-17;"Nitriansky kraj";30;0;0;0;NA;74680;30;2020-09-17;722
2020-09-16;"Nitriansky kraj";6;0;0;0;NA;74680;6;2020-09-16;692
2020-09-15;"Nitriansky kraj";19;0;0;0;NA;74680;19;2020-09-15;686
2020-09-14;"Nitriansky kraj";28;0;0;0;NA;74680;28;2020-09-14;667
2020-09-13;"Nitriansky kraj";3;0;0;0;NA;74680;3;2020-09-13;639
2020-09-12;"Nitriansky kraj";12;0;0;0;NA;74680;12;2020-09-12;636
2020-09-11;"Nitriansky kraj";23;0;0;0;NA;74680;23;2020-09-11;624
2020-09-10;"Nitriansky kraj";29;0;0;0;NA;74680;29;2020-09-10;601
2020-09-09;"Nitriansky kraj";19;0;0;0;NA;74680;19;2020-09-09;572
2020-09-08;"Nitriansky kraj";17;0;0;0;NA;74680;17;2020-09-08;553
2020-09-07;"Nitriansky kraj";17;0;0;0;NA;74680;17;2020-09-07;536
2020-09-05;"Nitriansky kraj";22;0;0;0;NA;74680;22;2020-09-05;519
2020-09-04;"Nitriansky kraj";34;0;0;0;NA;74680;34;2020-09-04;497
2020-09-03;"Nitriansky kraj";15;0;0;0;NA;74680;15;2020-09-03;463
2021-02-18;"Prešovský kraj";268;14253;261;14514;42466;73587;529;2021-02-18;73587
2021-02-17;"Prešovský kraj";293;15933;235;16168;NA;73587;528;2021-02-17;73058
2021-02-16;"Prešovský kraj";422;17137;244;17381;NA;73587;666;2021-02-16;72530
2021-02-15;"Prešovský kraj";211;28243;277;28520;NA;73587;488;2021-02-15;71864
2021-02-14;"Prešovský kraj";27;31859;272;32131;NA;73587;299;2021-02-14;71376
2021-02-13;"Prešovský kraj";157;71578;373;71951;NA;73587;530;2021-02-13;71077
2021-02-12;"Prešovský kraj";308;36537;341;36878;NA;73587;649;2021-02-12;70547
2021-02-11;"Prešovský kraj";218;14030;212;14242;NA;73587;430;2021-02-11;69898
2021-02-10;"Prešovský kraj";220;16957;250;17207;NA;73587;470;2021-02-10;69468
2021-02-09;"Prešovský kraj";323;19383;344;19727;NA;73587;667;2021-02-09;68998
2021-02-08;"Prešovský kraj";161;36330;234;36564;NA;73587;395;2021-02-08;68331
2021-02-07;"Prešovský kraj";21;23291;151;23442;NA;73587;172;2021-02-07;67936
2021-02-06;"Prešovský kraj";176;66798;348;67146;NA;73587;524;2021-02-06;67764
2021-02-05;"Prešovský kraj";177;27762;243;28005;NA;73587;420;2021-02-05;67240
2021-02-04;"Prešovský kraj";176;11943;219;12162;NA;73587;395;2021-02-04;66820
2021-02-03;"Prešovský kraj";251;7557;207;7764;NA;73587;458;2021-02-03;66425
2021-02-02;"Prešovský kraj";249;11504;274;11778;NA;73587;523;2021-02-02;65967
2021-02-01;"Prešovský kraj";220;15203;276;15479;NA;73587;496;2021-02-01;65444
2021-01-31;"Prešovský kraj";42;1623;38;1661;NA;73587;80;2021-01-31;64948
2021-01-30;"Prešovský kraj";142;23774;214;23988;NA;73587;356;2021-01-30;64868
2021-01-29;"Prešovský kraj";88;15544;266;15810;NA;73587;354;2021-01-29;64512
2021-01-28;"Prešovský kraj";311;8207;137;8344;NA;73587;448;2021-01-28;64158
2021-01-27;"Prešovský kraj";153;9348;139;9487;NA;73587;292;2021-01-27;63710
2021-01-26;"Prešovský kraj";252;15960;141;16101;NA;73587;393;2021-01-26;63418
2021-01-25;"Prešovský kraj";196;27727;238;27965;NA;73587;434;2021-01-25;63025
2021-01-24;"Prešovský kraj";12;52958;386;53344;NA;73587;398;2021-01-24;62591
2021-01-23;"Prešovský kraj";189;89846;434;90280;NA;73587;623;2021-01-23;62193
2021-01-22;"Prešovský kraj";187;33467;249;33716;NA;73587;436;2021-01-22;61570
2021-01-21;"Prešovský kraj";187;18674;195;18869;NA;73587;382;2021-01-21;61134
2021-01-20;"Prešovský kraj";253;13031;169;13200;NA;73587;422;2021-01-20;60752
2021-01-19;"Prešovský kraj";281;11004;290;11294;NA;73587;571;2021-01-19;60330
2021-01-18;"Prešovský kraj";203;9455;309;9764;NA;73587;512;2021-01-18;59759
2021-01-17;"Prešovský kraj";107;14393;1008;15401;NA;73587;1115;2021-01-17;59247
2021-01-16;"Prešovský kraj";72;1583;76;1659;NA;73587;148;2021-01-16;58132
2021-01-15;"Prešovský kraj";159;6322;209;6531;NA;73587;368;2021-01-15;57984
2021-01-14;"Prešovský kraj";268;5250;238;5488;NA;73587;506;2021-01-14;57616
2021-01-13;"Prešovský kraj";342;5294;208;5502;NA;73587;550;2021-01-13;57110
2021-01-12;"Prešovský kraj";455;8099;370;8469;NA;73587;825;2021-01-12;56560
2021-01-11;"Prešovský kraj";343;7208;435;7643;NA;73587;778;2021-01-11;55735
2021-01-10;"Prešovský kraj";63;476;23;499;NA;73587;86;2021-01-10;54957
2021-01-09;"Prešovský kraj";439;2248;125;2373;NA;73587;564;2021-01-09;54871
2021-01-08;"Prešovský kraj";430;10059;517;10576;NA;73587;947;2021-01-08;54307
2021-01-07;"Prešovský kraj";268;7387;621;8008;NA;73587;889;2021-01-07;53360
2021-01-06;"Prešovský kraj";315;1259;101;1360;NA;73587;416;2021-01-06;52471
2021-01-05;"Prešovský kraj";655;11094;947;12041;NA;73587;1602;2021-01-05;52055
2021-01-04;"Prešovský kraj";371;16400;1688;18088;NA;73587;2059;2021-01-04;50453
2021-01-03;"Prešovský kraj";89;257;37;294;NA;73587;126;2021-01-03;48394
2021-01-02;"Prešovský kraj";65;1559;160;1719;NA;73587;225;2021-01-02;48268
2021-01-01;"Prešovský kraj";174;914;70;984;NA;73587;244;2021-01-01;48043
2020-12-31;"Prešovský kraj";640;11485;709;12194;NA;73587;1349;2020-12-31;47799
2020-12-30;"Prešovský kraj";729;8300;715;9015;NA;73587;1444;2020-12-30;46450
2020-12-29;"Prešovský kraj";435;8286;863;9149;NA;73587;1298;2020-12-29;45006
2020-12-28;"Prešovský kraj";393;8292;1020;9312;NA;73587;1413;2020-12-28;43708
2020-12-27;"Prešovský kraj";40;571;39;610;NA;73587;79;2020-12-27;42295
2020-12-26;"Prešovský kraj";64;176;12;188;NA;73587;76;2020-12-26;42216
2020-12-25;"Prešovský kraj";208;273;13;286;NA;73587;221;2020-12-25;42140
2020-12-24;"Prešovský kraj";452;1214;85;1299;NA;73587;537;2020-12-24;41919
2020-12-23;"Prešovský kraj";361;10434;576;11010;NA;73587;937;2020-12-23;41382
2020-12-22;"Prešovský kraj";439;8805;666;9471;NA;73587;1105;2020-12-22;40445
2020-12-21;"Prešovský kraj";432;9396;820;10216;NA;73587;1252;2020-12-21;39340
2020-12-20;"Prešovský kraj";184;396;20;416;NA;73587;204;2020-12-20;38088
2020-12-19;"Prešovský kraj";276;1658;151;1809;NA;73587;427;2020-12-19;37884
2020-12-18;"Prešovský kraj";396;8850;599;9449;NA;73587;995;2020-12-18;37457
2020-12-17;"Prešovský kraj";427;10826;891;11717;NA;73587;1318;2020-12-17;36462
2020-12-16;"Prešovský kraj";466;6017;508;6525;NA;73587;974;2020-12-16;35144
2020-12-15;"Prešovský kraj";411;5685;584;6269;NA;73587;995;2020-12-15;34170
2020-12-14;"Prešovský kraj";334;5767;508;6275;NA;73587;842;2020-12-14;33175
2020-12-13;"Prešovský kraj";89;29;8;37;NA;73587;97;2020-12-13;32333
2020-12-12;"Prešovský kraj";319;2474;166;2640;NA;73587;485;2020-12-12;32236
2020-12-11;"Prešovský kraj";560;6042;418;6460;NA;73587;978;2020-12-11;31751
2020-12-10;"Prešovský kraj";337;5180;440;5620;NA;73587;777;2020-12-10;30773
2020-12-09;"Prešovský kraj";358;3646;270;3916;NA;73587;628;2020-12-09;29996
2020-12-08;"Prešovský kraj";350;6436;647;7083;NA;73587;997;2020-12-08;29368
2020-12-07;"Prešovský kraj";309;3700;281;3981;NA;73587;590;2020-12-07;28371
2020-12-06;"Prešovský kraj";59;358;26;384;NA;73587;85;2020-12-06;27781
2020-12-05;"Prešovský kraj";218;984;87;1071;NA;73587;305;2020-12-05;27696
2020-12-04;"Prešovský kraj";352;4471;281;4752;NA;73587;633;2020-12-04;27391
2020-12-03;"Prešovský kraj";284;2900;202;3102;NA;73587;486;2020-12-03;26758
2020-12-02;"Prešovský kraj";232;3251;235;3486;NA;73587;467;2020-12-02;26272
2020-12-01;"Prešovský kraj";281;2341;213;2554;NA;73587;494;2020-12-01;25805
2020-11-30;"Prešovský kraj";196;5821;110;5931;NA;73587;306;2020-11-30;25311
2020-11-29;"Prešovský kraj";27;379;42;421;NA;73587;69;2020-11-29;25005
2020-11-28;"Prešovský kraj";199;682;62;744;NA;73587;261;2020-11-28;24936
2020-11-27;"Prešovský kraj";232;2135;119;2254;NA;73587;351;2020-11-27;24675
2020-11-26;"Prešovský kraj";263;2787;312;3099;NA;73587;575;2020-11-26;24324
2020-11-25;"Prešovský kraj";302;1642;78;1720;NA;73587;380;2020-11-25;23749
2020-11-24;"Prešovský kraj";365;1662;140;1802;NA;73587;505;2020-11-24;23369
2020-11-23;"Prešovský kraj";164;842;42;884;NA;73587;206;2020-11-23;22864
2020-11-22;"Prešovský kraj";46;30;1;31;NA;73587;47;2020-11-22;22658
2020-11-21;"Prešovský kraj";205;689;57;746;NA;73587;262;2020-11-21;22611
2020-11-20;"Prešovský kraj";363;2063;98;2161;NA;73587;461;2020-11-20;22349
2020-11-19;"Prešovský kraj";359;1973;229;2202;NA;73587;588;2020-11-19;21888
2020-11-18;"Prešovský kraj";270;373;32;405;NA;73587;302;2020-11-18;21300
2020-11-17;"Prešovský kraj";347;151;17;168;NA;73587;364;2020-11-17;20998
2020-11-16;"Prešovský kraj";226;382;51;433;NA;73587;277;2020-11-16;20634
2020-11-15;"Prešovský kraj";186;39;4;43;NA;73587;190;2020-11-15;20357
2020-11-14;"Prešovský kraj";261;54;4;58;NA;73587;265;2020-11-14;20167
2020-11-13;"Prešovský kraj";395;166;8;174;NA;73587;403;2020-11-13;19902
2020-11-12;"Prešovský kraj";397;229;50;279;NA;73587;447;2020-11-12;19499
2020-11-11;"Prešovský kraj";516;161;15;176;NA;73587;531;2020-11-11;19052
2020-11-10;"Prešovský kraj";437;197;9;206;NA;73587;446;2020-11-10;18521
2020-11-09;"Prešovský kraj";190;4106;945;5051;NA;73587;1135;2020-11-09;18075
2020-11-08;"Prešovský kraj";97;2817;32;2849;NA;73587;129;2020-11-08;16940
2020-11-07;"Prešovský kraj";416;8578;81;8659;NA;73587;497;2020-11-07;16811
2020-11-06;"Prešovský kraj";520;4791;76;4867;NA;73587;596;2020-11-06;16314
2020-11-05;"Prešovský kraj";397;180;5;185;NA;73587;402;2020-11-05;15718
2020-11-04;"Prešovský kraj";350;807;8;815;NA;73587;358;2020-11-04;15316
2020-11-03;"Prešovský kraj";565;98;12;110;NA;73587;577;2020-11-03;14958
2020-11-02;"Prešovský kraj";203;4158;1004;5162;NA;73587;1207;2020-11-02;14381
2020-11-01;"Prešovský kraj";386;2906;53;2959;NA;73587;439;2020-11-01;13174
2020-10-31;"Prešovský kraj";315;10497;170;10667;NA;73587;485;2020-10-31;12735
2020-10-30;"Prešovský kraj";552;2949;65;3014;NA;73587;617;2020-10-30;12250
2020-10-29;"Prešovský kraj";594;301;38;339;NA;73587;632;2020-10-29;11633
2020-10-28;"Prešovský kraj";617;291;46;337;NA;73587;663;2020-10-28;11001
2020-10-27;"Prešovský kraj";656;268;34;302;NA;73587;690;2020-10-27;10338
2020-10-26;"Prešovský kraj";137;363;57;420;NA;73587;194;2020-10-26;9648
2020-10-25;"Prešovský kraj";237;346;11;357;NA;73587;248;2020-10-25;9454
2020-10-24;"Prešovský kraj";719;200;12;212;NA;73587;731;2020-10-24;9206
2020-10-23;"Prešovský kraj";750;218;8;226;NA;73587;758;2020-10-23;8475
2020-10-22;"Prešovský kraj";646;396;30;426;NA;73587;676;2020-10-22;7717
2020-10-21;"Prešovský kraj";383;58;8;66;NA;73587;391;2020-10-21;7041
2020-10-20;"Prešovský kraj";493;65;7;72;NA;73587;500;2020-10-20;6650
2020-10-19;"Prešovský kraj";140;235;15;250;NA;73587;155;2020-10-19;6150
2020-10-18;"Prešovský kraj";209;0;0;0;NA;73587;209;2020-10-18;5995
2020-10-17;"Prešovský kraj";342;0;0;0;NA;73587;342;2020-10-17;5786
2020-10-16;"Prešovský kraj";388;57;3;60;NA;73587;391;2020-10-16;5444
2020-10-15;"Prešovský kraj";435;85;18;103;NA;73587;453;2020-10-15;5053
2020-10-14;"Prešovský kraj";451;54;10;64;NA;73587;461;2020-10-14;4600
2020-10-13;"Prešovský kraj";264;50;6;56;NA;73587;270;2020-10-13;4139
2020-10-12;"Prešovský kraj";214;334;35;369;NA;73587;249;2020-10-12;3869
2020-10-11;"Prešovský kraj";127;0;0;0;NA;73587;127;2020-10-11;3620
2020-10-10;"Prešovský kraj";248;0;0;0;NA;73587;248;2020-10-10;3493
2020-10-09;"Prešovský kraj";406;0;0;0;NA;73587;406;2020-10-09;3245
2020-10-08;"Prešovský kraj";245;0;0;0;NA;73587;245;2020-10-08;2839
2020-10-07;"Prešovský kraj";244;0;0;0;NA;73587;244;2020-10-07;2594
2020-10-06;"Prešovský kraj";166;0;0;0;NA;73587;166;2020-10-06;2350
2020-10-05;"Prešovský kraj";84;0;0;0;NA;73587;84;2020-10-05;2184
2020-10-04;"Prešovský kraj";118;0;0;0;NA;73587;118;2020-10-04;2100
2020-10-03;"Prešovský kraj";204;0;0;0;NA;73587;204;2020-10-03;1982
2020-10-02;"Prešovský kraj";149;0;0;0;NA;73587;149;2020-10-02;1778
2020-10-01;"Prešovský kraj";136;0;0;0;NA;73587;136;2020-10-01;1629
2020-09-30;"Prešovský kraj";121;0;0;0;NA;73587;121;2020-09-30;1493
2020-09-29;"Prešovský kraj";156;0;0;0;NA;73587;156;2020-09-29;1372
2020-09-28;"Prešovský kraj";51;0;0;0;NA;73587;51;2020-09-28;1216
2020-09-27;"Prešovský kraj";10;0;0;0;NA;73587;10;2020-09-27;1165
2020-09-26;"Prešovský kraj";72;0;0;0;NA;73587;72;2020-09-26;1155
2020-09-25;"Prešovský kraj";91;0;0;0;NA;73587;91;2020-09-25;1083
2020-09-24;"Prešovský kraj";52;0;0;0;NA;73587;52;2020-09-24;992
2020-09-23;"Prešovský kraj";55;0;0;0;NA;73587;55;2020-09-23;940
2020-09-22;"Prešovský kraj";29;0;0;0;NA;73587;29;2020-09-22;885
2020-09-21;"Prešovský kraj";14;0;0;0;NA;73587;14;2020-09-21;856
2020-09-20;"Prešovský kraj";5;0;0;0;NA;73587;5;2020-09-20;842
2020-09-19;"Prešovský kraj";12;0;0;0;NA;73587;12;2020-09-19;837
2020-09-18;"Prešovský kraj";29;0;0;0;NA;73587;29;2020-09-18;825
2020-09-17;"Prešovský kraj";25;0;0;0;NA;73587;25;2020-09-17;796
2020-09-16;"Prešovský kraj";8;0;0;0;NA;73587;8;2020-09-16;771
2020-09-15;"Prešovský kraj";10;0;0;0;NA;73587;10;2020-09-15;763
2020-09-14;"Prešovský kraj";47;0;0;0;NA;73587;47;2020-09-14;753
2020-09-13;"Prešovský kraj";3;0;0;0;NA;73587;3;2020-09-13;706
2020-09-12;"Prešovský kraj";4;0;0;0;NA;73587;4;2020-09-12;703
2020-09-11;"Prešovský kraj";15;0;0;0;NA;73587;15;2020-09-11;699
2020-09-10;"Prešovský kraj";10;0;0;0;NA;73587;10;2020-09-10;684
2020-09-09;"Prešovský kraj";21;0;0;0;NA;73587;21;2020-09-09;674
2020-09-08;"Prešovský kraj";23;0;0;0;NA;73587;23;2020-09-08;653
2020-09-07;"Prešovský kraj";5;0;0;0;NA;73587;5;2020-09-07;630
2020-09-06;"Prešovský kraj";3;0;0;0;NA;73587;3;2020-09-06;625
2020-09-05;"Prešovský kraj";7;0;0;0;NA;73587;7;2020-09-05;622
2020-09-04;"Prešovský kraj";24;0;0;0;NA;73587;24;2020-09-04;615
2020-09-03;"Prešovský kraj";8;0;0;0;NA;73587;8;2020-09-03;591
2021-02-18;"Trenčiansky kraj";355;9028;287;9315;38595;68234;642;2021-02-18;68234
2021-02-17;"Trenčiansky kraj";363;10907;357;11264;NA;68234;720;2021-02-17;67592
2021-02-16;"Trenčiansky kraj";488;16793;384;17177;NA;68234;872;2021-02-16;66872
2021-02-15;"Trenčiansky kraj";151;21438;453;21891;NA;68234;604;2021-02-15;66000
2021-02-14;"Trenčiansky kraj";2;5594;53;5647;NA;68234;55;2021-02-14;65396
2021-02-13;"Trenčiansky kraj";274;65614;576;66190;NA;68234;850;2021-02-13;65341
2021-02-12;"Trenčiansky kraj";276;26190;400;26590;NA;68234;676;2021-02-12;64491
2021-02-11;"Trenčiansky kraj";291;11202;320;11522;NA;68234;611;2021-02-11;63815
2021-02-10;"Trenčiansky kraj";304;11395;321;11716;NA;68234;625;2021-02-10;63204
2021-02-09;"Trenčiansky kraj";514;21505;379;21884;NA;68234;893;2021-02-09;62579
2021-02-08;"Trenčiansky kraj";182;28466;414;28880;NA;68234;596;2021-02-08;61686
2021-02-07;"Trenčiansky kraj";31;25706;262;25968;NA;68234;293;2021-02-07;61090
2021-02-06;"Trenčiansky kraj";216;63275;580;63855;NA;68234;796;2021-02-06;60797
2021-02-05;"Trenčiansky kraj";202;17008;364;17372;NA;68234;566;2021-02-05;60001
2021-02-04;"Trenčiansky kraj";266;6891;293;7184;NA;68234;559;2021-02-04;59435
2021-02-03;"Trenčiansky kraj";162;8981;345;9326;NA;68234;507;2021-02-03;58876
2021-02-02;"Trenčiansky kraj";347;8077;385;8462;NA;68234;732;2021-02-02;58369
2021-02-01;"Trenčiansky kraj";167;18227;318;18545;NA;68234;485;2021-02-01;57637
2021-01-31;"Trenčiansky kraj";7;15791;135;15926;NA;68234;142;2021-01-31;57152
2021-01-30;"Trenčiansky kraj";228;37045;355;37400;NA;68234;583;2021-01-30;57010
2021-01-29;"Trenčiansky kraj";72;7147;204;7351;NA;68234;276;2021-01-29;56427
2021-01-28;"Trenčiansky kraj";307;5431;161;5592;NA;68234;468;2021-01-28;56151
2021-01-27;"Trenčiansky kraj";166;11735;203;11938;NA;68234;369;2021-01-27;55683
2021-01-26;"Trenčiansky kraj";303;14287;237;14524;NA;68234;540;2021-01-26;55314
2021-01-25;"Trenčiansky kraj";160;34063;366;34429;NA;68234;526;2021-01-25;54774
2021-01-24;"Trenčiansky kraj";51;27365;181;27546;NA;68234;232;2021-01-24;54248
2021-01-23;"Trenčiansky kraj";206;110039;709;110748;NA;68234;915;2021-01-23;54016
2021-01-22;"Trenčiansky kraj";148;13948;174;14122;NA;68234;322;2021-01-22;53101
2021-01-21;"Trenčiansky kraj";143;8835;190;9025;NA;68234;333;2021-01-21;52779
2021-01-20;"Trenčiansky kraj";181;7684;236;7920;NA;68234;417;2021-01-20;52446
2021-01-19;"Trenčiansky kraj";363;6462;275;6737;NA;68234;638;2021-01-19;52029
2021-01-18;"Trenčiansky kraj";72;4488;257;4745;NA;68234;329;2021-01-18;51391
2021-01-17;"Trenčiansky kraj";124;93;11;104;NA;68234;135;2021-01-17;51062
2021-01-16;"Trenčiansky kraj";39;793;62;855;NA;68234;101;2021-01-16;50927
2021-01-15;"Trenčiansky kraj";264;3757;217;3974;NA;68234;481;2021-01-15;50826
2021-01-14;"Trenčiansky kraj";275;2991;153;3144;NA;68234;428;2021-01-14;50345
2021-01-13;"Trenčiansky kraj";222;4064;236;4300;NA;68234;458;2021-01-13;49917
2021-01-12;"Trenčiansky kraj";508;4790;293;5083;NA;68234;801;2021-01-12;49459
2021-01-11;"Trenčiansky kraj";142;3885;294;4179;NA;68234;436;2021-01-11;48658
2021-01-10;"Trenčiansky kraj";89;4939;76;5015;NA;68234;165;2021-01-10;48222
2021-01-09;"Trenčiansky kraj";276;7973;121;8094;NA;68234;397;2021-01-09;48057
2021-01-08;"Trenčiansky kraj";489;6411;467;6878;NA;68234;956;2021-01-08;47660
2021-01-07;"Trenčiansky kraj";420;5719;503;6222;NA;68234;923;2021-01-07;46704
2021-01-06;"Trenčiansky kraj";221;1021;64;1085;NA;68234;285;2021-01-06;45781
2021-01-05;"Trenčiansky kraj";669;5985;800;6785;NA;68234;1469;2021-01-05;45496
2021-01-04;"Trenčiansky kraj";337;4697;704;5401;NA;68234;1041;2021-01-04;44027
2021-01-03;"Trenčiansky kraj";38;60;13;73;NA;68234;51;2021-01-03;42986
2021-01-02;"Trenčiansky kraj";129;140;23;163;NA;68234;152;2021-01-02;42935
2021-01-01;"Trenčiansky kraj";329;347;23;370;NA;68234;352;2021-01-01;42783
2020-12-31;"Trenčiansky kraj";597;4943;557;5500;NA;68234;1154;2020-12-31;42431
2020-12-30;"Trenčiansky kraj";836;6782;762;7544;NA;68234;1598;2020-12-30;41277
2020-12-29;"Trenčiansky kraj";459;5979;1018;6997;NA;68234;1477;2020-12-29;39679
2020-12-28;"Trenčiansky kraj";258;3923;777;4700;NA;68234;1035;2020-12-28;38202
2020-12-27;"Trenčiansky kraj";5;202;36;238;NA;68234;41;2020-12-27;37167
2020-12-26;"Trenčiansky kraj";174;74;10;84;NA;68234;184;2020-12-26;37126
2020-12-25;"Trenčiansky kraj";251;325;47;372;NA;68234;298;2020-12-25;36942
2020-12-24;"Trenčiansky kraj";552;2194;256;2450;NA;68234;808;2020-12-24;36644
2020-12-23;"Trenčiansky kraj";421;6294;629;6923;NA;68234;1050;2020-12-23;35836
2020-12-22;"Trenčiansky kraj";673;5597;694;6291;NA;68234;1367;2020-12-22;34786
2020-12-21;"Trenčiansky kraj";248;13539;996;14535;NA;68234;1244;2020-12-21;33419
2020-12-20;"Trenčiansky kraj";238;12480;291;12771;NA;68234;529;2020-12-20;32175
2020-12-19;"Trenčiansky kraj";341;1611;150;1761;NA;68234;491;2020-12-19;31646
2020-12-18;"Trenčiansky kraj";521;4670;543;5213;NA;68234;1064;2020-12-18;31155
2020-12-17;"Trenčiansky kraj";670;3690;503;4193;NA;68234;1173;2020-12-17;30091
2020-12-16;"Trenčiansky kraj";461;4325;622;4947;NA;68234;1083;2020-12-16;28918
2020-12-15;"Trenčiansky kraj";595;3643;656;4299;NA;68234;1251;2020-12-15;27835
2020-12-14;"Trenčiansky kraj";318;2960;613;3573;NA;68234;931;2020-12-14;26584
2020-12-13;"Trenčiansky kraj";77;24;4;28;NA;68234;81;2020-12-13;25653
2020-12-12;"Trenčiansky kraj";314;1002;120;1122;NA;68234;434;2020-12-12;25572
2020-12-11;"Trenčiansky kraj";750;3902;479;4381;NA;68234;1229;2020-12-11;25138
2020-12-10;"Trenčiansky kraj";271;3371;477;3848;NA;68234;748;2020-12-10;23909
2020-12-09;"Trenčiansky kraj";508;3805;470;4275;NA;68234;978;2020-12-09;23161
2020-12-08;"Trenčiansky kraj";546;3440;522;3962;NA;68234;1068;2020-12-08;22183
2020-12-07;"Trenčiansky kraj";258;3826;466;4292;NA;68234;724;2020-12-07;21115
2020-12-06;"Trenčiansky kraj";114;179;10;189;NA;68234;124;2020-12-06;20391
2020-12-05;"Trenčiansky kraj";223;751;64;815;NA;68234;287;2020-12-05;20267
2020-12-04;"Trenčiansky kraj";253;2519;215;2734;NA;68234;468;2020-12-04;19980
2020-12-03;"Trenčiansky kraj";503;1714;178;1892;NA;68234;681;2020-12-03;19512
2020-12-02;"Trenčiansky kraj";418;1844;232;2076;NA;68234;650;2020-12-02;18831
2020-12-01;"Trenčiansky kraj";321;5642;351;5993;NA;68234;672;2020-12-01;18181
2020-11-30;"Trenčiansky kraj";167;8494;489;8983;NA;68234;656;2020-11-30;17509
2020-11-29;"Trenčiansky kraj";29;18;2;20;NA;68234;31;2020-11-29;16853
2020-11-28;"Trenčiansky kraj";202;1051;93;1144;NA;68234;295;2020-11-28;16822
2020-11-27;"Trenčiansky kraj";330;1398;150;1548;NA;68234;480;2020-11-27;16527
2020-11-26;"Trenčiansky kraj";395;1252;122;1374;NA;68234;517;2020-11-26;16047
2020-11-25;"Trenčiansky kraj";322;1444;160;1604;NA;68234;482;2020-11-25;15530
2020-11-24;"Trenčiansky kraj";348;2553;308;2861;NA;68234;656;2020-11-24;15048
2020-11-23;"Trenčiansky kraj";159;1186;122;1308;NA;68234;281;2020-11-23;14392
2020-11-22;"Trenčiansky kraj";26;11;1;12;NA;68234;27;2020-11-22;14111
2020-11-21;"Trenčiansky kraj";255;1323;62;1385;NA;68234;317;2020-11-21;14084
2020-11-20;"Trenčiansky kraj";316;861;93;954;NA;68234;409;2020-11-20;13767
2020-11-19;"Trenčiansky kraj";316;740;113;853;NA;68234;429;2020-11-19;13358
2020-11-18;"Trenčiansky kraj";233;379;66;445;NA;68234;299;2020-11-18;12929
2020-11-17;"Trenčiansky kraj";222;106;15;121;NA;68234;237;2020-11-17;12630
2020-11-16;"Trenčiansky kraj";245;236;45;281;NA;68234;290;2020-11-16;12393
2020-11-15;"Trenčiansky kraj";109;29;6;35;NA;68234;115;2020-11-15;12103
2020-11-14;"Trenčiansky kraj";190;74;11;85;NA;68234;201;2020-11-14;11988
2020-11-13;"Trenčiansky kraj";308;131;13;144;NA;68234;321;2020-11-13;11787
2020-11-12;"Trenčiansky kraj";324;124;5;129;NA;68234;329;2020-11-12;11466
2020-11-11;"Trenčiansky kraj";366;113;10;123;NA;68234;376;2020-11-11;11137
2020-11-10;"Trenčiansky kraj";277;106;6;112;NA;68234;283;2020-11-10;10761
2020-11-09;"Trenčiansky kraj";115;1407;48;1455;NA;68234;163;2020-11-09;10478
2020-11-08;"Trenčiansky kraj";81;1223;8;1231;NA;68234;89;2020-11-08;10315
2020-11-07;"Trenčiansky kraj";319;3662;59;3721;NA;68234;378;2020-11-07;10226
2020-11-06;"Trenčiansky kraj";383;6893;84;6977;NA;68234;467;2020-11-06;9848
2020-11-05;"Trenčiansky kraj";399;98;15;113;NA;68234;414;2020-11-05;9381
2020-11-04;"Trenčiansky kraj";370;91;9;100;NA;68234;379;2020-11-04;8967
2020-11-03;"Trenčiansky kraj";575;97;8;105;NA;68234;583;2020-11-03;8588
2020-11-02;"Trenčiansky kraj";197;1833;68;1901;NA;68234;265;2020-11-02;8005
2020-11-01;"Trenčiansky kraj";257;804;23;827;NA;68234;280;2020-11-01;7740
2020-10-31;"Trenčiansky kraj";332;4719;82;4801;NA;68234;414;2020-10-31;7460
2020-10-30;"Trenčiansky kraj";299;5283;102;5385;NA;68234;401;2020-10-30;7046
2020-10-29;"Trenčiansky kraj";496;764;68;832;NA;68234;564;2020-10-29;6645
2020-10-28;"Trenčiansky kraj";269;192;33;225;NA;68234;302;2020-10-28;6081
2020-10-27;"Trenčiansky kraj";473;127;27;154;NA;68234;500;2020-10-27;5779
2020-10-26;"Trenčiansky kraj";177;103;31;134;NA;68234;208;2020-10-26;5279
2020-10-25;"Trenčiansky kraj";138;9;5;14;NA;68234;143;2020-10-25;5071
2020-10-24;"Trenčiansky kraj";395;128;6;134;NA;68234;401;2020-10-24;4928
2020-10-23;"Trenčiansky kraj";301;154;8;162;NA;68234;309;2020-10-23;4527
2020-10-22;"Trenčiansky kraj";273;82;12;94;NA;68234;285;2020-10-22;4218
2020-10-21;"Trenčiansky kraj";183;53;9;62;NA;68234;192;2020-10-21;3933
2020-10-20;"Trenčiansky kraj";212;47;6;53;NA;68234;218;2020-10-20;3741
2020-10-19;"Trenčiansky kraj";41;83;25;108;NA;68234;66;2020-10-19;3523
2020-10-18;"Trenčiansky kraj";104;0;0;0;NA;68234;104;2020-10-18;3457
2020-10-17;"Trenčiansky kraj";157;0;0;0;NA;68234;157;2020-10-17;3353
2020-10-16;"Trenčiansky kraj";225;42;6;48;NA;68234;231;2020-10-16;3196
2020-10-15;"Trenčiansky kraj";255;39;4;43;NA;68234;259;2020-10-15;2965
2020-10-14;"Trenčiansky kraj";162;42;7;49;NA;68234;169;2020-10-14;2706
2020-10-13;"Trenčiansky kraj";124;105;12;117;NA;68234;136;2020-10-13;2537
2020-10-12;"Trenčiansky kraj";55;0;0;0;NA;68234;55;2020-10-12;2401
2020-10-11;"Trenčiansky kraj";73;0;0;0;NA;68234;73;2020-10-11;2346
2020-10-10;"Trenčiansky kraj";180;0;0;0;NA;68234;180;2020-10-10;2273
2020-10-09;"Trenčiansky kraj";198;0;0;0;NA;68234;198;2020-10-09;2093
2020-10-08;"Trenčiansky kraj";115;0;0;0;NA;68234;115;2020-10-08;1895
2020-10-07;"Trenčiansky kraj";75;0;0;0;NA;68234;75;2020-10-07;1780
2020-10-06;"Trenčiansky kraj";72;0;0;0;NA;68234;72;2020-10-06;1705
2020-10-05;"Trenčiansky kraj";32;0;0;0;NA;68234;32;2020-10-05;1633
2020-10-04;"Trenčiansky kraj";37;0;0;0;NA;68234;37;2020-10-04;1601
2020-10-03;"Trenčiansky kraj";79;0;0;0;NA;68234;79;2020-10-03;1564
2020-10-02;"Trenčiansky kraj";69;0;0;0;NA;68234;69;2020-10-02;1485
2020-10-01;"Trenčiansky kraj";58;0;0;0;NA;68234;58;2020-10-01;1416
2020-09-30;"Trenčiansky kraj";76;0;0;0;NA;68234;76;2020-09-30;1358
2020-09-29;"Trenčiansky kraj";43;0;0;0;NA;68234;43;2020-09-29;1282
2020-09-28;"Trenčiansky kraj";7;0;0;0;NA;68234;7;2020-09-28;1239
2020-09-27;"Trenčiansky kraj";12;0;0;0;NA;68234;12;2020-09-27;1232
2020-09-26;"Trenčiansky kraj";37;0;0;0;NA;68234;37;2020-09-26;1220
2020-09-25;"Trenčiansky kraj";72;0;0;0;NA;68234;72;2020-09-25;1183
2020-09-24;"Trenčiansky kraj";41;0;0;0;NA;68234;41;2020-09-24;1111
2020-09-23;"Trenčiansky kraj";32;0;0;0;NA;68234;32;2020-09-23;1070
2020-09-22;"Trenčiansky kraj";26;0;0;0;NA;68234;26;2020-09-22;1038
2020-09-21;"Trenčiansky kraj";23;0;0;0;NA;68234;23;2020-09-21;1012
2020-09-20;"Trenčiansky kraj";21;0;0;0;NA;68234;21;2020-09-20;989
2020-09-19;"Trenčiansky kraj";20;0;0;0;NA;68234;20;2020-09-19;968
2020-09-18;"Trenčiansky kraj";41;0;0;0;NA;68234;41;2020-09-18;948
2020-09-17;"Trenčiansky kraj";20;0;0;0;NA;68234;20;2020-09-17;907
2020-09-16;"Trenčiansky kraj";14;0;0;0;NA;68234;14;2020-09-16;887
2020-09-15;"Trenčiansky kraj";8;0;0;0;NA;68234;8;2020-09-15;873
2020-09-14;"Trenčiansky kraj";5;0;0;0;NA;68234;5;2020-09-14;865
2020-09-13;"Trenčiansky kraj";12;0;0;0;NA;68234;12;2020-09-13;860
2020-09-12;"Trenčiansky kraj";2;0;0;0;NA;68234;2;2020-09-12;848
2020-09-11;"Trenčiansky kraj";27;0;0;0;NA;68234;27;2020-09-11;846
2020-09-10;"Trenčiansky kraj";15;0;0;0;NA;68234;15;2020-09-10;819
2020-09-09;"Trenčiansky kraj";11;0;0;0;NA;68234;11;2020-09-09;804
2020-09-08;"Trenčiansky kraj";12;0;0;0;NA;68234;12;2020-09-08;793
2020-09-07;"Trenčiansky kraj";6;0;0;0;NA;68234;6;2020-09-07;781
2020-09-06;"Trenčiansky kraj";1;0;0;0;NA;68234;1;2020-09-06;775
2020-09-05;"Trenčiansky kraj";3;0;0;0;NA;68234;3;2020-09-05;774
2020-09-04;"Trenčiansky kraj";9;0;0;0;NA;68234;9;2020-09-04;771
2020-09-03;"Trenčiansky kraj";10;0;0;0;NA;68234;10;2020-09-03;762
2021-02-18;"Trnavský kraj";344;9115;252;9367;34619;66352;596;2021-02-18;66352
2021-02-17;"Trnavský kraj";431;7375;338;7713;NA;66352;769;2021-02-17;65756
2021-02-16;"Trnavský kraj";426;10509;253;10762;NA;66352;679;2021-02-16;64987
2021-02-15;"Trnavský kraj";146;16248;214;16462;NA;66352;360;2021-02-15;64308
2021-02-14;"Trnavský kraj";51;44848;343;45191;NA;66352;394;2021-02-14;63948
2021-02-13;"Trnavský kraj";218;134683;967;135650;NA;66352;1185;2021-02-13;63554
2021-02-12;"Trnavský kraj";300;23056;315;23371;NA;66352;615;2021-02-12;62369
2021-02-11;"Trnavský kraj";422;9648;345;9993;NA;66352;767;2021-02-11;61754
2021-02-10;"Trnavský kraj";511;8799;298;9097;NA;66352;809;2021-02-10;60987
2021-02-09;"Trnavský kraj";544;12748;366;13114;NA;66352;910;2021-02-09;60178
2021-02-08;"Trnavský kraj";220;33840;486;34326;NA;66352;706;2021-02-08;59268
2021-02-07;"Trnavský kraj";140;68837;627;69464;NA;66352;767;2021-02-07;58562
2021-02-06;"Trnavský kraj";348;111899;1473;113372;NA;66352;1821;2021-02-06;57795
2021-02-05;"Trnavský kraj";377;15918;354;16272;NA;66352;731;2021-02-05;55974
2021-02-04;"Trnavský kraj";456;10691;551;11242;NA;66352;1007;2021-02-04;55243
2021-02-03;"Trnavský kraj";472;6129;390;6519;NA;66352;862;2021-02-03;54236
2021-02-02;"Trnavský kraj";446;13831;415;14246;NA;66352;861;2021-02-02;53374
2021-02-01;"Trnavský kraj";198;39792;710;40502;NA;66352;908;2021-02-01;52513
2021-01-31;"Trnavský kraj";19;62728;778;63506;NA;66352;797;2021-01-31;51605
2021-01-30;"Trnavský kraj";323;110455;1279;111734;NA;66352;1602;2021-01-30;50808
2021-01-29;"Trnavský kraj";196;9564;284;9848;NA;66352;480;2021-01-29;49206
2021-01-28;"Trnavský kraj";389;5815;286;6101;NA;66352;675;2021-01-28;48726
2021-01-27;"Trnavský kraj";433;5301;219;5520;NA;66352;652;2021-01-27;48051
2021-01-26;"Trnavský kraj";565;25345;650;25995;NA;66352;1215;2021-01-26;47399
2021-01-25;"Trnavský kraj";210;43441;632;44073;NA;66352;842;2021-01-25;46184
2021-01-24;"Trnavský kraj";91;55652;703;56355;NA;66352;794;2021-01-24;45342
2021-01-23;"Trnavský kraj";372;116896;1336;118232;NA;66352;1708;2021-01-23;44548
2021-01-22;"Trnavský kraj";217;32439;500;32939;NA;66352;717;2021-01-22;42840
2021-01-21;"Trnavský kraj";311;13834;378;14212;NA;66352;689;2021-01-21;42123
2021-01-20;"Trnavský kraj";503;8149;274;8423;NA;66352;777;2021-01-20;41434
2021-01-19;"Trnavský kraj";415;7020;347;7367;NA;66352;762;2021-01-19;40657
2021-01-18;"Trnavský kraj";247;6237;484;6721;NA;66352;731;2021-01-18;39895
2021-01-17;"Trnavský kraj";128;854;215;1069;NA;66352;343;2021-01-17;39164
2021-01-16;"Trnavský kraj";103;599;19;618;NA;66352;122;2021-01-16;38821
2021-01-15;"Trnavský kraj";278;5466;336;5802;NA;66352;614;2021-01-15;38699
2021-01-14;"Trnavský kraj";452;3994;337;4331;NA;66352;789;2021-01-14;38085
2021-01-13;"Trnavský kraj";457;4752;378;5130;NA;66352;835;2021-01-13;37296
2021-01-12;"Trnavský kraj";469;7177;483;7660;NA;66352;952;2021-01-12;36461
2021-01-11;"Trnavský kraj";370;4911;376;5287;NA;66352;746;2021-01-11;35509
2021-01-10;"Trnavský kraj";71;8;0;8;NA;66352;71;2021-01-10;34763
2021-01-09;"Trnavský kraj";417;1775;100;1875;NA;66352;517;2021-01-09;34692
2021-01-08;"Trnavský kraj";381;6349;502;6851;NA;66352;883;2021-01-08;34175
2021-01-07;"Trnavský kraj";501;4074;397;4471;NA;66352;898;2021-01-07;33292
2021-01-06;"Trnavský kraj";179;758;132;890;NA;66352;311;2021-01-06;32394
2021-01-05;"Trnavský kraj";611;6188;705;6893;NA;66352;1316;2021-01-05;32083
2021-01-04;"Trnavský kraj";302;5235;689;5924;NA;66352;991;2021-01-04;30767
2021-01-03;"Trnavský kraj";60;51;7;58;NA;66352;67;2021-01-03;29776
2021-01-02;"Trnavský kraj";282;412;30;442;NA;66352;312;2021-01-02;29709
2021-01-01;"Trnavský kraj";143;449;76;525;NA;66352;219;2021-01-01;29397
2020-12-31;"Trnavský kraj";498;8488;858;9346;NA;66352;1356;2020-12-31;29178
2020-12-30;"Trnavský kraj";785;5321;612;5933;NA;66352;1397;2020-12-30;27822
2020-12-29;"Trnavský kraj";322;4999;593;5592;NA;66352;915;2020-12-29;26425
2020-12-28;"Trnavský kraj";213;5320;612;5932;NA;66352;825;2020-12-28;25510
2020-12-27;"Trnavský kraj";27;13;4;17;NA;66352;31;2020-12-27;24685
2020-12-26;"Trnavský kraj";148;44;1;45;NA;66352;149;2020-12-26;24654
2020-12-25;"Trnavský kraj";65;49;5;54;NA;66352;70;2020-12-25;24505
2020-12-24;"Trnavský kraj";333;1359;117;1476;NA;66352;450;2020-12-24;24435
2020-12-23;"Trnavský kraj";210;6417;375;6792;NA;66352;585;2020-12-23;23985
2020-12-22;"Trnavský kraj";311;5590;491;6081;NA;66352;802;2020-12-22;23400
2020-12-21;"Trnavský kraj";328;4527;399;4926;NA;66352;727;2020-12-21;22598
2020-12-20;"Trnavský kraj";134;110;12;122;NA;66352;146;2020-12-20;21871
2020-12-19;"Trnavský kraj";201;1046;86;1132;NA;66352;287;2020-12-19;21725
2020-12-18;"Trnavský kraj";341;4891;378;5269;NA;66352;719;2020-12-18;21438
2020-12-17;"Trnavský kraj";375;4996;407;5403;NA;66352;782;2020-12-17;20719
2020-12-16;"Trnavský kraj";312;5249;405;5654;NA;66352;717;2020-12-16;19937
2020-12-15;"Trnavský kraj";492;6622;632;7254;NA;66352;1124;2020-12-15;19220
2020-12-14;"Trnavský kraj";161;3505;292;3797;NA;66352;453;2020-12-14;18096
2020-12-13;"Trnavský kraj";7;0;0;0;NA;66352;7;2020-12-13;17643
2020-12-12;"Trnavský kraj";254;1456;114;1570;NA;66352;368;2020-12-12;17636
2020-12-11;"Trnavský kraj";384;4683;262;4945;NA;66352;646;2020-12-11;17268
2020-12-10;"Trnavský kraj";183;5194;320;5514;NA;66352;503;2020-12-10;16622
2020-12-09;"Trnavský kraj";521;4283;321;4604;NA;66352;842;2020-12-09;16119
2020-12-08;"Trnavský kraj";281;4090;304;4394;NA;66352;585;2020-12-08;15277
2020-12-07;"Trnavský kraj";178;2895;199;3094;NA;66352;377;2020-12-07;14692
2020-12-06;"Trnavský kraj";46;0;0;0;NA;66352;46;2020-12-06;14315
2020-12-05;"Trnavský kraj";129;2218;41;2259;NA;66352;170;2020-12-05;14269
2020-12-04;"Trnavský kraj";242;3948;158;4106;NA;66352;400;2020-12-04;14099
2020-12-03;"Trnavský kraj";248;2770;190;2960;NA;66352;438;2020-12-03;13699
2020-12-02;"Trnavský kraj";284;4516;176;4692;NA;66352;460;2020-12-02;13261
2020-12-01;"Trnavský kraj";253;3190;205;3395;NA;66352;458;2020-12-01;12801
2020-11-30;"Trnavský kraj";200;7360;186;7546;NA;66352;386;2020-11-30;12343
2020-11-29;"Trnavský kraj";17;708;34;742;NA;66352;51;2020-11-29;11957
2020-11-28;"Trnavský kraj";83;1453;77;1530;NA;66352;160;2020-11-28;11906
2020-11-27;"Trnavský kraj";148;1591;83;1674;NA;66352;231;2020-11-27;11746
2020-11-26;"Trnavský kraj";234;985;59;1044;NA;66352;293;2020-11-26;11515
2020-11-25;"Trnavský kraj";232;1029;72;1101;NA;66352;304;2020-11-25;11222
2020-11-24;"Trnavský kraj";295;1772;91;1863;NA;66352;386;2020-11-24;10918
2020-11-23;"Trnavský kraj";242;7207;125;7332;NA;66352;367;2020-11-23;10532
2020-11-22;"Trnavský kraj";10;54;3;57;NA;66352;13;2020-11-22;10165
2020-11-21;"Trnavský kraj";129;1214;23;1237;NA;66352;152;2020-11-21;10152
2020-11-20;"Trnavský kraj";246;1027;61;1088;NA;66352;307;2020-11-20;10000
2020-11-19;"Trnavský kraj";157;694;58;752;NA;66352;215;2020-11-19;9693
2020-11-18;"Trnavský kraj";235;716;75;791;NA;66352;310;2020-11-18;9478
2020-11-17;"Trnavský kraj";129;695;72;767;NA;66352;201;2020-11-17;9168
2020-11-16;"Trnavský kraj";187;682;32;714;NA;66352;219;2020-11-16;8967
2020-11-15;"Trnavský kraj";23;73;4;77;NA;66352;27;2020-11-15;8748
2020-11-14;"Trnavský kraj";86;389;10;399;NA;66352;96;2020-11-14;8721
2020-11-13;"Trnavský kraj";219;1312;21;1333;NA;66352;240;2020-11-13;8625
2020-11-12;"Trnavský kraj";162;420;18;438;NA;66352;180;2020-11-12;8385
2020-11-11;"Trnavský kraj";257;392;15;407;NA;66352;272;2020-11-11;8205
2020-11-10;"Trnavský kraj";189;889;30;919;NA;66352;219;2020-11-10;7933
2020-11-09;"Trnavský kraj";196;369;23;392;NA;66352;219;2020-11-09;7714
2020-11-08;"Trnavský kraj";55;306;4;310;NA;66352;59;2020-11-08;7495
2020-11-07;"Trnavský kraj";207;6070;74;6144;NA;66352;281;2020-11-07;7436
2020-11-06;"Trnavský kraj";260;1531;19;1550;NA;66352;279;2020-11-06;7155
2020-11-05;"Trnavský kraj";150;220;27;247;NA;66352;177;2020-11-05;6876
2020-11-04;"Trnavský kraj";188;212;10;222;NA;66352;198;2020-11-04;6699
2020-11-03;"Trnavský kraj";317;127;8;135;NA;66352;325;2020-11-03;6501
2020-11-02;"Trnavský kraj";281;1728;31;1759;NA;66352;312;2020-11-02;6176
2020-11-01;"Trnavský kraj";87;494;27;521;NA;66352;114;2020-11-01;5864
2020-10-31;"Trnavský kraj";259;5024;41;5065;NA;66352;300;2020-10-31;5750
2020-10-30;"Trnavský kraj";198;3784;27;3811;NA;66352;225;2020-10-30;5450
2020-10-29;"Trnavský kraj";273;1461;16;1477;NA;66352;289;2020-10-29;5225
2020-10-28;"Trnavský kraj";319;117;16;133;NA;66352;335;2020-10-28;4936
2020-10-27;"Trnavský kraj";199;461;36;497;NA;66352;235;2020-10-27;4601
2020-10-26;"Trnavský kraj";153;29;2;31;NA;66352;155;2020-10-26;4366
2020-10-25;"Trnavský kraj";95;19;1;20;NA;66352;96;2020-10-25;4211
2020-10-24;"Trnavský kraj";158;109;2;111;NA;66352;160;2020-10-24;4115
2020-10-23;"Trnavský kraj";201;89;4;93;NA;66352;205;2020-10-23;3955
2020-10-22;"Trnavský kraj";195;55;2;57;NA;66352;197;2020-10-22;3750
2020-10-21;"Trnavský kraj";134;73;3;76;NA;66352;137;2020-10-21;3553
2020-10-20;"Trnavský kraj";202;82;3;85;NA;66352;205;2020-10-20;3416
2020-10-19;"Trnavský kraj";67;55;0;55;NA;66352;67;2020-10-19;3211
2020-10-18;"Trnavský kraj";84;0;0;0;NA;66352;84;2020-10-18;3144
2020-10-17;"Trnavský kraj";123;0;0;0;NA;66352;123;2020-10-17;3060
2020-10-16;"Trnavský kraj";86;45;2;47;NA;66352;88;2020-10-16;2937
2020-10-15;"Trnavský kraj";155;66;2;68;NA;66352;157;2020-10-15;2849
2020-10-14;"Trnavský kraj";236;468;3;471;NA;66352;239;2020-10-14;2692
2020-10-13;"Trnavský kraj";138;16;2;18;NA;66352;140;2020-10-13;2453
2020-10-12;"Trnavský kraj";33;41;1;42;NA;66352;34;2020-10-12;2313
2020-10-11;"Trnavský kraj";31;0;0;0;NA;66352;31;2020-10-11;2279
2020-10-10;"Trnavský kraj";128;0;0;0;NA;66352;128;2020-10-10;2248
2020-10-09;"Trnavský kraj";156;0;0;0;NA;66352;156;2020-10-09;2120
2020-10-08;"Trnavský kraj";153;0;0;0;NA;66352;153;2020-10-08;1964
2020-10-07;"Trnavský kraj";80;0;0;0;NA;66352;80;2020-10-07;1811
2020-10-06;"Trnavský kraj";112;0;0;0;NA;66352;112;2020-10-06;1731
2020-10-05;"Trnavský kraj";33;0;0;0;NA;66352;33;2020-10-05;1619
2020-10-04;"Trnavský kraj";44;0;0;0;NA;66352;44;2020-10-04;1586
2020-10-03;"Trnavský kraj";60;0;0;0;NA;66352;60;2020-10-03;1542
2020-10-02;"Trnavský kraj";41;0;0;0;NA;66352;41;2020-10-02;1482
2020-10-01;"Trnavský kraj";53;0;0;0;NA;66352;53;2020-10-01;1441
2020-09-30;"Trnavský kraj";91;0;0;0;NA;66352;91;2020-09-30;1388
2020-09-29;"Trnavský kraj";40;0;0;0;NA;66352;40;2020-09-29;1297
2020-09-28;"Trnavský kraj";69;0;0;0;NA;66352;69;2020-09-28;1257
2020-09-27;"Trnavský kraj";30;0;0;0;NA;66352;30;2020-09-27;1188
2020-09-26;"Trnavský kraj";46;0;0;0;NA;66352;46;2020-09-26;1158
2020-09-25;"Trnavský kraj";32;0;0;0;NA;66352;32;2020-09-25;1112
2020-09-24;"Trnavský kraj";42;0;0;0;NA;66352;42;2020-09-24;1080
2020-09-23;"Trnavský kraj";43;0;0;0;NA;66352;43;2020-09-23;1038
2020-09-22;"Trnavský kraj";55;0;0;0;NA;66352;55;2020-09-22;995
2020-09-21;"Trnavský kraj";41;0;0;0;NA;66352;41;2020-09-21;940
2020-09-20;"Trnavský kraj";17;0;0;0;NA;66352;17;2020-09-20;899
2020-09-19;"Trnavský kraj";4;0;0;0;NA;66352;4;2020-09-19;882
2020-09-18;"Trnavský kraj";33;0;0;0;NA;66352;33;2020-09-18;878
2020-09-17;"Trnavský kraj";42;0;0;0;NA;66352;42;2020-09-17;845
2020-09-16;"Trnavský kraj";49;0;0;0;NA;66352;49;2020-09-16;803
2020-09-15;"Trnavský kraj";5;0;0;0;NA;66352;5;2020-09-15;754
2020-09-14;"Trnavský kraj";26;0;0;0;NA;66352;26;2020-09-14;749
2020-09-13;"Trnavský kraj";9;0;0;0;NA;66352;9;2020-09-13;723
2020-09-12;"Trnavský kraj";12;0;0;0;NA;66352;12;2020-09-12;714
2020-09-11;"Trnavský kraj";16;0;0;0;NA;66352;16;2020-09-11;702
2020-09-10;"Trnavský kraj";32;0;0;0;NA;66352;32;2020-09-10;686
2020-09-09;"Trnavský kraj";14;0;0;0;NA;66352;14;2020-09-09;654
2020-09-08;"Trnavský kraj";11;0;0;0;NA;66352;11;2020-09-08;640
2020-09-07;"Trnavský kraj";7;0;0;0;NA;66352;7;2020-09-07;629
2020-09-06;"Trnavský kraj";5;0;0;0;NA;66352;5;2020-09-06;622
2020-09-05;"Trnavský kraj";7;0;0;0;NA;66352;7;2020-09-05;617
2020-09-04;"Trnavský kraj";16;0;0;0;NA;66352;16;2020-09-04;610
2020-09-03;"Trnavský kraj";8;0;0;0;NA;66352;8;2020-09-03;594
2021-02-18;"Žilinský kraj";263;14586;257;14843;40118;68019;520;2021-02-18;68019
2021-02-17;"Žilinský kraj";269;17319;331;17650;NA;68019;600;2021-02-17;67499
2021-02-16;"Žilinský kraj";321;23323;324;23647;NA;68019;645;2021-02-16;66899
2021-02-15;"Žilinský kraj";230;32214;316;32530;NA;68019;546;2021-02-15;66254
2021-02-14;"Žilinský kraj";30;20329;180;20509;NA;68019;210;2021-02-14;65708
2021-02-13;"Žilinský kraj";91;64870;432;65302;NA;68019;523;2021-02-13;65498
2021-02-12;"Žilinský kraj";242;41184;330;41514;NA;68019;572;2021-02-12;64975
2021-02-11;"Žilinský kraj";228;23461;293;23754;NA;68019;521;2021-02-11;64403
2021-02-10;"Žilinský kraj";259;16779;259;17038;NA;68019;518;2021-02-10;63882
2021-02-09;"Žilinský kraj";377;24921;278;25199;NA;68019;655;2021-02-09;63364
2021-02-08;"Žilinský kraj";160;43415;408;43823;NA;68019;568;2021-02-08;62709
2021-02-07;"Žilinský kraj";24;38440;199;38639;NA;68019;223;2021-02-07;62141
2021-02-06;"Žilinský kraj";71;66243;325;66568;NA;68019;396;2021-02-06;61918
2021-02-05;"Žilinský kraj";248;30539;293;30832;NA;68019;541;2021-02-05;61522
2021-02-04;"Žilinský kraj";238;11307;232;11539;NA;68019;470;2021-02-04;60981
2021-02-03;"Žilinský kraj";194;8750;252;9002;NA;68019;446;2021-02-03;60511
2021-02-02;"Žilinský kraj";216;9807;280;10087;NA;68019;496;2021-02-02;60065
2021-02-01;"Žilinský kraj";220;18627;334;18961;NA;68019;554;2021-02-01;59569
2021-01-31;"Žilinský kraj";11;42;1;43;NA;68019;12;2021-01-31;59015
2021-01-30;"Žilinský kraj";85;15377;156;15533;NA;68019;241;2021-01-30;59003
2021-01-29;"Žilinský kraj";30;17212;214;17426;NA;68019;244;2021-01-29;58762
2021-01-28;"Žilinský kraj";240;5598;174;5772;NA;68019;414;2021-01-28;58518
2021-01-27;"Žilinský kraj";256;6977;123;7100;NA;68019;379;2021-01-27;58104
2021-01-26;"Žilinský kraj";245;49404;342;49746;NA;68019;587;2021-01-26;57725
2021-01-25;"Žilinský kraj";159;18615;131;18746;NA;68019;290;2021-01-25;57138
2021-01-24;"Žilinský kraj";22;32472;138;32610;NA;68019;160;2021-01-24;56848
2021-01-23;"Žilinský kraj";91;88106;395;88501;NA;68019;486;2021-01-23;56688
2021-01-22;"Žilinský kraj";163;28047;228;28275;NA;68019;391;2021-01-22;56202
2021-01-21;"Žilinský kraj";116;19351;178;19529;NA;68019;294;2021-01-21;55811
2021-01-20;"Žilinský kraj";236;16958;165;17123;NA;68019;401;2021-01-20;55517
2021-01-19;"Žilinský kraj";245;17570;405;17975;NA;68019;650;2021-01-19;55116
2021-01-18;"Žilinský kraj";236;12487;334;12821;NA;68019;570;2021-01-18;54466
2021-01-17;"Žilinský kraj";95;113;2;115;NA;68019;97;2021-01-17;53896
2021-01-16;"Žilinský kraj";14;314;8;322;NA;68019;22;2021-01-16;53799
2021-01-15;"Žilinský kraj";248;7149;202;7351;NA;68019;450;2021-01-15;53777
2021-01-14;"Žilinský kraj";166;5637;253;5890;NA;68019;419;2021-01-14;53327
2021-01-13;"Žilinský kraj";247;11341;554;11895;NA;68019;801;2021-01-13;52908
2021-01-12;"Žilinský kraj";376;8924;426;9350;NA;68019;802;2021-01-12;52107
2021-01-11;"Žilinský kraj";351;10485;510;10995;NA;68019;861;2021-01-11;51305
2021-01-10;"Žilinský kraj";38;189;7;196;NA;68019;45;2021-01-10;50444
2021-01-09;"Žilinský kraj";192;1992;85;2077;NA;68019;277;2021-01-09;50399
2021-01-08;"Žilinský kraj";413;9352;511;9863;NA;68019;924;2021-01-08;50122
2021-01-07;"Žilinský kraj";438;23644;1880;25524;NA;68019;2318;2021-01-07;49198
2021-01-06;"Žilinský kraj";145;1338;89;1427;NA;68019;234;2021-01-06;46880
2021-01-05;"Žilinský kraj";717;11310;929;12239;NA;68019;1646;2021-01-05;46646
2021-01-04;"Žilinský kraj";479;9549;949;10498;NA;68019;1428;2021-01-04;45000
2021-01-03;"Žilinský kraj";13;33;4;37;NA;68019;17;2021-01-03;43572
2021-01-02;"Žilinský kraj";98;746;86;832;NA;68019;184;2021-01-02;43555
2021-01-01;"Žilinský kraj";118;552;36;588;NA;68019;154;2021-01-01;43371
2020-12-31;"Žilinský kraj";395;10348;833;11181;NA;68019;1228;2020-12-31;43217
2020-12-30;"Žilinský kraj";1038;12157;860;13017;NA;68019;1898;2020-12-30;41989
2020-12-29;"Žilinský kraj";256;10800;1070;11870;NA;68019;1326;2020-12-29;40091
2020-12-28;"Žilinský kraj";406;10770;1002;11772;NA;68019;1408;2020-12-28;38765
2020-12-27;"Žilinský kraj";40;662;80;742;NA;68019;120;2020-12-27;37357
2020-12-26;"Žilinský kraj";135;124;14;138;NA;68019;149;2020-12-26;37237
2020-12-25;"Žilinský kraj";66;111;10;121;NA;68019;76;2020-12-25;37088
2020-12-24;"Žilinský kraj";643;1018;75;1093;NA;68019;718;2020-12-24;37012
2020-12-23;"Žilinský kraj";228;17258;1012;18270;NA;68019;1240;2020-12-23;36294
2020-12-22;"Žilinský kraj";519;13188;1023;14211;NA;68019;1542;2020-12-22;35054
2020-12-21;"Žilinský kraj";444;12703;1107;13810;NA;68019;1551;2020-12-21;33512
2020-12-20;"Žilinský kraj";36;579;73;652;NA;68019;109;2020-12-20;31961
2020-12-19;"Žilinský kraj";208;2080;144;2224;NA;68019;352;2020-12-19;31852
2020-12-18;"Žilinský kraj";333;7027;402;7429;NA;68019;735;2020-12-18;31500
2020-12-17;"Žilinský kraj";500;4333;281;4614;NA;68019;781;2020-12-17;30765
2020-12-16;"Žilinský kraj";333;4365;305;4670;NA;68019;638;2020-12-16;29984
2020-12-15;"Žilinský kraj";528;4399;387;4786;NA;68019;915;2020-12-15;29346
2020-12-14;"Žilinský kraj";321;4401;358;4759;NA;68019;679;2020-12-14;28431
2020-12-13;"Žilinský kraj";26;515;64;579;NA;68019;90;2020-12-13;27752
2020-12-12;"Žilinský kraj";95;1061;53;1114;NA;68019;148;2020-12-12;27662
2020-12-11;"Žilinský kraj";455;4596;282;4878;NA;68019;737;2020-12-11;27514
2020-12-10;"Žilinský kraj";166;9407;849;10256;NA;68019;1015;2020-12-10;26777
2020-12-09;"Žilinský kraj";392;2559;163;2722;NA;68019;555;2020-12-09;25762
2020-12-08;"Žilinský kraj";331;3915;188;4103;NA;68019;519;2020-12-08;25207
2020-12-07;"Žilinský kraj";348;2274;121;2395;NA;68019;469;2020-12-07;24688
2020-12-06;"Žilinský kraj";15;134;4;138;NA;68019;19;2020-12-06;24219
2020-12-05;"Žilinský kraj";98;1237;45;1282;NA;68019;143;2020-12-05;24200
2020-12-04;"Žilinský kraj";228;2847;120;2967;NA;68019;348;2020-12-04;24057
2020-12-03;"Žilinský kraj";237;1412;119;1531;NA;68019;356;2020-12-03;23709
2020-12-02;"Žilinský kraj";181;1553;82;1635;NA;68019;263;2020-12-02;23353
2020-12-01;"Žilinský kraj";209;6529;309;6838;NA;68019;518;2020-12-01;23090
2020-11-30;"Žilinský kraj";202;5232;291;5523;NA;68019;493;2020-11-30;22572
2020-11-29;"Žilinský kraj";18;81;7;88;NA;68019;25;2020-11-29;22079
2020-11-28;"Žilinský kraj";99;349;15;364;NA;68019;114;2020-11-28;22054
2020-11-27;"Žilinský kraj";218;913;46;959;NA;68019;264;2020-11-27;21940
2020-11-26;"Žilinský kraj";189;1104;57;1161;NA;68019;246;2020-11-26;21676
2020-11-25;"Žilinský kraj";225;1217;49;1266;NA;68019;274;2020-11-25;21430
2020-11-24;"Žilinský kraj";213;2092;67;2159;NA;68019;280;2020-11-24;21156
2020-11-23;"Žilinský kraj";170;759;44;803;NA;68019;214;2020-11-23;20876
2020-11-22;"Žilinský kraj";11;0;0;0;NA;68019;11;2020-11-22;20662
2020-11-21;"Žilinský kraj";61;505;20;525;NA;68019;81;2020-11-21;20651
2020-11-20;"Žilinský kraj";251;1074;45;1119;NA;68019;296;2020-11-20;20570
2020-11-19;"Žilinský kraj";252;752;61;813;NA;68019;313;2020-11-19;20274
2020-11-18;"Žilinský kraj";346;348;15;363;NA;68019;361;2020-11-18;19961
2020-11-17;"Žilinský kraj";123;490;15;505;NA;68019;138;2020-11-17;19600
2020-11-16;"Žilinský kraj";227;206;13;219;NA;68019;240;2020-11-16;19462
2020-11-15;"Žilinský kraj";63;13;0;13;NA;68019;63;2020-11-15;19222
2020-11-14;"Žilinský kraj";189;1038;11;1049;NA;68019;200;2020-11-14;19159
2020-11-13;"Žilinský kraj";181;125;9;134;NA;68019;190;2020-11-13;18959
2020-11-12;"Žilinský kraj";334;79;2;81;NA;68019;336;2020-11-12;18769
2020-11-11;"Žilinský kraj";489;147;10;157;NA;68019;499;2020-11-11;18433
2020-11-10;"Žilinský kraj";374;519;9;528;NA;68019;383;2020-11-10;17934
2020-11-09;"Žilinský kraj";143;2335;30;2365;NA;68019;173;2020-11-09;17551
2020-11-08;"Žilinský kraj";59;2196;35;2231;NA;68019;94;2020-11-08;17378
2020-11-07;"Žilinský kraj";312;8175;88;8263;NA;68019;400;2020-11-07;17284
2020-11-06;"Žilinský kraj";503;4090;38;4128;NA;68019;541;2020-11-06;16884
2020-11-05;"Žilinský kraj";473;64;4;68;NA;68019;477;2020-11-05;16343
2020-11-04;"Žilinský kraj";423;168;10;178;NA;68019;433;2020-11-04;15866
2020-11-03;"Žilinský kraj";688;889;16;905;NA;68019;704;2020-11-03;15433
2020-11-02;"Žilinský kraj";472;1043;39;1082;NA;68019;511;2020-11-02;14729
2020-11-01;"Žilinský kraj";349;5096;130;5226;NA;68019;479;2020-11-01;14218
2020-10-31;"Žilinský kraj";662;7963;203;8166;NA;68019;865;2020-10-31;13739
2020-10-30;"Žilinský kraj";529;2575;61;2636;NA;68019;590;2020-10-30;12874
2020-10-29;"Žilinský kraj";740;503;17;520;NA;68019;757;2020-10-29;12284
2020-10-28;"Žilinský kraj";635;105;11;116;NA;68019;646;2020-10-28;11527
2020-10-27;"Žilinský kraj";355;154;24;178;NA;68019;379;2020-10-27;10881
2020-10-26;"Žilinský kraj";148;117;28;145;NA;68019;176;2020-10-26;10502
2020-10-25;"Žilinský kraj";436;0;0;0;NA;68019;436;2020-10-25;10326
2020-10-24;"Žilinský kraj";803;0;0;0;NA;68019;803;2020-10-24;9890
2020-10-23;"Žilinský kraj";659;102;13;115;NA;68019;672;2020-10-23;9087
2020-10-22;"Žilinský kraj";525;33;3;36;NA;68019;528;2020-10-22;8415
2020-10-21;"Žilinský kraj";478;74;14;88;NA;68019;492;2020-10-21;7887
2020-10-20;"Žilinský kraj";524;127;8;135;NA;68019;532;2020-10-20;7395
2020-10-19;"Žilinský kraj";70;80;12;92;NA;68019;82;2020-10-19;6863
2020-10-18;"Žilinský kraj";159;0;0;0;NA;68019;159;2020-10-18;6781
2020-10-17;"Žilinský kraj";509;0;0;0;NA;68019;509;2020-10-17;6622
2020-10-16;"Žilinský kraj";603;51;9;60;NA;68019;612;2020-10-16;6113
2020-10-15;"Žilinský kraj";679;61;3;64;NA;68019;682;2020-10-15;5501
2020-10-14;"Žilinský kraj";523;269;6;275;NA;68019;529;2020-10-14;4819
2020-10-13;"Žilinský kraj";367;458;40;498;NA;68019;407;2020-10-13;4290
2020-10-12;"Žilinský kraj";62;0;0;0;NA;68019;62;2020-10-12;3883
2020-10-11;"Žilinský kraj";50;0;0;0;NA;68019;50;2020-10-11;3821
2020-10-10;"Žilinský kraj";213;0;0;0;NA;68019;213;2020-10-10;3771
2020-10-09;"Žilinský kraj";543;0;0;0;NA;68019;543;2020-10-09;3558
2020-10-08;"Žilinský kraj";238;0;0;0;NA;68019;238;2020-10-08;3015
2020-10-07;"Žilinský kraj";168;0;0;0;NA;68019;168;2020-10-07;2777
2020-10-06;"Žilinský kraj";233;0;0;0;NA;68019;233;2020-10-06;2609
2020-10-05;"Žilinský kraj";33;0;0;0;NA;68019;33;2020-10-05;2376
2020-10-04;"Žilinský kraj";35;0;0;0;NA;68019;35;2020-10-04;2343
2020-10-03;"Žilinský kraj";155;0;0;0;NA;68019;155;2020-10-03;2308
2020-10-02;"Žilinský kraj";105;0;0;0;NA;68019;105;2020-10-02;2153
2020-10-01;"Žilinský kraj";147;0;0;0;NA;68019;147;2020-10-01;2048
2020-09-30;"Žilinský kraj";163;0;0;0;NA;68019;163;2020-09-30;1901
2020-09-29;"Žilinský kraj";105;0;0;0;NA;68019;105;2020-09-29;1738
2020-09-28;"Žilinský kraj";34;0;0;0;NA;68019;34;2020-09-28;1633
2020-09-27;"Žilinský kraj";108;0;0;0;NA;68019;108;2020-09-27;1599
2020-09-26;"Žilinský kraj";96;0;0;0;NA;68019;96;2020-09-26;1491
2020-09-25;"Žilinský kraj";69;0;0;0;NA;68019;69;2020-09-25;1395
2020-09-24;"Žilinský kraj";100;0;0;0;NA;68019;100;2020-09-24;1326
2020-09-23;"Žilinský kraj";65;0;0;0;NA;68019;65;2020-09-23;1226
2020-09-22;"Žilinský kraj";65;0;0;0;NA;68019;65;2020-09-22;1161
2020-09-21;"Žilinský kraj";47;0;0;0;NA;68019;47;2020-09-21;1096
2020-09-20;"Žilinský kraj";4;0;0;0;NA;68019;4;2020-09-20;1049
2020-09-19;"Žilinský kraj";6;0;0;0;NA;68019;6;2020-09-19;1045
2020-09-18;"Žilinský kraj";82;0;0;0;NA;68019;82;2020-09-18;1039
2020-09-17;"Žilinský kraj";30;0;0;0;NA;68019;30;2020-09-17;957
2020-09-16;"Žilinský kraj";34;0;0;0;NA;68019;34;2020-09-16;927
2020-09-15;"Žilinský kraj";12;0;0;0;NA;68019;12;2020-09-15;893
2020-09-14;"Žilinský kraj";39;0;0;0;NA;68019;39;2020-09-14;881
2020-09-13;"Žilinský kraj";6;0;0;0;NA;68019;6;2020-09-13;842
2020-09-12;"Žilinský kraj";4;0;0;0;NA;68019;4;2020-09-12;836
2020-09-11;"Žilinský kraj";31;0;0;0;NA;68019;31;2020-09-11;832
2020-09-10;"Žilinský kraj";31;0;0;0;NA;68019;31;2020-09-10;801
2020-09-09;"Žilinský kraj";23;0;0;0;NA;68019;23;2020-09-09;770
2020-09-08;"Žilinský kraj";25;0;0;0;NA;68019;25;2020-09-08;747
2020-09-07;"Žilinský kraj";11;0;0;0;NA;68019;11;2020-09-07;722
2020-09-05;"Žilinský kraj";2;0;0;0;NA;68019;2;2020-09-05;711
2020-09-04;"Žilinský kraj";33;0;0;0;NA;68019;33;2020-09-04;709
2020-09-03;"Žilinský kraj";18;0;0;0;NA;68019;18;2020-09-03;676
