"Datum";"Region";"PCR_Pos";"Ag_Neg";"Ag_Pos";"Total";"Pocet.potvrdenych";"Potvrdenych";"newcases";"date";"positive"
2021-05-30;"Banskobystrický kraj";3;8945;19;8964;37911;80348;22;2021-05-30;80348
2021-05-29;"Banskobystrický kraj";11;8816;9;8825;NA;80348;20;2021-05-29;80326
2021-05-28;"Banskobystrický kraj";13;11662;27;11689;NA;80348;40;2021-05-28;80306
2021-05-27;"Banskobystrický kraj";7;8620;12;8632;NA;80348;19;2021-05-27;80266
2021-05-26;"Banskobystrický kraj";18;7906;16;7922;NA;80348;34;2021-05-26;80247
2021-05-25;"Banskobystrický kraj";27;8840;30;8870;NA;80348;57;2021-05-25;80213
2021-05-24;"Banskobystrický kraj";9;12341;44;12385;NA;80348;53;2021-05-24;80156
2021-05-23;"Banskobystrický kraj";0;9798;27;9825;NA;80348;27;2021-05-23;80103
2021-05-22;"Banskobystrický kraj";20;9576;26;9602;NA;80348;46;2021-05-22;80076
2021-05-21;"Banskobystrický kraj";22;12708;25;12733;NA;80348;47;2021-05-21;80030
2021-05-20;"Banskobystrický kraj";14;8707;25;8732;NA;80348;39;2021-05-20;79983
2021-05-19;"Banskobystrický kraj";42;8608;21;8629;NA;80348;63;2021-05-19;79944
2021-05-18;"Banskobystrický kraj";27;9649;25;9674;NA;80348;52;2021-05-18;79881
2021-05-17;"Banskobystrický kraj";11;13251;33;13284;NA;80348;44;2021-05-17;79829
2021-05-16;"Banskobystrický kraj";15;14026;27;14053;NA;80348;42;2021-05-16;79785
2021-05-15;"Banskobystrický kraj";11;15218;27;15245;NA;80348;38;2021-05-15;79743
2021-05-14;"Banskobystrický kraj";35;18452;45;18497;NA;80348;80;2021-05-14;79705
2021-05-13;"Banskobystrický kraj";37;10405;40;10445;NA;80348;77;2021-05-13;79625
2021-05-12;"Banskobystrický kraj";31;10835;45;10880;NA;80348;76;2021-05-12;79548
2021-05-11;"Banskobystrický kraj";42;11636;47;11683;NA;80348;89;2021-05-11;79472
2021-05-10;"Banskobystrický kraj";28;17317;68;17385;NA;80348;96;2021-05-10;79383
2021-05-09;"Banskobystrický kraj";25;21903;67;21970;NA;80348;92;2021-05-09;79287
2021-05-08;"Banskobystrický kraj";11;14048;26;14074;NA;80348;37;2021-05-08;79195
2021-05-07;"Banskobystrický kraj";41;21898;78;21976;NA;80348;119;2021-05-07;79158
2021-05-06;"Banskobystrický kraj";36;12159;70;12229;NA;80348;106;2021-05-06;79039
2021-05-05;"Banskobystrický kraj";34;12592;63;12655;NA;80348;97;2021-05-05;78933
2021-05-04;"Banskobystrický kraj";83;13788;47;13835;NA;80348;130;2021-05-04;78836
2021-05-03;"Banskobystrický kraj";30;20872;80;20952;NA;80348;110;2021-05-03;78706
2021-05-02;"Banskobystrický kraj";6;32623;60;32683;NA;80348;66;2021-05-02;78596
2021-05-01;"Banskobystrický kraj";54;36770;67;36837;NA;80348;121;2021-05-01;78530
2021-04-30;"Banskobystrický kraj";38;0;0;0;NA;80348;38;2021-04-30;78409
2021-04-29;"Banskobystrický kraj";55;0;0;0;NA;80348;55;2021-04-29;78371
2021-04-28;"Banskobystrický kraj";66;0;0;0;NA;80348;66;2021-04-28;78316
2021-04-27;"Banskobystrický kraj";70;0;0;0;NA;80348;70;2021-04-27;78250
2021-04-26;"Banskobystrický kraj";34;0;0;0;NA;80348;34;2021-04-26;78180
2021-04-25;"Banskobystrický kraj";14;0;0;0;NA;80348;14;2021-04-25;78146
2021-04-24;"Banskobystrický kraj";40;0;0;0;NA;80348;40;2021-04-24;78132
2021-04-23;"Banskobystrický kraj";78;0;0;0;NA;80348;78;2021-04-23;78092
2021-04-22;"Banskobystrický kraj";51;0;0;0;NA;80348;51;2021-04-22;78014
2021-04-21;"Banskobystrický kraj";76;0;0;0;NA;80348;76;2021-04-21;77963
2021-04-20;"Banskobystrický kraj";116;0;0;0;NA;80348;116;2021-04-20;77887
2021-04-19;"Banskobystrický kraj";48;0;0;0;NA;80348;48;2021-04-19;77771
2021-04-18;"Banskobystrický kraj";16;0;0;0;NA;80348;16;2021-04-18;77723
2021-04-17;"Banskobystrický kraj";42;0;0;0;NA;80348;42;2021-04-17;77707
2021-04-16;"Banskobystrický kraj";72;0;0;0;NA;80348;72;2021-04-16;77665
2021-04-15;"Banskobystrický kraj";67;0;0;0;NA;80348;67;2021-04-15;77593
2021-04-14;"Banskobystrický kraj";69;0;0;0;NA;80348;69;2021-04-14;77526
2021-04-13;"Banskobystrický kraj";130;0;0;0;NA;80348;130;2021-04-13;77457
2021-04-12;"Banskobystrický kraj";60;0;0;0;NA;80348;60;2021-04-12;77327
2021-04-11;"Banskobystrický kraj";0;0;0;0;NA;80348;0;2021-04-11;77267
2021-04-10;"Banskobystrický kraj";56;0;0;0;NA;80348;56;2021-04-10;77267
2021-04-09;"Banskobystrický kraj";106;0;0;0;NA;80348;106;2021-04-09;77211
2021-04-08;"Banskobystrický kraj";132;0;0;0;NA;80348;132;2021-04-08;77105
2021-04-07;"Banskobystrický kraj";226;0;0;0;NA;80348;226;2021-04-07;76973
2021-04-06;"Banskobystrický kraj";93;0;0;0;NA;80348;93;2021-04-06;76747
2021-04-05;"Banskobystrický kraj";15;0;0;0;NA;80348;15;2021-04-05;76654
2021-04-04;"Banskobystrický kraj";24;0;0;0;NA;80348;24;2021-04-04;76639
2021-04-03;"Banskobystrický kraj";5;0;0;0;NA;80348;5;2021-04-03;76615
2021-04-02;"Banskobystrický kraj";71;0;0;0;NA;80348;71;2021-04-02;76610
2021-04-01;"Banskobystrický kraj";171;0;0;0;NA;80348;171;2021-04-01;76539
2021-03-31;"Banskobystrický kraj";147;25543;161;25704;NA;80348;308;2021-03-31;76368
2021-03-30;"Banskobystrický kraj";167;21439;159;21598;NA;80348;326;2021-03-30;76060
2021-03-29;"Banskobystrický kraj";119;29491;218;29709;NA;80348;337;2021-03-29;75734
2021-03-28;"Banskobystrický kraj";25;40610;189;40799;NA;80348;214;2021-03-28;75397
2021-03-27;"Banskobystrický kraj";85;64652;264;64916;NA;80348;349;2021-03-27;75183
2021-03-26;"Banskobystrický kraj";122;43397;240;43637;NA;80348;362;2021-03-26;74834
2021-03-25;"Banskobystrický kraj";120;21589;240;21829;NA;80348;360;2021-03-25;74472
2021-03-24;"Banskobystrický kraj";200;19319;227;19546;NA;80348;427;2021-03-24;74112
2021-03-23;"Banskobystrický kraj";241;21398;257;21655;NA;80348;498;2021-03-23;73685
2021-03-22;"Banskobystrický kraj";65;30418;274;30692;NA;80348;339;2021-03-22;73187
2021-03-21;"Banskobystrický kraj";31;40039;280;40319;NA;80348;311;2021-03-21;72848
2021-03-20;"Banskobystrický kraj";119;67730;383;68113;NA;80348;502;2021-03-20;72537
2021-03-19;"Banskobystrický kraj";240;44041;307;44348;NA;80348;547;2021-03-19;72035
2021-03-18;"Banskobystrický kraj";160;21727;273;22000;NA;80348;433;2021-03-18;71488
2021-03-17;"Banskobystrický kraj";262;21573;245;21818;NA;80348;507;2021-03-17;71055
2021-03-16;"Banskobystrický kraj";340;23365;224;23589;NA;80348;564;2021-03-16;70548
2021-03-15;"Banskobystrický kraj";95;31133;364;31497;NA;80348;459;2021-03-15;69984
2021-03-14;"Banskobystrický kraj";39;40650;229;40879;NA;80348;268;2021-03-14;69525
2021-03-13;"Banskobystrický kraj";209;67167;391;67558;NA;80348;600;2021-03-13;69257
2021-03-12;"Banskobystrický kraj";206;41485;330;41815;NA;80348;536;2021-03-12;68657
2021-03-11;"Banskobystrický kraj";228;21337;272;21609;NA;80348;500;2021-03-11;68121
2021-03-10;"Banskobystrický kraj";260;20381;238;20619;NA;80348;498;2021-03-10;67621
2021-03-09;"Banskobystrický kraj";352;21790;284;22074;NA;80348;636;2021-03-09;67123
2021-03-08;"Banskobystrický kraj";191;31488;427;31915;NA;80348;618;2021-03-08;66487
2021-03-07;"Banskobystrický kraj";60;39083;295;39378;NA;80348;355;2021-03-07;65869
2021-03-06;"Banskobystrický kraj";164;70562;410;70972;NA;80348;574;2021-03-06;65514
2021-03-05;"Banskobystrický kraj";221;42137;388;42525;NA;80348;609;2021-03-05;64940
2021-03-04;"Banskobystrický kraj";226;21607;334;21941;NA;80348;560;2021-03-04;64331
2021-03-03;"Banskobystrický kraj";317;21949;331;22280;NA;80348;648;2021-03-03;63771
2021-03-02;"Banskobystrický kraj";291;22602;354;22956;NA;80348;645;2021-03-02;63123
2021-03-01;"Banskobystrický kraj";151;31773;434;32207;NA;80348;585;2021-03-01;62478
2021-02-28;"Banskobystrický kraj";45;38313;336;38649;NA;80348;381;2021-02-28;61893
2021-02-27;"Banskobystrický kraj";289;66667;529;67196;NA;80348;818;2021-02-27;61512
2021-02-26;"Banskobystrický kraj";326;39489;468;39957;NA;80348;794;2021-02-26;60694
2021-02-25;"Banskobystrický kraj";375;17731;366;18097;NA;80348;741;2021-02-25;59900
2021-02-24;"Banskobystrický kraj";332;16735;373;17108;NA;80348;705;2021-02-24;59159
2021-02-23;"Banskobystrický kraj";462;19480;439;19919;NA;80348;901;2021-02-23;58454
2021-02-22;"Banskobystrický kraj";67;28643;598;29241;NA;80348;665;2021-02-22;57553
2021-02-21;"Banskobystrický kraj";68;37464;437;37901;NA;80348;505;2021-02-21;56888
2021-02-20;"Banskobystrický kraj";280;68851;598;69449;NA;80348;878;2021-02-20;56383
2021-02-19;"Banskobystrický kraj";420;39632;511;40143;NA;80348;931;2021-02-19;55505
2021-02-18;"Banskobystrický kraj";241;18618;396;19014;NA;80348;637;2021-02-18;54574
2021-02-17;"Banskobystrický kraj";415;16312;389;16701;NA;80348;804;2021-02-17;53937
2021-02-16;"Banskobystrický kraj";338;19933;369;20302;NA;80348;707;2021-02-16;53133
2021-02-15;"Banskobystrický kraj";118;35835;591;36426;NA;80348;709;2021-02-15;52426
2021-02-14;"Banskobystrický kraj";60;31894;386;32280;NA;80348;446;2021-02-14;51717
2021-02-13;"Banskobystrický kraj";202;53889;492;54381;NA;80348;694;2021-02-13;51271
2021-02-12;"Banskobystrický kraj";312;36620;533;37153;NA;80348;845;2021-02-12;50577
2021-02-11;"Banskobystrický kraj";305;20825;386;21211;NA;80348;691;2021-02-11;49732
2021-02-10;"Banskobystrický kraj";333;14790;344;15134;NA;80348;677;2021-02-10;49041
2021-02-09;"Banskobystrický kraj";329;18504;362;18866;NA;80348;691;2021-02-09;48364
2021-02-08;"Banskobystrický kraj";103;46804;672;47476;NA;80348;775;2021-02-08;47673
2021-02-07;"Banskobystrický kraj";70;37363;333;37696;NA;80348;403;2021-02-07;46898
2021-02-06;"Banskobystrický kraj";178;69638;570;70208;NA;80348;748;2021-02-06;46495
2021-02-05;"Banskobystrický kraj";282;24577;363;24940;NA;80348;645;2021-02-05;45747
2021-02-04;"Banskobystrický kraj";240;13842;430;14272;NA;80348;670;2021-02-04;45102
2021-02-03;"Banskobystrický kraj";350;9429;255;9684;NA;80348;605;2021-02-03;44432
2021-02-02;"Banskobystrický kraj";277;15740;334;16074;NA;80348;611;2021-02-02;43827
2021-02-01;"Banskobystrický kraj";75;24723;496;25219;NA;80348;571;2021-02-01;43216
2021-01-31;"Banskobystrický kraj";34;19983;201;20184;NA;80348;235;2021-01-31;42645
2021-01-30;"Banskobystrický kraj";163;64086;525;64611;NA;80348;688;2021-01-30;42410
2021-01-29;"Banskobystrický kraj";196;17360;269;17629;NA;80348;465;2021-01-29;41722
2021-01-28;"Banskobystrický kraj";218;14229;372;14601;NA;80348;590;2021-01-28;41257
2021-01-27;"Banskobystrický kraj";191;8128;200;8328;NA;80348;391;2021-01-27;40667
2021-01-26;"Banskobystrický kraj";238;19798;283;20081;NA;80348;521;2021-01-26;40276
2021-01-25;"Banskobystrický kraj";82;33666;412;34078;NA;80348;494;2021-01-25;39755
2021-01-24;"Banskobystrický kraj";38;35587;278;35865;NA;80348;316;2021-01-24;39261
2021-01-23;"Banskobystrický kraj";142;89295;530;89825;NA;80348;672;2021-01-23;38945
2021-01-22;"Banskobystrický kraj";175;27148;361;27509;NA;80348;536;2021-01-22;38273
2021-01-21;"Banskobystrický kraj";194;17308;285;17593;NA;80348;479;2021-01-21;37737
2021-01-20;"Banskobystrický kraj";231;9150;188;9338;NA;80348;419;2021-01-20;37258
2021-01-19;"Banskobystrický kraj";213;10708;311;11019;NA;80348;524;2021-01-19;36839
2021-01-18;"Banskobystrický kraj";94;7415;402;7817;NA;80348;496;2021-01-18;36315
2021-01-17;"Banskobystrický kraj";110;8154;77;8231;NA;80348;187;2021-01-17;35819
2021-01-16;"Banskobystrický kraj";58;2274;57;2331;NA;80348;115;2021-01-16;35632
2021-01-15;"Banskobystrický kraj";164;7673;217;7890;NA;80348;381;2021-01-15;35517
2021-01-14;"Banskobystrický kraj";220;5760;325;6085;NA;80348;545;2021-01-14;35136
2021-01-13;"Banskobystrický kraj";235;5974;217;6191;NA;80348;452;2021-01-13;34591
2021-01-12;"Banskobystrický kraj";194;6808;299;7107;NA;80348;493;2021-01-12;34139
2021-01-11;"Banskobystrický kraj";76;8231;481;8712;NA;80348;557;2021-01-11;33646
2021-01-10;"Banskobystrický kraj";110;233;4;237;NA;80348;114;2021-01-10;33089
2021-01-09;"Banskobystrický kraj";297;2378;81;2459;NA;80348;378;2021-01-09;32975
2021-01-08;"Banskobystrický kraj";435;9677;443;10120;NA;80348;878;2021-01-08;32597
2021-01-07;"Banskobystrický kraj";127;6322;366;6688;NA;80348;493;2021-01-07;31719
2021-01-06;"Banskobystrický kraj";305;3124;185;3309;NA;80348;490;2021-01-06;31226
2021-01-05;"Banskobystrický kraj";372;7349;533;7882;NA;80348;905;2021-01-05;30736
2021-01-04;"Banskobystrický kraj";130;7083;700;7783;NA;80348;830;2021-01-04;29831
2021-01-03;"Banskobystrický kraj";199;320;19;339;NA;80348;218;2021-01-03;29001
2021-01-02;"Banskobystrický kraj";123;702;85;787;NA;80348;208;2021-01-02;28783
2021-01-01;"Banskobystrický kraj";220;1958;132;2090;NA;80348;352;2021-01-01;28575
2020-12-31;"Banskobystrický kraj";499;7379;633;8012;NA;80348;1132;2020-12-31;28223
2020-12-30;"Banskobystrický kraj";593;7670;557;8227;NA;80348;1150;2020-12-30;27091
2020-12-29;"Banskobystrický kraj";240;7955;664;8619;NA;80348;904;2020-12-29;25941
2020-12-28;"Banskobystrický kraj";131;6098;711;6809;NA;80348;842;2020-12-28;25037
2020-12-27;"Banskobystrický kraj";116;541;25;566;NA;80348;141;2020-12-27;24195
2020-12-26;"Banskobystrický kraj";61;295;35;330;NA;80348;96;2020-12-26;24054
2020-12-25;"Banskobystrický kraj";65;313;10;323;NA;80348;75;2020-12-25;23958
2020-12-24;"Banskobystrický kraj";452;3685;135;3820;NA;80348;587;2020-12-24;23883
2020-12-23;"Banskobystrický kraj";368;10116;507;10623;NA;80348;875;2020-12-23;23296
2020-12-22;"Banskobystrický kraj";307;8449;624;9073;NA;80348;931;2020-12-22;22421
2020-12-21;"Banskobystrický kraj";286;4896;448;5344;NA;80348;734;2020-12-21;21490
2020-12-20;"Banskobystrický kraj";155;249;14;263;NA;80348;169;2020-12-20;20756
2020-12-19;"Banskobystrický kraj";170;3084;138;3222;NA;80348;308;2020-12-19;20587
2020-12-18;"Banskobystrický kraj";432;5965;324;6289;NA;80348;756;2020-12-18;20279
2020-12-17;"Banskobystrický kraj";468;8703;656;9359;NA;80348;1124;2020-12-17;19523
2020-12-16;"Banskobystrický kraj";379;10202;560;10762;NA;80348;939;2020-12-16;18399
2020-12-15;"Banskobystrický kraj";336;5425;433;5858;NA;80348;769;2020-12-15;17460
2020-12-14;"Banskobystrický kraj";148;3897;259;4156;NA;80348;407;2020-12-14;16691
2020-12-13;"Banskobystrický kraj";122;142;1;143;NA;80348;123;2020-12-13;16284
2020-12-12;"Banskobystrický kraj";137;2714;138;2852;NA;80348;275;2020-12-12;16161
2020-12-11;"Banskobystrický kraj";468;6587;374;6961;NA;80348;842;2020-12-11;15886
2020-12-10;"Banskobystrický kraj";280;5204;355;5559;NA;80348;635;2020-12-10;15044
2020-12-09;"Banskobystrický kraj";323;3850;213;4063;NA;80348;536;2020-12-09;14409
2020-12-08;"Banskobystrický kraj";256;3787;276;4063;NA;80348;532;2020-12-08;13873
2020-12-07;"Banskobystrický kraj";175;2380;156;2536;NA;80348;331;2020-12-07;13341
2020-12-06;"Banskobystrický kraj";121;507;11;518;NA;80348;132;2020-12-06;13010
2020-12-05;"Banskobystrický kraj";109;1099;34;1133;NA;80348;143;2020-12-05;12878
2020-12-04;"Banskobystrický kraj";339;3828;174;4002;NA;80348;513;2020-12-04;12735
2020-12-03;"Banskobystrický kraj";240;3193;234;3427;NA;80348;474;2020-12-03;12222
2020-12-02;"Banskobystrický kraj";217;4442;186;4628;NA;80348;403;2020-12-02;11748
2020-12-01;"Banskobystrický kraj";215;2702;134;2836;NA;80348;349;2020-12-01;11345
2020-11-30;"Banskobystrický kraj";74;4559;257;4816;NA;80348;331;2020-11-30;10996
2020-11-29;"Banskobystrický kraj";19;208;7;215;NA;80348;26;2020-11-29;10665
2020-11-28;"Banskobystrický kraj";81;1408;55;1463;NA;80348;136;2020-11-28;10639
2020-11-27;"Banskobystrický kraj";219;2266;123;2389;NA;80348;342;2020-11-27;10503
2020-11-26;"Banskobystrický kraj";208;2124;93;2217;NA;80348;301;2020-11-26;10161
2020-11-25;"Banskobystrický kraj";170;1952;86;2038;NA;80348;256;2020-11-25;9860
2020-11-24;"Banskobystrický kraj";166;2566;69;2635;NA;80348;235;2020-11-24;9604
2020-11-23;"Banskobystrický kraj";66;10240;194;10434;NA;80348;260;2020-11-23;9369
2020-11-22;"Banskobystrický kraj";38;104;1;105;NA;80348;39;2020-11-22;9109
2020-11-21;"Banskobystrický kraj";52;904;14;918;NA;80348;66;2020-11-21;9070
2020-11-20;"Banskobystrický kraj";127;2005;107;2112;NA;80348;234;2020-11-20;9004
2020-11-19;"Banskobystrický kraj";170;1218;82;1300;NA;80348;252;2020-11-19;8770
2020-11-18;"Banskobystrický kraj";153;698;65;763;NA;80348;218;2020-11-18;8518
2020-11-17;"Banskobystrický kraj";52;578;35;613;NA;80348;87;2020-11-17;8300
2020-11-16;"Banskobystrický kraj";106;470;25;495;NA;80348;131;2020-11-16;8213
2020-11-15;"Banskobystrický kraj";52;301;4;305;NA;80348;56;2020-11-15;8082
2020-11-14;"Banskobystrický kraj";73;305;2;307;NA;80348;75;2020-11-14;8026
2020-11-13;"Banskobystrický kraj";157;552;11;563;NA;80348;168;2020-11-13;7951
2020-11-12;"Banskobystrický kraj";218;952;44;996;NA;80348;262;2020-11-12;7783
2020-11-11;"Banskobystrický kraj";224;437;9;446;NA;80348;233;2020-11-11;7521
2020-11-10;"Banskobystrický kraj";263;463;18;481;NA;80348;281;2020-11-10;7288
2020-11-09;"Banskobystrický kraj";80;2678;31;2709;NA;80348;111;2020-11-09;7007
2020-11-08;"Banskobystrický kraj";82;981;16;997;NA;80348;98;2020-11-08;6896
2020-11-07;"Banskobystrický kraj";164;8828;94;8922;NA;80348;258;2020-11-07;6798
2020-11-06;"Banskobystrický kraj";227;2496;16;2512;NA;80348;243;2020-11-06;6540
2020-11-05;"Banskobystrický kraj";240;290;33;323;NA;80348;273;2020-11-05;6297
2020-11-04;"Banskobystrický kraj";254;1366;13;1379;NA;80348;267;2020-11-04;6024
2020-11-03;"Banskobystrický kraj";246;1332;4;1336;NA;80348;250;2020-11-03;5757
2020-11-02;"Banskobystrický kraj";90;2909;65;2974;NA;80348;155;2020-11-02;5507
2020-11-01;"Banskobystrický kraj";101;2671;42;2713;NA;80348;143;2020-11-01;5352
2020-10-31;"Banskobystrický kraj";199;13516;116;13632;NA;80348;315;2020-10-31;5209
2020-10-30;"Banskobystrický kraj";254;2829;20;2849;NA;80348;274;2020-10-30;4894
2020-10-29;"Banskobystrický kraj";372;969;42;1011;NA;80348;414;2020-10-29;4620
2020-10-28;"Banskobystrický kraj";285;302;30;332;NA;80348;315;2020-10-28;4206
2020-10-27;"Banskobystrický kraj";266;654;40;694;NA;80348;306;2020-10-27;3891
2020-10-26;"Banskobystrický kraj";38;234;29;263;NA;80348;67;2020-10-26;3585
2020-10-25;"Banskobystrický kraj";50;140;11;151;NA;80348;61;2020-10-25;3518
2020-10-24;"Banskobystrický kraj";315;114;12;126;NA;80348;327;2020-10-24;3457
2020-10-23;"Banskobystrický kraj";231;230;29;259;NA;80348;260;2020-10-23;3130
2020-10-22;"Banskobystrický kraj";264;253;24;277;NA;80348;288;2020-10-22;2870
2020-10-21;"Banskobystrický kraj";209;266;3;269;NA;80348;212;2020-10-21;2582
2020-10-20;"Banskobystrický kraj";210;66;3;69;NA;80348;213;2020-10-20;2370
2020-10-19;"Banskobystrický kraj";27;73;12;85;NA;80348;39;2020-10-19;2157
2020-10-18;"Banskobystrický kraj";49;0;0;0;NA;80348;49;2020-10-18;2118
2020-10-17;"Banskobystrický kraj";91;0;0;0;NA;80348;91;2020-10-17;2069
2020-10-16;"Banskobystrický kraj";224;37;3;40;NA;80348;227;2020-10-16;1978
2020-10-15;"Banskobystrický kraj";133;29;1;30;NA;80348;134;2020-10-15;1751
2020-10-14;"Banskobystrický kraj";139;31;1;32;NA;80348;140;2020-10-14;1617
2020-10-13;"Banskobystrický kraj";151;169;11;180;NA;80348;162;2020-10-13;1477
2020-10-12;"Banskobystrický kraj";11;110;4;114;NA;80348;15;2020-10-12;1315
2020-10-11;"Banskobystrický kraj";14;0;0;0;NA;80348;14;2020-10-11;1300
2020-10-10;"Banskobystrický kraj";53;0;0;0;NA;80348;53;2020-10-10;1286
2020-10-09;"Banskobystrický kraj";128;0;0;0;NA;80348;128;2020-10-09;1233
2020-10-08;"Banskobystrický kraj";99;0;0;0;NA;80348;99;2020-10-08;1105
2020-10-07;"Banskobystrický kraj";124;0;0;0;NA;80348;124;2020-10-07;1006
2020-10-06;"Banskobystrický kraj";68;0;0;0;NA;80348;68;2020-10-06;882
2020-10-05;"Banskobystrický kraj";49;0;0;0;NA;80348;49;2020-10-05;814
2020-10-04;"Banskobystrický kraj";8;0;0;0;NA;80348;8;2020-10-04;765
2020-10-03;"Banskobystrický kraj";37;0;0;0;NA;80348;37;2020-10-03;757
2020-10-02;"Banskobystrický kraj";74;0;0;0;NA;80348;74;2020-10-02;720
2020-10-01;"Banskobystrický kraj";49;0;0;0;NA;80348;49;2020-10-01;646
2020-09-30;"Banskobystrický kraj";60;0;0;0;NA;80348;60;2020-09-30;597
2020-09-29;"Banskobystrický kraj";24;0;0;0;NA;80348;24;2020-09-29;537
2020-09-28;"Banskobystrický kraj";0;0;0;0;NA;80348;0;2020-09-28;513
2020-09-27;"Banskobystrický kraj";20;0;0;0;NA;80348;20;2020-09-27;513
2020-09-26;"Banskobystrický kraj";24;0;0;0;NA;80348;24;2020-09-26;493
2020-09-25;"Banskobystrický kraj";29;0;0;0;NA;80348;29;2020-09-25;469
2020-09-24;"Banskobystrický kraj";25;0;0;0;NA;80348;25;2020-09-24;440
2020-09-23;"Banskobystrický kraj";17;0;0;0;NA;80348;17;2020-09-23;415
2020-09-22;"Banskobystrický kraj";25;0;0;0;NA;80348;25;2020-09-22;398
2020-09-21;"Banskobystrický kraj";3;0;0;0;NA;80348;3;2020-09-21;373
2020-09-20;"Banskobystrický kraj";0;0;0;0;NA;80348;0;2020-09-20;370
2020-09-19;"Banskobystrický kraj";3;0;0;0;NA;80348;3;2020-09-19;370
2020-09-18;"Banskobystrický kraj";24;0;0;0;NA;80348;24;2020-09-18;367
2020-09-17;"Banskobystrický kraj";14;0;0;0;NA;80348;14;2020-09-17;343
2020-09-16;"Banskobystrický kraj";6;0;0;0;NA;80348;6;2020-09-16;329
2020-09-15;"Banskobystrický kraj";2;0;0;0;NA;80348;2;2020-09-15;323
2020-09-14;"Banskobystrický kraj";13;0;0;0;NA;80348;13;2020-09-14;321
2020-09-13;"Banskobystrický kraj";1;0;0;0;NA;80348;1;2020-09-13;308
2020-09-12;"Banskobystrický kraj";5;0;0;0;NA;80348;5;2020-09-12;307
2020-09-11;"Banskobystrický kraj";19;0;0;0;NA;80348;19;2020-09-11;302
2020-09-10;"Banskobystrický kraj";11;0;0;0;NA;80348;11;2020-09-10;283
2020-09-09;"Banskobystrický kraj";13;0;0;0;NA;80348;13;2020-09-09;272
2020-09-08;"Banskobystrický kraj";5;0;0;0;NA;80348;5;2020-09-08;259
2020-09-07;"Banskobystrický kraj";2;0;0;0;NA;80348;2;2020-09-07;254
2020-09-06;"Banskobystrický kraj";0;0;0;0;NA;80348;0;2020-09-06;252
2020-09-05;"Banskobystrický kraj";0;0;0;0;NA;80348;0;2020-09-05;252
2020-09-04;"Banskobystrický kraj";9;0;0;0;NA;80348;9;2020-09-04;252
2020-09-03;"Banskobystrický kraj";5;0;0;0;NA;80348;5;2020-09-03;243
2020-09-02;"Banskobystrický kraj";6;0;0;0;NA;80348;6;2020-09-02;238
2020-09-01;"Banskobystrický kraj";2;0;0;0;NA;80348;2;2020-09-01;232
2020-08-31;"Banskobystrický kraj";6;0;0;0;NA;80348;6;2020-08-31;230
2020-08-30;"Banskobystrický kraj";0;0;0;0;NA;80348;0;2020-08-30;224
2020-08-29;"Banskobystrický kraj";1;0;0;0;NA;80348;1;2020-08-29;224
2020-08-28;"Banskobystrický kraj";3;0;0;0;NA;80348;3;2020-08-28;223
2020-08-27;"Banskobystrický kraj";1;0;0;0;NA;80348;1;2020-08-27;220
2020-08-26;"Banskobystrický kraj";2;0;0;0;NA;80348;2;2020-08-26;219
2020-08-25;"Banskobystrický kraj";2;0;0;0;NA;80348;2;2020-08-25;217
2020-08-24;"Banskobystrický kraj";0;0;0;0;NA;80348;0;2020-08-24;215
2020-08-23;"Banskobystrický kraj";0;0;0;0;NA;80348;0;2020-08-23;215
2020-08-22;"Banskobystrický kraj";0;0;0;0;NA;80348;0;2020-08-22;215
2020-08-21;"Banskobystrický kraj";4;0;0;0;NA;80348;4;2020-08-21;215
2020-08-20;"Banskobystrický kraj";1;0;0;0;NA;80348;1;2020-08-20;211
2020-08-19;"Banskobystrický kraj";4;0;0;0;NA;80348;4;2020-08-19;210
2020-08-18;"Banskobystrický kraj";0;0;0;0;NA;80348;0;2020-08-18;206
2020-08-17;"Banskobystrický kraj";1;0;0;0;NA;80348;1;2020-08-17;206
2020-08-16;"Banskobystrický kraj";0;0;0;0;NA;80348;0;2020-08-16;205
2020-08-15;"Banskobystrický kraj";0;0;0;0;NA;80348;0;2020-08-15;205
2020-08-14;"Banskobystrický kraj";5;0;0;0;NA;80348;5;2020-08-14;205
2020-08-13;"Banskobystrický kraj";0;0;0;0;NA;80348;0;2020-08-13;200
2020-08-12;"Banskobystrický kraj";0;0;0;0;NA;80348;0;2020-08-12;200
2020-08-11;"Banskobystrický kraj";2;0;0;0;NA;80348;2;2020-08-11;200
2020-08-10;"Banskobystrický kraj";3;0;0;0;NA;80348;3;2020-08-10;198
2020-08-09;"Banskobystrický kraj";0;0;0;0;NA;80348;0;2020-08-09;195
2020-08-08;"Banskobystrický kraj";2;0;0;0;NA;80348;2;2020-08-08;195
2020-08-07;"Banskobystrický kraj";1;0;0;0;NA;80348;1;2020-08-07;193
2020-08-06;"Banskobystrický kraj";1;0;0;0;NA;80348;1;2020-08-06;192
2020-08-05;"Banskobystrický kraj";0;0;0;0;NA;80348;0;2020-08-05;191
2020-08-04;"Banskobystrický kraj";3;0;0;0;NA;80348;3;2020-08-04;191
2020-08-03;"Banskobystrický kraj";0;0;0;0;NA;80348;0;2020-08-03;188
2020-08-02;"Banskobystrický kraj";0;0;0;0;NA;80348;0;2020-08-02;188
2020-08-01;"Banskobystrický kraj";1;0;0;0;NA;80348;1;2020-08-01;188
2020-07-31;"Banskobystrický kraj";2;0;0;0;NA;80348;2;2020-07-31;187
2020-07-30;"Banskobystrický kraj";1;0;0;0;NA;80348;1;2020-07-30;185
2020-07-29;"Banskobystrický kraj";0;0;0;0;NA;80348;0;2020-07-29;184
2020-07-28;"Banskobystrický kraj";2;0;0;0;NA;80348;2;2020-07-28;184
2020-07-27;"Banskobystrický kraj";3;0;0;0;NA;80348;3;2020-07-27;182
2020-07-26;"Banskobystrický kraj";0;0;0;0;NA;80348;0;2020-07-26;179
2020-07-25;"Banskobystrický kraj";0;0;0;0;NA;80348;0;2020-07-25;179
2020-07-24;"Banskobystrický kraj";9;0;0;0;NA;80348;9;2020-07-24;179
2020-07-23;"Banskobystrický kraj";0;0;0;0;NA;80348;0;2020-07-23;170
2020-07-22;"Banskobystrický kraj";3;0;0;0;NA;80348;3;2020-07-22;170
2020-07-21;"Banskobystrický kraj";3;0;0;0;NA;80348;3;2020-07-21;167
2020-07-20;"Banskobystrický kraj";1;0;0;0;NA;80348;1;2020-07-20;164
2020-07-19;"Banskobystrický kraj";1;0;0;0;NA;80348;1;2020-07-19;163
2020-07-18;"Banskobystrický kraj";0;0;0;0;NA;80348;0;2020-07-18;162
2020-07-17;"Banskobystrický kraj";2;0;0;0;NA;80348;2;2020-07-17;162
2020-07-16;"Banskobystrický kraj";1;0;0;0;NA;80348;1;2020-07-16;160
2020-07-15;"Banskobystrický kraj";4;0;0;0;NA;80348;4;2020-07-15;159
2020-07-14;"Banskobystrický kraj";2;0;0;0;NA;80348;2;2020-07-14;155
2020-07-13;"Banskobystrický kraj";1;0;0;0;NA;80348;1;2020-07-13;153
2020-07-12;"Banskobystrický kraj";0;0;0;0;NA;80348;0;2020-07-12;152
2020-07-11;"Banskobystrický kraj";0;0;0;0;NA;80348;0;2020-07-11;152
2020-07-10;"Banskobystrický kraj";3;0;0;0;NA;80348;3;2020-07-10;152
2020-07-09;"Banskobystrický kraj";9;0;0;0;NA;80348;9;2020-07-09;149
2020-07-08;"Banskobystrický kraj";0;0;0;0;NA;80348;0;2020-07-08;140
2020-07-07;"Banskobystrický kraj";4;0;0;0;NA;80348;4;2020-07-07;140
2020-07-06;"Banskobystrický kraj";0;0;0;0;NA;80348;0;2020-07-06;136
2020-07-05;"Banskobystrický kraj";0;0;0;0;NA;80348;0;2020-07-05;136
2020-07-04;"Banskobystrický kraj";1;0;0;0;NA;80348;1;2020-07-04;136
2020-07-03;"Banskobystrický kraj";4;0;0;0;NA;80348;4;2020-07-03;135
2020-07-02;"Banskobystrický kraj";0;0;0;0;NA;80348;0;2020-07-02;131
2020-07-01;"Banskobystrický kraj";1;0;0;0;NA;80348;1;2020-07-01;131
2020-06-30;"Banskobystrický kraj";0;0;0;0;NA;80348;0;2020-06-30;130
2020-06-29;"Banskobystrický kraj";0;0;0;0;NA;80348;0;2020-06-29;130
2020-06-28;"Banskobystrický kraj";0;0;0;0;NA;80348;0;2020-06-28;130
2020-06-27;"Banskobystrický kraj";0;0;0;0;NA;80348;0;2020-06-27;130
2020-06-26;"Banskobystrický kraj";0;0;0;0;NA;80348;0;2020-06-26;130
2020-06-25;"Banskobystrický kraj";1;0;0;0;NA;80348;1;2020-06-25;130
2020-06-24;"Banskobystrický kraj";0;0;0;0;NA;80348;0;2020-06-24;129
2020-06-23;"Banskobystrický kraj";6;0;0;0;NA;80348;6;2020-06-23;129
2020-06-22;"Banskobystrický kraj";0;0;0;0;NA;80348;0;2020-06-22;123
2020-06-21;"Banskobystrický kraj";0;0;0;0;NA;80348;0;2020-06-21;123
2020-06-20;"Banskobystrický kraj";0;0;0;0;NA;80348;0;2020-06-20;123
2020-06-19;"Banskobystrický kraj";2;0;0;0;NA;80348;2;2020-06-19;123
2020-06-18;"Banskobystrický kraj";10;0;0;0;NA;80348;10;2020-06-18;121
2020-06-17;"Banskobystrický kraj";1;0;0;0;NA;80348;1;2020-06-17;111
2020-06-16;"Banskobystrický kraj";0;0;0;0;NA;80348;0;2020-06-16;110
2020-06-14;"Banskobystrický kraj";2;0;0;0;NA;80348;2;2020-06-14;110
2020-06-13;"Banskobystrický kraj";2;0;0;0;NA;80348;2;2020-06-13;108
2020-06-12;"Banskobystrický kraj";0;0;0;0;NA;80348;0;2020-06-12;106
2020-06-11;"Banskobystrický kraj";1;0;0;0;NA;80348;1;2020-06-11;106
2020-06-10;"Banskobystrický kraj";0;0;0;0;NA;80348;0;2020-06-10;105
2020-06-09;"Banskobystrický kraj";0;0;0;0;NA;80348;0;2020-06-09;105
2020-06-08;"Banskobystrický kraj";0;0;0;0;NA;80348;0;2020-06-08;105
2020-06-07;"Banskobystrický kraj";0;0;0;0;NA;80348;0;2020-06-07;105
2020-06-05;"Banskobystrický kraj";2;0;0;0;NA;80348;2;2020-06-05;105
2020-06-03;"Banskobystrický kraj";0;0;0;0;NA;80348;0;2020-06-03;103
2020-06-02;"Banskobystrický kraj";0;0;0;0;NA;80348;0;2020-06-02;103
2020-05-31;"Banskobystrický kraj";0;0;0;0;NA;80348;0;2020-05-31;103
2020-05-29;"Banskobystrický kraj";0;0;0;0;NA;80348;0;2020-05-29;103
2020-05-27;"Banskobystrický kraj";1;0;0;0;NA;80348;1;2020-05-27;103
2020-05-26;"Banskobystrický kraj";0;0;0;0;NA;80348;0;2020-05-26;102
2020-05-25;"Banskobystrický kraj";0;0;0;0;NA;80348;0;2020-05-25;102
2020-05-24;"Banskobystrický kraj";0;0;0;0;NA;80348;0;2020-05-24;102
2020-05-23;"Banskobystrický kraj";1;0;0;0;NA;80348;1;2020-05-23;102
2020-05-22;"Banskobystrický kraj";0;0;0;0;NA;80348;0;2020-05-22;101
2020-05-21;"Banskobystrický kraj";0;0;0;0;NA;80348;0;2020-05-21;101
2020-05-20;"Banskobystrický kraj";1;0;0;0;NA;80348;1;2020-05-20;101
2020-05-19;"Banskobystrický kraj";0;0;0;0;NA;80348;0;2020-05-19;100
2020-05-17;"Banskobystrický kraj";0;0;0;0;NA;80348;0;2020-05-17;100
2020-05-16;"Banskobystrický kraj";0;0;0;0;NA;80348;0;2020-05-16;100
2020-05-15;"Banskobystrický kraj";0;0;0;0;NA;80348;0;2020-05-15;100
2020-05-14;"Banskobystrický kraj";0;0;0;0;NA;80348;0;2020-05-14;100
2020-05-13;"Banskobystrický kraj";0;0;0;0;NA;80348;0;2020-05-13;100
2020-05-12;"Banskobystrický kraj";1;0;0;0;NA;80348;1;2020-05-12;100
2020-05-11;"Banskobystrický kraj";0;0;0;0;NA;80348;0;2020-05-11;99
2020-05-09;"Banskobystrický kraj";0;0;0;0;NA;80348;0;2020-05-09;99
2020-05-07;"Banskobystrický kraj";2;0;0;0;NA;80348;2;2020-05-07;99
2020-05-06;"Banskobystrický kraj";1;0;0;0;NA;80348;1;2020-05-06;97
2020-05-05;"Banskobystrický kraj";2;0;0;0;NA;80348;2;2020-05-05;96
2020-05-04;"Banskobystrický kraj";0;0;0;0;NA;80348;0;2020-05-04;94
2020-05-03;"Banskobystrický kraj";0;0;0;0;NA;80348;0;2020-05-03;94
2020-05-02;"Banskobystrický kraj";0;0;0;0;NA;80348;0;2020-05-02;94
2020-05-01;"Banskobystrický kraj";0;0;0;0;NA;80348;0;2020-05-01;94
2020-04-30;"Banskobystrický kraj";1;0;0;0;NA;80348;1;2020-04-30;94
2020-04-29;"Banskobystrický kraj";1;0;0;0;NA;80348;1;2020-04-29;93
2020-04-28;"Banskobystrický kraj";0;0;0;0;NA;80348;0;2020-04-28;92
2020-04-27;"Banskobystrický kraj";0;0;0;0;NA;80348;0;2020-04-27;92
2020-04-26;"Banskobystrický kraj";0;0;0;0;NA;80348;0;2020-04-26;92
2020-04-25;"Banskobystrický kraj";2;0;0;0;NA;80348;2;2020-04-25;92
2020-04-24;"Banskobystrický kraj";3;0;0;0;NA;80348;3;2020-04-24;90
2020-04-23;"Banskobystrický kraj";2;0;0;0;NA;80348;2;2020-04-23;87
2020-04-22;"Banskobystrický kraj";2;0;0;0;NA;80348;2;2020-04-22;85
2020-04-21;"Banskobystrický kraj";2;0;0;0;NA;80348;2;2020-04-21;83
2020-04-20;"Banskobystrický kraj";0;0;0;0;NA;80348;0;2020-04-20;81
2020-04-19;"Banskobystrický kraj";0;0;0;0;NA;80348;0;2020-04-19;81
2020-04-18;"Banskobystrický kraj";8;0;0;0;NA;80348;8;2020-04-18;81
2020-04-17;"Banskobystrický kraj";2;0;0;0;NA;80348;2;2020-04-17;73
2020-04-16;"Banskobystrický kraj";0;0;0;0;NA;80348;0;2020-04-16;71
2020-04-15;"Banskobystrický kraj";10;0;0;0;NA;80348;10;2020-04-15;71
2020-04-14;"Banskobystrický kraj";0;0;0;0;NA;80348;0;2020-04-14;61
2020-04-13;"Banskobystrický kraj";2;0;0;0;NA;80348;2;2020-04-13;61
2020-04-12;"Banskobystrický kraj";4;0;0;0;NA;80348;4;2020-04-12;59
2020-04-11;"Banskobystrický kraj";1;0;0;0;NA;80348;1;2020-04-11;55
2020-04-10;"Banskobystrický kraj";0;0;0;0;NA;80348;0;2020-04-10;54
2020-04-09;"Banskobystrický kraj";2;0;0;0;NA;80348;2;2020-04-09;54
2020-04-08;"Banskobystrický kraj";0;0;0;0;NA;80348;0;2020-04-08;52
2020-04-07;"Banskobystrický kraj";4;0;0;0;NA;80348;4;2020-04-07;52
2020-04-06;"Banskobystrický kraj";10;0;0;0;NA;80348;10;2020-04-06;48
2020-04-05;"Banskobystrický kraj";9;0;0;0;NA;80348;9;2020-04-05;38
2020-04-04;"Banskobystrický kraj";0;0;0;0;NA;80348;0;2020-04-04;29
2020-04-03;"Banskobystrický kraj";2;0;0;0;NA;80348;2;2020-04-03;29
2020-04-02;"Banskobystrický kraj";2;0;0;0;NA;80348;2;2020-04-02;27
2020-04-01;"Banskobystrický kraj";5;0;0;0;NA;80348;5;2020-04-01;25
2020-03-31;"Banskobystrický kraj";3;0;0;0;NA;80348;3;2020-03-31;20
2020-03-30;"Banskobystrický kraj";1;0;0;0;NA;80348;1;2020-03-30;17
2020-03-29;"Banskobystrický kraj";2;0;0;0;NA;80348;2;2020-03-29;16
2020-03-28;"Banskobystrický kraj";1;0;0;0;NA;80348;1;2020-03-28;14
2020-03-27;"Banskobystrický kraj";1;0;0;0;NA;80348;1;2020-03-27;13
2020-03-26;"Banskobystrický kraj";1;0;0;0;NA;80348;1;2020-03-26;12
2020-03-25;"Banskobystrický kraj";0;0;0;0;NA;80348;0;2020-03-25;11
2020-03-24;"Banskobystrický kraj";1;0;0;0;NA;80348;1;2020-03-24;11
2020-03-23;"Banskobystrický kraj";1;0;0;0;NA;80348;1;2020-03-23;10
2020-03-22;"Banskobystrický kraj";0;0;0;0;NA;80348;0;2020-03-22;9
2020-03-21;"Banskobystrický kraj";3;0;0;0;NA;80348;3;2020-03-21;9
2020-03-20;"Banskobystrický kraj";0;0;0;0;NA;80348;0;2020-03-20;6
2020-03-19;"Banskobystrický kraj";2;0;0;0;NA;80348;2;2020-03-19;6
2020-03-18;"Banskobystrický kraj";1;0;0;0;NA;80348;1;2020-03-18;4
2020-03-17;"Banskobystrický kraj";1;0;0;0;NA;80348;1;2020-03-17;3
2020-03-16;"Banskobystrický kraj";0;0;0;0;NA;80348;0;2020-03-16;2
2020-03-15;"Banskobystrický kraj";1;0;0;0;NA;80348;1;2020-03-15;2
2020-03-14;"Banskobystrický kraj";0;0;0;0;NA;80348;0;2020-03-14;1
2020-03-13;"Banskobystrický kraj";1;0;0;0;NA;80348;1;2020-03-13;1
2020-03-12;"Banskobystrický kraj";0;0;0;0;NA;80348;0;2020-03-12;0
2020-03-11;"Banskobystrický kraj";0;0;0;0;NA;80348;0;2020-03-11;0
2020-03-09;"Banskobystrický kraj";0;0;0;0;NA;80348;0;2020-03-09;0
2020-03-08;"Banskobystrický kraj";0;0;0;0;NA;80348;0;2020-03-08;0
2020-03-07;"Banskobystrický kraj";0;0;0;0;NA;80348;0;2020-03-07;0
2020-03-06;"Banskobystrický kraj";0;0;0;0;NA;80348;0;2020-03-06;0
2021-05-30;"Bratislavský kraj";1;11852;17;11869;44179;87541;18;2021-05-30;87541
2021-05-29;"Bratislavský kraj";4;11702;8;11710;NA;87541;12;2021-05-29;87523
2021-05-28;"Bratislavský kraj";14;15684;23;15707;NA;87541;37;2021-05-28;87511
2021-05-27;"Bratislavský kraj";5;11279;19;11298;NA;87541;24;2021-05-27;87474
2021-05-26;"Bratislavský kraj";20;10674;16;10690;NA;87541;36;2021-05-26;87450
2021-05-25;"Bratislavský kraj";19;11655;31;11686;NA;87541;50;2021-05-25;87414
2021-05-24;"Bratislavský kraj";12;12965;23;12988;NA;87541;35;2021-05-24;87364
2021-05-23;"Bratislavský kraj";7;13074;24;13098;NA;87541;31;2021-05-23;87329
2021-05-22;"Bratislavský kraj";6;13702;21;13723;NA;87541;27;2021-05-22;87298
2021-05-21;"Bratislavský kraj";15;19128;22;19150;NA;87541;37;2021-05-21;87271
2021-05-20;"Bratislavský kraj";15;13925;17;13942;NA;87541;32;2021-05-20;87234
2021-05-19;"Bratislavský kraj";21;11841;24;11865;NA;87541;45;2021-05-19;87202
2021-05-18;"Bratislavský kraj";14;12849;33;12882;NA;87541;47;2021-05-18;87157
2021-05-17;"Bratislavský kraj";15;13786;29;13815;NA;87541;44;2021-05-17;87110
2021-05-16;"Bratislavský kraj";12;19900;32;19932;NA;87541;44;2021-05-16;87066
2021-05-15;"Bratislavský kraj";1;17513;32;17545;NA;87541;33;2021-05-15;87022
2021-05-14;"Bratislavský kraj";15;22603;29;22632;NA;87541;44;2021-05-14;86989
2021-05-13;"Bratislavský kraj";9;15851;17;15868;NA;87541;26;2021-05-13;86945
2021-05-12;"Bratislavský kraj";11;14478;26;14504;NA;87541;37;2021-05-12;86919
2021-05-11;"Bratislavský kraj";29;16095;32;16127;NA;87541;61;2021-05-11;86882
2021-05-10;"Bratislavský kraj";27;19916;63;19979;NA;87541;90;2021-05-10;86821
2021-05-09;"Bratislavský kraj";9;29358;32;29390;NA;87541;41;2021-05-09;86731
2021-05-08;"Bratislavský kraj";5;19575;24;19599;NA;87541;29;2021-05-08;86690
2021-05-07;"Bratislavský kraj";32;27941;66;28007;NA;87541;98;2021-05-07;86661
2021-05-06;"Bratislavský kraj";19;20048;52;20100;NA;87541;71;2021-05-06;86563
2021-05-05;"Bratislavský kraj";29;15367;27;15394;NA;87541;56;2021-05-05;86492
2021-05-04;"Bratislavský kraj";46;18959;57;19016;NA;87541;103;2021-05-04;86436
2021-05-03;"Bratislavský kraj";37;22059;60;22119;NA;87541;97;2021-05-03;86333
2021-05-02;"Bratislavský kraj";38;43064;75;43139;NA;87541;113;2021-05-02;86236
2021-05-01;"Bratislavský kraj";11;40068;41;40109;NA;87541;52;2021-05-01;86123
2021-04-30;"Bratislavský kraj";43;0;0;0;NA;87541;43;2021-04-30;86071
2021-04-29;"Bratislavský kraj";48;0;0;0;NA;87541;48;2021-04-29;86028
2021-04-28;"Bratislavský kraj";40;0;0;0;NA;87541;40;2021-04-28;85980
2021-04-27;"Bratislavský kraj";41;0;0;0;NA;87541;41;2021-04-27;85940
2021-04-26;"Bratislavský kraj";59;0;0;0;NA;87541;59;2021-04-26;85899
2021-04-25;"Bratislavský kraj";8;0;0;0;NA;87541;8;2021-04-25;85840
2021-04-24;"Bratislavský kraj";28;0;0;0;NA;87541;28;2021-04-24;85832
2021-04-23;"Bratislavský kraj";70;0;0;0;NA;87541;70;2021-04-23;85804
2021-04-22;"Bratislavský kraj";39;0;0;0;NA;87541;39;2021-04-22;85734
2021-04-21;"Bratislavský kraj";48;0;0;0;NA;87541;48;2021-04-21;85695
2021-04-20;"Bratislavský kraj";58;0;0;0;NA;87541;58;2021-04-20;85647
2021-04-19;"Bratislavský kraj";48;0;0;0;NA;87541;48;2021-04-19;85589
2021-04-18;"Bratislavský kraj";35;0;0;0;NA;87541;35;2021-04-18;85541
2021-04-17;"Bratislavský kraj";13;0;0;0;NA;87541;13;2021-04-17;85506
2021-04-16;"Bratislavský kraj";62;0;0;0;NA;87541;62;2021-04-16;85493
2021-04-15;"Bratislavský kraj";34;0;0;0;NA;87541;34;2021-04-15;85431
2021-04-14;"Bratislavský kraj";65;0;0;0;NA;87541;65;2021-04-14;85397
2021-04-13;"Bratislavský kraj";82;0;0;0;NA;87541;82;2021-04-13;85332
2021-04-12;"Bratislavský kraj";77;0;0;0;NA;87541;77;2021-04-12;85250
2021-04-11;"Bratislavský kraj";42;0;0;0;NA;87541;42;2021-04-11;85173
2021-04-10;"Bratislavský kraj";14;0;0;0;NA;87541;14;2021-04-10;85131
2021-04-09;"Bratislavský kraj";72;0;0;0;NA;87541;72;2021-04-09;85117
2021-04-08;"Bratislavský kraj";71;0;0;0;NA;87541;71;2021-04-08;85045
2021-04-07;"Bratislavský kraj";96;0;0;0;NA;87541;96;2021-04-07;84974
2021-04-06;"Bratislavský kraj";94;0;0;0;NA;87541;94;2021-04-06;84878
2021-04-05;"Bratislavský kraj";85;0;0;0;NA;87541;85;2021-04-05;84784
2021-04-04;"Bratislavský kraj";37;0;0;0;NA;87541;37;2021-04-04;84699
2021-04-03;"Bratislavský kraj";52;0;0;0;NA;87541;52;2021-04-03;84662
2021-04-02;"Bratislavský kraj";33;0;0;0;NA;87541;33;2021-04-02;84610
2021-04-01;"Bratislavský kraj";119;0;0;0;NA;87541;119;2021-04-01;84577
2021-03-31;"Bratislavský kraj";105;45689;149;45838;NA;87541;254;2021-03-31;84458
2021-03-30;"Bratislavský kraj";100;39010;142;39152;NA;87541;242;2021-03-30;84204
2021-03-29;"Bratislavský kraj";153;40124;178;40302;NA;87541;331;2021-03-29;83962
2021-03-28;"Bratislavský kraj";59;53372;137;53509;NA;87541;196;2021-03-28;83631
2021-03-27;"Bratislavský kraj";53;79160;239;79399;NA;87541;292;2021-03-27;83435
2021-03-26;"Bratislavský kraj";114;55513;190;55703;NA;87541;304;2021-03-26;83143
2021-03-25;"Bratislavský kraj";76;36300;170;36470;NA;87541;246;2021-03-25;82839
2021-03-24;"Bratislavský kraj";120;30184;200;30384;NA;87541;320;2021-03-24;82593
2021-03-23;"Bratislavský kraj";138;36029;189;36218;NA;87541;327;2021-03-23;82273
2021-03-22;"Bratislavský kraj";110;42516;218;42734;NA;87541;328;2021-03-22;81946
2021-03-21;"Bratislavský kraj";54;61299;212;61511;NA;87541;266;2021-03-21;81618
2021-03-20;"Bratislavský kraj";59;72630;228;72858;NA;87541;287;2021-03-20;81352
2021-03-19;"Bratislavský kraj";139;53952;255;54207;NA;87541;394;2021-03-19;81065
2021-03-18;"Bratislavský kraj";142;34057;190;34247;NA;87541;332;2021-03-18;80671
2021-03-17;"Bratislavský kraj";177;30179;215;30394;NA;87541;392;2021-03-17;80339
2021-03-16;"Bratislavský kraj";258;36425;282;36707;NA;87541;540;2021-03-16;79947
2021-03-15;"Bratislavský kraj";180;38247;252;38499;NA;87541;432;2021-03-15;79407
2021-03-14;"Bratislavský kraj";75;52609;275;52884;NA;87541;350;2021-03-14;78975
2021-03-13;"Bratislavský kraj";110;79741;329;80070;NA;87541;439;2021-03-13;78625
2021-03-12;"Bratislavský kraj";152;54534;301;54835;NA;87541;453;2021-03-12;78186
2021-03-11;"Bratislavský kraj";178;34290;281;34571;NA;87541;459;2021-03-11;77733
2021-03-10;"Bratislavský kraj";164;30828;273;31101;NA;87541;437;2021-03-10;77274
2021-03-09;"Bratislavský kraj";242;37798;267;38065;NA;87541;509;2021-03-09;76837
2021-03-08;"Bratislavský kraj";255;40722;343;41065;NA;87541;598;2021-03-08;76328
2021-03-07;"Bratislavský kraj";142;52814;301;53115;NA;87541;443;2021-03-07;75730
2021-03-06;"Bratislavský kraj";79;71410;412;71822;NA;87541;491;2021-03-06;75287
2021-03-05;"Bratislavský kraj";238;50484;292;50776;NA;87541;530;2021-03-05;74796
2021-03-04;"Bratislavský kraj";204;34544;344;34888;NA;87541;548;2021-03-04;74266
2021-03-03;"Bratislavský kraj";250;30525;364;30889;NA;87541;614;2021-03-03;73718
2021-03-02;"Bratislavský kraj";267;39735;388;40123;NA;87541;655;2021-03-02;73104
2021-03-01;"Bratislavský kraj";320;38222;432;38654;NA;87541;752;2021-03-01;72449
2021-02-28;"Bratislavský kraj";184;50323;323;50646;NA;87541;507;2021-02-28;71697
2021-02-27;"Bratislavský kraj";151;76894;465;77359;NA;87541;616;2021-02-27;71190
2021-02-26;"Bratislavský kraj";277;47265;400;47665;NA;87541;677;2021-02-26;70574
2021-02-25;"Bratislavský kraj";277;28769;405;29174;NA;87541;682;2021-02-25;69897
2021-02-24;"Bratislavský kraj";217;27095;412;27507;NA;87541;629;2021-02-24;69215
2021-02-23;"Bratislavský kraj";257;31297;395;31692;NA;87541;652;2021-02-23;68586
2021-02-22;"Bratislavský kraj";353;36454;480;36934;NA;87541;833;2021-02-22;67934
2021-02-21;"Bratislavský kraj";185;54150;396;54546;NA;87541;581;2021-02-21;67101
2021-02-20;"Bratislavský kraj";167;74787;550;75337;NA;87541;717;2021-02-20;66520
2021-02-19;"Bratislavský kraj";280;44871;415;45286;NA;87541;695;2021-02-19;65803
2021-02-18;"Bratislavský kraj";263;26377;371;26748;NA;87541;634;2021-02-18;65108
2021-02-17;"Bratislavský kraj";264;22815;316;23131;NA;87541;580;2021-02-17;64474
2021-02-16;"Bratislavský kraj";289;28265;354;28619;NA;87541;643;2021-02-16;63894
2021-02-15;"Bratislavský kraj";248;36893;396;37289;NA;87541;644;2021-02-15;63251
2021-02-14;"Bratislavský kraj";153;47948;323;48271;NA;87541;476;2021-02-14;62607
2021-02-13;"Bratislavský kraj";173;68589;515;69104;NA;87541;688;2021-02-13;62131
2021-02-12;"Bratislavský kraj";282;35729;327;36056;NA;87541;609;2021-02-12;61443
2021-02-11;"Bratislavský kraj";337;24542;285;24827;NA;87541;622;2021-02-11;60834
2021-02-10;"Bratislavský kraj";314;23120;359;23479;NA;87541;673;2021-02-10;60212
2021-02-09;"Bratislavský kraj";287;36565;454;37019;NA;87541;741;2021-02-09;59539
2021-02-08;"Bratislavský kraj";484;31866;397;32263;NA;87541;881;2021-02-08;58798
2021-02-07;"Bratislavský kraj";243;51290;425;51715;NA;87541;668;2021-02-07;57917
2021-02-06;"Bratislavský kraj";116;62602;508;63110;NA;87541;624;2021-02-06;57249
2021-02-05;"Bratislavský kraj";327;27152;375;27527;NA;87541;702;2021-02-05;56625
2021-02-04;"Bratislavský kraj";555;17252;348;17600;NA;87541;903;2021-02-04;55923
2021-02-03;"Bratislavský kraj";161;13057;351;13408;NA;87541;512;2021-02-03;55020
2021-02-02;"Bratislavský kraj";397;25945;480;26425;NA;87541;877;2021-02-02;54508
2021-02-01;"Bratislavský kraj";221;35536;513;36049;NA;87541;734;2021-02-01;53631
2021-01-31;"Bratislavský kraj";180;35693;425;36118;NA;87541;605;2021-01-31;52897
2021-01-30;"Bratislavský kraj";310;49588;521;50109;NA;87541;831;2021-01-30;52292
2021-01-29;"Bratislavský kraj";344;16568;344;16912;NA;87541;688;2021-01-29;51461
2021-01-28;"Bratislavský kraj";307;10710;297;11007;NA;87541;604;2021-01-28;50773
2021-01-27;"Bratislavský kraj";336;22217;345;22562;NA;87541;681;2021-01-27;50169
2021-01-26;"Bratislavský kraj";297;22218;308;22526;NA;87541;605;2021-01-26;49488
2021-01-25;"Bratislavský kraj";356;23257;249;23506;NA;87541;605;2021-01-25;48883
2021-01-24;"Bratislavský kraj";175;37903;404;38307;NA;87541;579;2021-01-24;48278
2021-01-23;"Bratislavský kraj";396;79447;690;80137;NA;87541;1086;2021-01-23;47699
2021-01-22;"Bratislavský kraj";199;42028;365;42393;NA;87541;564;2021-01-22;46613
2021-01-21;"Bratislavský kraj";255;105732;1317;107049;NA;87541;1572;2021-01-21;46049
2021-01-20;"Bratislavský kraj";360;27258;450;27708;NA;87541;810;2021-01-20;44477
2021-01-19;"Bratislavský kraj";375;15309;346;15655;NA;87541;721;2021-01-19;43667
2021-01-18;"Bratislavský kraj";357;12533;707;13240;NA;87541;1064;2021-01-18;42946
2021-01-17;"Bratislavský kraj";244;482;26;508;NA;87541;270;2021-01-17;41882
2021-01-16;"Bratislavský kraj";70;3016;156;3172;NA;87541;226;2021-01-16;41612
2021-01-15;"Bratislavský kraj";251;7896;256;8152;NA;87541;507;2021-01-15;41386
2021-01-14;"Bratislavský kraj";363;8511;273;8784;NA;87541;636;2021-01-14;40879
2021-01-13;"Bratislavský kraj";336;8540;329;8869;NA;87541;665;2021-01-13;40243
2021-01-12;"Bratislavský kraj";450;10761;464;11225;NA;87541;914;2021-01-12;39578
2021-01-11;"Bratislavský kraj";397;20108;380;20488;NA;87541;777;2021-01-11;38664
2021-01-10;"Bratislavský kraj";252;1507;79;1586;NA;87541;331;2021-01-10;37887
2021-01-09;"Bratislavský kraj";351;5005;291;5296;NA;87541;642;2021-01-09;37556
2021-01-08;"Bratislavský kraj";556;10045;436;10481;NA;87541;992;2021-01-08;36914
2021-01-07;"Bratislavský kraj";537;7725;412;8137;NA;87541;949;2021-01-07;35922
2021-01-06;"Bratislavský kraj";271;3329;216;3545;NA;87541;487;2021-01-06;34973
2021-01-05;"Bratislavský kraj";619;10981;844;11825;NA;87541;1463;2021-01-05;34486
2021-01-04;"Bratislavský kraj";601;8494;606;9100;NA;87541;1207;2021-01-04;33023
2021-01-03;"Bratislavský kraj";77;433;41;474;NA;87541;118;2021-01-03;31816
2021-01-02;"Bratislavský kraj";185;462;57;519;NA;87541;242;2021-01-02;31698
2021-01-01;"Bratislavský kraj";235;3277;131;3408;NA;87541;366;2021-01-01;31456
2020-12-31;"Bratislavský kraj";925;14982;589;15571;NA;87541;1514;2020-12-31;31090
2020-12-30;"Bratislavský kraj";650;9526;528;10054;NA;87541;1178;2020-12-30;29576
2020-12-29;"Bratislavský kraj";303;10887;776;11663;NA;87541;1079;2020-12-29;28398
2020-12-28;"Bratislavský kraj";255;8447;560;9007;NA;87541;815;2020-12-28;27319
2020-12-27;"Bratislavský kraj";160;709;76;785;NA;87541;236;2020-12-27;26504
2020-12-26;"Bratislavský kraj";75;480;27;507;NA;87541;102;2020-12-26;26268
2020-12-25;"Bratislavský kraj";114;503;38;541;NA;87541;152;2020-12-25;26166
2020-12-24;"Bratislavský kraj";536;3461;102;3563;NA;87541;638;2020-12-24;26014
2020-12-23;"Bratislavský kraj";416;13293;500;13793;NA;87541;916;2020-12-23;25376
2020-12-22;"Bratislavský kraj";327;15783;772;16555;NA;87541;1099;2020-12-22;24460
2020-12-21;"Bratislavský kraj";392;15669;2007;17676;NA;87541;2399;2020-12-21;23361
2020-12-20;"Bratislavský kraj";180;775;54;829;NA;87541;234;2020-12-20;20962
2020-12-19;"Bratislavský kraj";396;3314;130;3444;NA;87541;526;2020-12-19;20728
2020-12-18;"Bratislavský kraj";306;10735;401;11136;NA;87541;707;2020-12-18;20202
2020-12-17;"Bratislavský kraj";502;10270;412;10682;NA;87541;914;2020-12-17;19495
2020-12-16;"Bratislavský kraj";282;10772;452;11224;NA;87541;734;2020-12-16;18581
2020-12-15;"Bratislavský kraj";423;10916;479;11395;NA;87541;902;2020-12-15;17847
2020-12-14;"Bratislavský kraj";279;7198;293;7491;NA;87541;572;2020-12-14;16945
2020-12-13;"Bratislavský kraj";125;139;10;149;NA;87541;135;2020-12-13;16373
2020-12-12;"Bratislavský kraj";361;3886;157;4043;NA;87541;518;2020-12-12;16238
2020-12-11;"Bratislavský kraj";326;7344;289;7633;NA;87541;615;2020-12-11;15720
2020-12-10;"Bratislavský kraj";286;5823;209;6032;NA;87541;495;2020-12-10;15105
2020-12-09;"Bratislavský kraj";382;4795;178;4973;NA;87541;560;2020-12-09;14610
2020-12-08;"Bratislavský kraj";234;6243;207;6450;NA;87541;441;2020-12-08;14050
2020-12-07;"Bratislavský kraj";272;4639;152;4791;NA;87541;424;2020-12-07;13609
2020-12-06;"Bratislavský kraj";61;1625;52;1677;NA;87541;113;2020-12-06;13185
2020-12-05;"Bratislavský kraj";266;2221;41;2262;NA;87541;307;2020-12-05;13072
2020-12-04;"Bratislavský kraj";200;4954;99;5053;NA;87541;299;2020-12-04;12765
2020-12-03;"Bratislavský kraj";213;5672;95;5767;NA;87541;308;2020-12-03;12466
2020-12-02;"Bratislavský kraj";205;3462;103;3565;NA;87541;308;2020-12-02;12158
2020-12-01;"Bratislavský kraj";255;3889;172;4061;NA;87541;427;2020-12-01;11850
2020-11-30;"Bratislavský kraj";152;2153;121;2274;NA;87541;273;2020-11-30;11423
2020-11-29;"Bratislavský kraj";52;201;24;225;NA;87541;76;2020-11-29;11150
2020-11-28;"Bratislavský kraj";232;2624;33;2657;NA;87541;265;2020-11-28;11074
2020-11-27;"Bratislavský kraj";54;2540;64;2604;NA;87541;118;2020-11-27;10809
2020-11-26;"Bratislavský kraj";129;1976;60;2036;NA;87541;189;2020-11-26;10691
2020-11-25;"Bratislavský kraj";140;1770;47;1817;NA;87541;187;2020-11-25;10502
2020-11-24;"Bratislavský kraj";81;2988;67;3055;NA;87541;148;2020-11-24;10315
2020-11-23;"Bratislavský kraj";67;7083;58;7141;NA;87541;125;2020-11-23;10167
2020-11-22;"Bratislavský kraj";36;81;7;88;NA;87541;43;2020-11-22;10042
2020-11-21;"Bratislavský kraj";109;2126;47;2173;NA;87541;156;2020-11-21;9999
2020-11-20;"Bratislavský kraj";118;2876;48;2924;NA;87541;166;2020-11-20;9843
2020-11-19;"Bratislavský kraj";173;987;29;1016;NA;87541;202;2020-11-19;9677
2020-11-18;"Bratislavský kraj";118;616;75;691;NA;87541;193;2020-11-18;9475
2020-11-17;"Bratislavský kraj";108;928;23;951;NA;87541;131;2020-11-17;9282
2020-11-16;"Bratislavský kraj";82;651;9;660;NA;87541;91;2020-11-16;9151
2020-11-15;"Bratislavský kraj";47;236;0;236;NA;87541;47;2020-11-15;9060
2020-11-14;"Bratislavský kraj";53;1834;15;1849;NA;87541;68;2020-11-14;9013
2020-11-13;"Bratislavský kraj";94;2096;21;2117;NA;87541;115;2020-11-13;8945
2020-11-12;"Bratislavský kraj";141;1727;6;1733;NA;87541;147;2020-11-12;8830
2020-11-11;"Bratislavský kraj";159;1429;12;1441;NA;87541;171;2020-11-11;8683
2020-11-10;"Bratislavský kraj";136;805;14;819;NA;87541;150;2020-11-10;8512
2020-11-09;"Bratislavský kraj";70;616;8;624;NA;87541;78;2020-11-09;8362
2020-11-08;"Bratislavský kraj";82;869;6;875;NA;87541;88;2020-11-08;8284
2020-11-07;"Bratislavský kraj";88;4039;17;4056;NA;87541;105;2020-11-07;8196
2020-11-06;"Bratislavský kraj";281;6441;25;6466;NA;87541;306;2020-11-06;8091
2020-11-05;"Bratislavský kraj";175;476;11;487;NA;87541;186;2020-11-05;7785
2020-11-04;"Bratislavský kraj";65;411;10;421;NA;87541;75;2020-11-04;7599
2020-11-03;"Bratislavský kraj";251;1085;12;1097;NA;87541;263;2020-11-03;7524
2020-11-02;"Bratislavský kraj";202;3365;22;3387;NA;87541;224;2020-11-02;7261
2020-11-01;"Bratislavský kraj";227;8694;39;8733;NA;87541;266;2020-11-01;7037
2020-10-31;"Bratislavský kraj";173;22407;123;22530;NA;87541;296;2020-10-31;6771
2020-10-30;"Bratislavský kraj";158;17350;138;17488;NA;87541;296;2020-10-30;6475
2020-10-29;"Bratislavský kraj";262;116;4;120;NA;87541;266;2020-10-29;6179
2020-10-28;"Bratislavský kraj";220;260;15;275;NA;87541;235;2020-10-28;5913
2020-10-27;"Bratislavský kraj";256;145;4;149;NA;87541;260;2020-10-27;5678
2020-10-26;"Bratislavský kraj";123;229;11;240;NA;87541;134;2020-10-26;5418
2020-10-25;"Bratislavský kraj";152;33;2;35;NA;87541;154;2020-10-25;5284
2020-10-24;"Bratislavský kraj";170;221;6;227;NA;87541;176;2020-10-24;5130
2020-10-23;"Bratislavský kraj";151;144;8;152;NA;87541;159;2020-10-23;4954
2020-10-22;"Bratislavský kraj";192;204;15;219;NA;87541;207;2020-10-22;4795
2020-10-21;"Bratislavský kraj";66;90;6;96;NA;87541;72;2020-10-21;4588
2020-10-20;"Bratislavský kraj";183;97;4;101;NA;87541;187;2020-10-20;4516
2020-10-19;"Bratislavský kraj";148;80;3;83;NA;87541;151;2020-10-19;4329
2020-10-18;"Bratislavský kraj";75;92;0;92;NA;87541;75;2020-10-18;4178
2020-10-17;"Bratislavský kraj";136;0;0;0;NA;87541;136;2020-10-17;4103
2020-10-16;"Bratislavský kraj";103;14;1;15;NA;87541;104;2020-10-16;3967
2020-10-15;"Bratislavský kraj";135;6;1;7;NA;87541;136;2020-10-15;3863
2020-10-14;"Bratislavský kraj";127;4;0;4;NA;87541;127;2020-10-14;3727
2020-10-13;"Bratislavský kraj";86;108;8;116;NA;87541;94;2020-10-13;3600
2020-10-12;"Bratislavský kraj";46;0;0;0;NA;87541;46;2020-10-12;3506
2020-10-11;"Bratislavský kraj";80;0;0;0;NA;87541;80;2020-10-11;3460
2020-10-10;"Bratislavský kraj";55;0;0;0;NA;87541;55;2020-10-10;3380
2020-10-09;"Bratislavský kraj";148;0;0;0;NA;87541;148;2020-10-09;3325
2020-10-08;"Bratislavský kraj";100;0;0;0;NA;87541;100;2020-10-08;3177
2020-10-07;"Bratislavský kraj";107;0;0;0;NA;87541;107;2020-10-07;3077
2020-10-06;"Bratislavský kraj";108;0;0;0;NA;87541;108;2020-10-06;2970
2020-10-05;"Bratislavský kraj";30;0;0;0;NA;87541;30;2020-10-05;2862
2020-10-04;"Bratislavský kraj";49;0;0;0;NA;87541;49;2020-10-04;2832
2020-10-03;"Bratislavský kraj";82;0;0;0;NA;87541;82;2020-10-03;2783
2020-10-02;"Bratislavský kraj";101;0;0;0;NA;87541;101;2020-10-02;2701
2020-10-01;"Bratislavský kraj";72;0;0;0;NA;87541;72;2020-10-01;2600
2020-09-30;"Bratislavský kraj";91;0;0;0;NA;87541;91;2020-09-30;2528
2020-09-29;"Bratislavský kraj";74;0;0;0;NA;87541;74;2020-09-29;2437
2020-09-28;"Bratislavský kraj";29;0;0;0;NA;87541;29;2020-09-28;2363
2020-09-27;"Bratislavský kraj";48;0;0;0;NA;87541;48;2020-09-27;2334
2020-09-26;"Bratislavský kraj";86;0;0;0;NA;87541;86;2020-09-26;2286
2020-09-25;"Bratislavský kraj";97;0;0;0;NA;87541;97;2020-09-25;2200
2020-09-24;"Bratislavský kraj";73;0;0;0;NA;87541;73;2020-09-24;2103
2020-09-23;"Bratislavský kraj";55;0;0;0;NA;87541;55;2020-09-23;2030
2020-09-22;"Bratislavský kraj";81;0;0;0;NA;87541;81;2020-09-22;1975
2020-09-21;"Bratislavský kraj";32;0;0;0;NA;87541;32;2020-09-21;1894
2020-09-20;"Bratislavský kraj";25;0;0;0;NA;87541;25;2020-09-20;1862
2020-09-19;"Bratislavský kraj";59;0;0;0;NA;87541;59;2020-09-19;1837
2020-09-18;"Bratislavský kraj";42;0;0;0;NA;87541;42;2020-09-18;1778
2020-09-17;"Bratislavský kraj";52;0;0;0;NA;87541;52;2020-09-17;1736
2020-09-16;"Bratislavský kraj";32;0;0;0;NA;87541;32;2020-09-16;1684
2020-09-15;"Bratislavský kraj";26;0;0;0;NA;87541;26;2020-09-15;1652
2020-09-14;"Bratislavský kraj";24;0;0;0;NA;87541;24;2020-09-14;1626
2020-09-13;"Bratislavský kraj";11;0;0;0;NA;87541;11;2020-09-13;1602
2020-09-12;"Bratislavský kraj";24;0;0;0;NA;87541;24;2020-09-12;1591
2020-09-11;"Bratislavský kraj";50;0;0;0;NA;87541;50;2020-09-11;1567
2020-09-10;"Bratislavský kraj";47;0;0;0;NA;87541;47;2020-09-10;1517
2020-09-09;"Bratislavský kraj";40;0;0;0;NA;87541;40;2020-09-09;1470
2020-09-08;"Bratislavský kraj";58;0;0;0;NA;87541;58;2020-09-08;1430
2020-09-07;"Bratislavský kraj";39;0;0;0;NA;87541;39;2020-09-07;1372
2020-09-06;"Bratislavský kraj";11;0;0;0;NA;87541;11;2020-09-06;1333
2020-09-05;"Bratislavský kraj";37;0;0;0;NA;87541;37;2020-09-05;1322
2020-09-04;"Bratislavský kraj";87;0;0;0;NA;87541;87;2020-09-04;1285
2020-09-03;"Bratislavský kraj";51;0;0;0;NA;87541;51;2020-09-03;1198
2020-09-02;"Bratislavský kraj";50;0;0;0;NA;87541;50;2020-09-02;1147
2020-09-01;"Bratislavský kraj";16;0;0;0;NA;87541;16;2020-09-01;1097
2020-08-31;"Bratislavský kraj";19;0;0;0;NA;87541;19;2020-08-31;1081
2020-08-30;"Bratislavský kraj";9;0;0;0;NA;87541;9;2020-08-30;1062
2020-08-29;"Bratislavský kraj";12;0;0;0;NA;87541;12;2020-08-29;1053
2020-08-28;"Bratislavský kraj";35;0;0;0;NA;87541;35;2020-08-28;1041
2020-08-27;"Bratislavský kraj";33;0;0;0;NA;87541;33;2020-08-27;1006
2020-08-26;"Bratislavský kraj";27;0;0;0;NA;87541;27;2020-08-26;973
2020-08-25;"Bratislavský kraj";29;0;0;0;NA;87541;29;2020-08-25;946
2020-08-24;"Bratislavský kraj";6;0;0;0;NA;87541;6;2020-08-24;917
2020-08-23;"Bratislavský kraj";45;0;0;0;NA;87541;45;2020-08-23;911
2020-08-22;"Bratislavský kraj";13;0;0;0;NA;87541;13;2020-08-22;866
2020-08-21;"Bratislavský kraj";46;0;0;0;NA;87541;46;2020-08-21;853
2020-08-20;"Bratislavský kraj";41;0;0;0;NA;87541;41;2020-08-20;807
2020-08-19;"Bratislavský kraj";27;0;0;0;NA;87541;27;2020-08-19;766
2020-08-18;"Bratislavský kraj";47;0;0;0;NA;87541;47;2020-08-18;739
2020-08-17;"Bratislavský kraj";2;0;0;0;NA;87541;2;2020-08-17;692
2020-08-16;"Bratislavský kraj";3;0;0;0;NA;87541;3;2020-08-16;690
2020-08-15;"Bratislavský kraj";18;0;0;0;NA;87541;18;2020-08-15;687
2020-08-14;"Bratislavský kraj";16;0;0;0;NA;87541;16;2020-08-14;669
2020-08-13;"Bratislavský kraj";12;0;0;0;NA;87541;12;2020-08-13;653
2020-08-12;"Bratislavský kraj";10;0;0;0;NA;87541;10;2020-08-12;641
2020-08-11;"Bratislavský kraj";23;0;0;0;NA;87541;23;2020-08-11;631
2020-08-10;"Bratislavský kraj";2;0;0;0;NA;87541;2;2020-08-10;608
2020-08-09;"Bratislavský kraj";2;0;0;0;NA;87541;2;2020-08-09;606
2020-08-08;"Bratislavský kraj";1;0;0;0;NA;87541;1;2020-08-08;604
2020-08-07;"Bratislavský kraj";9;0;0;0;NA;87541;9;2020-08-07;603
2020-08-06;"Bratislavský kraj";15;0;0;0;NA;87541;15;2020-08-06;594
2020-08-05;"Bratislavský kraj";11;0;0;0;NA;87541;11;2020-08-05;579
2020-08-04;"Bratislavský kraj";21;0;0;0;NA;87541;21;2020-08-04;568
2020-08-03;"Bratislavský kraj";7;0;0;0;NA;87541;7;2020-08-03;547
2020-08-02;"Bratislavský kraj";0;0;0;0;NA;87541;0;2020-08-02;540
2020-08-01;"Bratislavský kraj";0;0;0;0;NA;87541;0;2020-08-01;540
2020-07-31;"Bratislavský kraj";14;0;0;0;NA;87541;14;2020-07-31;540
2020-07-30;"Bratislavský kraj";6;0;0;0;NA;87541;6;2020-07-30;526
2020-07-29;"Bratislavský kraj";7;0;0;0;NA;87541;7;2020-07-29;520
2020-07-28;"Bratislavský kraj";14;0;0;0;NA;87541;14;2020-07-28;513
2020-07-27;"Bratislavský kraj";3;0;0;0;NA;87541;3;2020-07-27;499
2020-07-26;"Bratislavský kraj";0;0;0;0;NA;87541;0;2020-07-26;496
2020-07-25;"Bratislavský kraj";8;0;0;0;NA;87541;8;2020-07-25;496
2020-07-24;"Bratislavský kraj";2;0;0;0;NA;87541;2;2020-07-24;488
2020-07-23;"Bratislavský kraj";8;0;0;0;NA;87541;8;2020-07-23;486
2020-07-22;"Bratislavský kraj";11;0;0;0;NA;87541;11;2020-07-22;478
2020-07-21;"Bratislavský kraj";8;0;0;0;NA;87541;8;2020-07-21;467
2020-07-20;"Bratislavský kraj";12;0;0;0;NA;87541;12;2020-07-20;459
2020-07-19;"Bratislavský kraj";0;0;0;0;NA;87541;0;2020-07-19;447
2020-07-18;"Bratislavský kraj";2;0;0;0;NA;87541;2;2020-07-18;447
2020-07-17;"Bratislavský kraj";2;0;0;0;NA;87541;2;2020-07-17;445
2020-07-16;"Bratislavský kraj";6;0;0;0;NA;87541;6;2020-07-16;443
2020-07-15;"Bratislavský kraj";3;0;0;0;NA;87541;3;2020-07-15;437
2020-07-14;"Bratislavský kraj";2;0;0;0;NA;87541;2;2020-07-14;434
2020-07-13;"Bratislavský kraj";2;0;0;0;NA;87541;2;2020-07-13;432
2020-07-12;"Bratislavský kraj";0;0;0;0;NA;87541;0;2020-07-12;430
2020-07-11;"Bratislavský kraj";0;0;0;0;NA;87541;0;2020-07-11;430
2020-07-10;"Bratislavský kraj";8;0;0;0;NA;87541;8;2020-07-10;430
2020-07-09;"Bratislavský kraj";2;0;0;0;NA;87541;2;2020-07-09;422
2020-07-08;"Bratislavský kraj";11;0;0;0;NA;87541;11;2020-07-08;420
2020-07-07;"Bratislavský kraj";5;0;0;0;NA;87541;5;2020-07-07;409
2020-07-06;"Bratislavský kraj";1;0;0;0;NA;87541;1;2020-07-06;404
2020-07-05;"Bratislavský kraj";0;0;0;0;NA;87541;0;2020-07-05;403
2020-07-04;"Bratislavský kraj";3;0;0;0;NA;87541;3;2020-07-04;403
2020-07-03;"Bratislavský kraj";1;0;0;0;NA;87541;1;2020-07-03;400
2020-07-02;"Bratislavský kraj";0;0;0;0;NA;87541;0;2020-07-02;399
2020-07-01;"Bratislavský kraj";7;0;0;0;NA;87541;7;2020-07-01;399
2020-06-30;"Bratislavský kraj";3;0;0;0;NA;87541;3;2020-06-30;392
2020-06-29;"Bratislavský kraj";1;0;0;0;NA;87541;1;2020-06-29;389
2020-06-28;"Bratislavský kraj";0;0;0;0;NA;87541;0;2020-06-28;388
2020-06-27;"Bratislavský kraj";1;0;0;0;NA;87541;1;2020-06-27;388
2020-06-26;"Bratislavský kraj";6;0;0;0;NA;87541;6;2020-06-26;387
2020-06-25;"Bratislavský kraj";0;0;0;0;NA;87541;0;2020-06-25;381
2020-06-24;"Bratislavský kraj";3;0;0;0;NA;87541;3;2020-06-24;381
2020-06-23;"Bratislavský kraj";0;0;0;0;NA;87541;0;2020-06-23;378
2020-06-22;"Bratislavský kraj";1;0;0;0;NA;87541;1;2020-06-22;378
2020-06-21;"Bratislavský kraj";0;0;0;0;NA;87541;0;2020-06-21;377
2020-06-20;"Bratislavský kraj";0;0;0;0;NA;87541;0;2020-06-20;377
2020-06-19;"Bratislavský kraj";3;0;0;0;NA;87541;3;2020-06-19;377
2020-06-18;"Bratislavský kraj";0;0;0;0;NA;87541;0;2020-06-18;374
2020-06-17;"Bratislavský kraj";0;0;0;0;NA;87541;0;2020-06-17;374
2020-06-16;"Bratislavský kraj";0;0;0;0;NA;87541;0;2020-06-16;374
2020-06-14;"Bratislavský kraj";2;0;0;0;NA;87541;2;2020-06-14;374
2020-06-13;"Bratislavský kraj";1;0;0;0;NA;87541;1;2020-06-13;372
2020-06-12;"Bratislavský kraj";2;0;0;0;NA;87541;2;2020-06-12;371
2020-06-11;"Bratislavský kraj";0;0;0;0;NA;87541;0;2020-06-11;369
2020-06-10;"Bratislavský kraj";0;0;0;0;NA;87541;0;2020-06-10;369
2020-06-09;"Bratislavský kraj";0;0;0;0;NA;87541;0;2020-06-09;369
2020-06-08;"Bratislavský kraj";1;0;0;0;NA;87541;1;2020-06-08;369
2020-06-07;"Bratislavský kraj";0;0;0;0;NA;87541;0;2020-06-07;368
2020-06-05;"Bratislavský kraj";0;0;0;0;NA;87541;0;2020-06-05;368
2020-06-03;"Bratislavský kraj";1;0;0;0;NA;87541;1;2020-06-03;368
2020-06-02;"Bratislavský kraj";0;0;0;0;NA;87541;0;2020-06-02;367
2020-05-31;"Bratislavský kraj";0;0;0;0;NA;87541;0;2020-05-31;367
2020-05-29;"Bratislavský kraj";0;0;0;0;NA;87541;0;2020-05-29;367
2020-05-27;"Bratislavský kraj";1;0;0;0;NA;87541;1;2020-05-27;367
2020-05-26;"Bratislavský kraj";0;0;0;0;NA;87541;0;2020-05-26;366
2020-05-25;"Bratislavský kraj";0;0;0;0;NA;87541;0;2020-05-25;366
2020-05-24;"Bratislavský kraj";0;0;0;0;NA;87541;0;2020-05-24;366
2020-05-23;"Bratislavský kraj";2;0;0;0;NA;87541;2;2020-05-23;366
2020-05-22;"Bratislavský kraj";0;0;0;0;NA;87541;0;2020-05-22;364
2020-05-21;"Bratislavský kraj";0;0;0;0;NA;87541;0;2020-05-21;364
2020-05-20;"Bratislavský kraj";0;0;0;0;NA;87541;0;2020-05-20;364
2020-05-19;"Bratislavský kraj";0;0;0;0;NA;87541;0;2020-05-19;364
2020-05-17;"Bratislavský kraj";0;0;0;0;NA;87541;0;2020-05-17;364
2020-05-16;"Bratislavský kraj";0;0;0;0;NA;87541;0;2020-05-16;364
2020-05-15;"Bratislavský kraj";0;0;0;0;NA;87541;0;2020-05-15;364
2020-05-14;"Bratislavský kraj";0;0;0;0;NA;87541;0;2020-05-14;364
2020-05-13;"Bratislavský kraj";0;0;0;0;NA;87541;0;2020-05-13;364
2020-05-12;"Bratislavský kraj";2;0;0;0;NA;87541;2;2020-05-12;364
2020-05-11;"Bratislavský kraj";0;0;0;0;NA;87541;0;2020-05-11;362
2020-05-09;"Bratislavský kraj";0;0;0;0;NA;87541;0;2020-05-09;362
2020-05-07;"Bratislavský kraj";1;0;0;0;NA;87541;1;2020-05-07;362
2020-05-06;"Bratislavský kraj";3;0;0;0;NA;87541;3;2020-05-06;361
2020-05-05;"Bratislavský kraj";0;0;0;0;NA;87541;0;2020-05-05;358
2020-05-04;"Bratislavský kraj";0;0;0;0;NA;87541;0;2020-05-04;358
2020-05-03;"Bratislavský kraj";2;0;0;0;NA;87541;2;2020-05-03;358
2020-05-02;"Bratislavský kraj";0;0;0;0;NA;87541;0;2020-05-02;356
2020-05-01;"Bratislavský kraj";0;0;0;0;NA;87541;0;2020-05-01;356
2020-04-30;"Bratislavský kraj";5;0;0;0;NA;87541;5;2020-04-30;356
2020-04-29;"Bratislavský kraj";0;0;0;0;NA;87541;0;2020-04-29;351
2020-04-28;"Bratislavský kraj";2;0;0;0;NA;87541;2;2020-04-28;351
2020-04-27;"Bratislavský kraj";0;0;0;0;NA;87541;0;2020-04-27;349
2020-04-26;"Bratislavský kraj";1;0;0;0;NA;87541;1;2020-04-26;349
2020-04-25;"Bratislavský kraj";0;0;0;0;NA;87541;0;2020-04-25;348
2020-04-24;"Bratislavský kraj";2;0;0;0;NA;87541;2;2020-04-24;348
2020-04-23;"Bratislavský kraj";6;0;0;0;NA;87541;6;2020-04-23;346
2020-04-22;"Bratislavský kraj";11;0;0;0;NA;87541;11;2020-04-22;340
2020-04-21;"Bratislavský kraj";4;0;0;0;NA;87541;4;2020-04-21;329
2020-04-20;"Bratislavský kraj";0;0;0;0;NA;87541;0;2020-04-20;325
2020-04-19;"Bratislavský kraj";4;0;0;0;NA;87541;4;2020-04-19;325
2020-04-18;"Bratislavský kraj";5;0;0;0;NA;87541;5;2020-04-18;321
2020-04-17;"Bratislavský kraj";6;0;0;0;NA;87541;6;2020-04-17;316
2020-04-16;"Bratislavský kraj";15;0;0;0;NA;87541;15;2020-04-16;310
2020-04-15;"Bratislavský kraj";11;0;0;0;NA;87541;11;2020-04-15;295
2020-04-14;"Bratislavský kraj";19;0;0;0;NA;87541;19;2020-04-14;284
2020-04-13;"Bratislavský kraj";53;0;0;0;NA;87541;53;2020-04-13;265
2020-04-12;"Bratislavský kraj";3;0;0;0;NA;87541;3;2020-04-12;212
2020-04-11;"Bratislavský kraj";1;0;0;0;NA;87541;1;2020-04-11;209
2020-04-10;"Bratislavský kraj";8;0;0;0;NA;87541;8;2020-04-10;208
2020-04-09;"Bratislavský kraj";3;0;0;0;NA;87541;3;2020-04-09;200
2020-04-08;"Bratislavský kraj";3;0;0;0;NA;87541;3;2020-04-08;197
2020-04-07;"Bratislavský kraj";24;0;0;0;NA;87541;24;2020-04-07;194
2020-04-06;"Bratislavský kraj";5;0;0;0;NA;87541;5;2020-04-06;170
2020-04-05;"Bratislavský kraj";6;0;0;0;NA;87541;6;2020-04-05;165
2020-04-04;"Bratislavský kraj";2;0;0;0;NA;87541;2;2020-04-04;159
2020-04-03;"Bratislavský kraj";1;0;0;0;NA;87541;1;2020-04-03;157
2020-04-02;"Bratislavský kraj";2;0;0;0;NA;87541;2;2020-04-02;156
2020-04-01;"Bratislavský kraj";5;0;0;0;NA;87541;5;2020-04-01;154
2020-03-31;"Bratislavský kraj";19;0;0;0;NA;87541;19;2020-03-31;149
2020-03-30;"Bratislavský kraj";6;0;0;0;NA;87541;6;2020-03-30;130
2020-03-29;"Bratislavský kraj";8;0;0;0;NA;87541;8;2020-03-29;124
2020-03-28;"Bratislavský kraj";4;0;0;0;NA;87541;4;2020-03-28;116
2020-03-27;"Bratislavský kraj";3;0;0;0;NA;87541;3;2020-03-27;112
2020-03-26;"Bratislavský kraj";15;0;0;0;NA;87541;15;2020-03-26;109
2020-03-25;"Bratislavský kraj";1;0;0;0;NA;87541;1;2020-03-25;94
2020-03-24;"Bratislavský kraj";4;0;0;0;NA;87541;4;2020-03-24;93
2020-03-23;"Bratislavský kraj";9;0;0;0;NA;87541;9;2020-03-23;89
2020-03-22;"Bratislavský kraj";2;0;0;0;NA;87541;2;2020-03-22;80
2020-03-21;"Bratislavský kraj";22;0;0;0;NA;87541;22;2020-03-21;78
2020-03-20;"Bratislavský kraj";3;0;0;0;NA;87541;3;2020-03-20;56
2020-03-19;"Bratislavský kraj";4;0;0;0;NA;87541;4;2020-03-19;53
2020-03-18;"Bratislavský kraj";3;0;0;0;NA;87541;3;2020-03-18;49
2020-03-17;"Bratislavský kraj";13;0;0;0;NA;87541;13;2020-03-17;46
2020-03-16;"Bratislavský kraj";1;0;0;0;NA;87541;1;2020-03-16;33
2020-03-15;"Bratislavský kraj";4;0;0;0;NA;87541;4;2020-03-15;32
2020-03-14;"Bratislavský kraj";9;0;0;0;NA;87541;9;2020-03-14;28
2020-03-13;"Bratislavský kraj";2;0;0;0;NA;87541;2;2020-03-13;19
2020-03-12;"Bratislavský kraj";8;0;0;0;NA;87541;8;2020-03-12;17
2020-03-11;"Bratislavský kraj";3;0;0;0;NA;87541;3;2020-03-11;9
2020-03-09;"Bratislavský kraj";0;0;0;0;NA;87541;0;2020-03-09;6
2020-03-08;"Bratislavský kraj";2;0;0;0;NA;87541;2;2020-03-08;6
2020-03-07;"Bratislavský kraj";2;0;0;0;NA;87541;2;2020-03-07;4
2020-03-06;"Bratislavský kraj";1;0;0;0;NA;87541;1;2020-03-06;2
2021-05-30;"Košický kraj";3;10790;9;10799;52573;94074;12;2021-05-30;94074
2021-05-29;"Košický kraj";25;10076;22;10098;NA;94074;47;2021-05-29;94062
2021-05-28;"Košický kraj";17;12457;28;12485;NA;94074;45;2021-05-28;94015
2021-05-27;"Košický kraj";19;7425;24;7449;NA;94074;43;2021-05-27;93970
2021-05-26;"Košický kraj";35;7922;27;7949;NA;94074;62;2021-05-26;93927
2021-05-25;"Košický kraj";33;9042;12;9054;NA;94074;45;2021-05-25;93865
2021-05-24;"Košický kraj";10;10613;26;10639;NA;94074;36;2021-05-24;93820
2021-05-23;"Košický kraj";4;12151;15;12166;NA;94074;19;2021-05-23;93784
2021-05-22;"Košický kraj";27;12601;19;12620;NA;94074;46;2021-05-22;93765
2021-05-21;"Košický kraj";24;14910;27;14937;NA;94074;51;2021-05-21;93719
2021-05-20;"Košický kraj";20;9422;28;9450;NA;94074;48;2021-05-20;93668
2021-05-19;"Košický kraj";30;10421;21;10442;NA;94074;51;2021-05-19;93620
2021-05-18;"Košický kraj";34;10080;34;10114;NA;94074;68;2021-05-18;93569
2021-05-17;"Košický kraj";20;12686;38;12724;NA;94074;58;2021-05-17;93501
2021-05-16;"Košický kraj";37;17865;20;17885;NA;94074;57;2021-05-16;93443
2021-05-15;"Košický kraj";22;25602;28;25630;NA;94074;50;2021-05-15;93386
2021-05-14;"Košický kraj";32;21933;42;21975;NA;94074;74;2021-05-14;93336
2021-05-13;"Košický kraj";39;10041;32;10073;NA;94074;71;2021-05-13;93262
2021-05-12;"Košický kraj";85;10866;33;10899;NA;94074;118;2021-05-12;93191
2021-05-11;"Košický kraj";68;11166;32;11198;NA;94074;100;2021-05-11;93073
2021-05-10;"Košický kraj";25;17042;42;17084;NA;94074;67;2021-05-10;92973
2021-05-09;"Košický kraj";84;25594;55;25649;NA;94074;139;2021-05-09;92906
2021-05-08;"Košický kraj";18;23195;23;23218;NA;94074;41;2021-05-08;92767
2021-05-07;"Košický kraj";51;24493;57;24550;NA;94074;108;2021-05-07;92726
2021-05-06;"Košický kraj";55;11892;43;11935;NA;94074;98;2021-05-06;92618
2021-05-05;"Košický kraj";23;12072;35;12107;NA;94074;58;2021-05-05;92520
2021-05-04;"Košický kraj";143;13562;38;13600;NA;94074;181;2021-05-04;92462
2021-05-03;"Košický kraj";37;17041;69;17110;NA;94074;106;2021-05-03;92281
2021-05-02;"Košický kraj";45;36095;56;36151;NA;94074;101;2021-05-02;92175
2021-05-01;"Košický kraj";54;51896;76;51972;NA;94074;130;2021-05-01;92074
2021-04-30;"Košický kraj";59;0;0;0;NA;94074;59;2021-04-30;91944
2021-04-29;"Košický kraj";76;0;0;0;NA;94074;76;2021-04-29;91885
2021-04-28;"Košický kraj";99;0;0;0;NA;94074;99;2021-04-28;91809
2021-04-27;"Košický kraj";108;0;0;0;NA;94074;108;2021-04-27;91710
2021-04-26;"Košický kraj";39;0;0;0;NA;94074;39;2021-04-26;91602
2021-04-25;"Košický kraj";23;0;0;0;NA;94074;23;2021-04-25;91563
2021-04-24;"Košický kraj";68;0;0;0;NA;94074;68;2021-04-24;91540
2021-04-23;"Košický kraj";110;0;0;0;NA;94074;110;2021-04-23;91472
2021-04-22;"Košický kraj";56;0;0;0;NA;94074;56;2021-04-22;91362
2021-04-21;"Košický kraj";114;0;0;0;NA;94074;114;2021-04-21;91306
2021-04-20;"Košický kraj";81;0;0;0;NA;94074;81;2021-04-20;91192
2021-04-19;"Košický kraj";93;0;0;0;NA;94074;93;2021-04-19;91111
2021-04-18;"Košický kraj";10;0;0;0;NA;94074;10;2021-04-18;91018
2021-04-17;"Košický kraj";187;0;0;0;NA;94074;187;2021-04-17;91008
2021-04-16;"Košický kraj";83;0;0;0;NA;94074;83;2021-04-16;90821
2021-04-15;"Košický kraj";104;0;0;0;NA;94074;104;2021-04-15;90738
2021-04-14;"Košický kraj";119;0;0;0;NA;94074;119;2021-04-14;90634
2021-04-13;"Košický kraj";81;0;0;0;NA;94074;81;2021-04-13;90515
2021-04-12;"Košický kraj";129;0;0;0;NA;94074;129;2021-04-12;90434
2021-04-11;"Košický kraj";29;0;0;0;NA;94074;29;2021-04-11;90305
2021-04-10;"Košický kraj";138;0;0;0;NA;94074;138;2021-04-10;90276
2021-04-09;"Košický kraj";168;0;0;0;NA;94074;168;2021-04-09;90138
2021-04-08;"Košický kraj";81;0;0;0;NA;94074;81;2021-04-08;89970
2021-04-07;"Košický kraj";232;0;0;0;NA;94074;232;2021-04-07;89889
2021-04-06;"Košický kraj";121;0;0;0;NA;94074;121;2021-04-06;89657
2021-04-05;"Košický kraj";19;0;0;0;NA;94074;19;2021-04-05;89536
2021-04-04;"Košický kraj";33;0;0;0;NA;94074;33;2021-04-04;89517
2021-04-03;"Košický kraj";138;0;0;0;NA;94074;138;2021-04-03;89484
2021-04-02;"Košický kraj";128;0;0;0;NA;94074;128;2021-04-02;89346
2021-04-01;"Košický kraj";165;0;0;0;NA;94074;165;2021-04-01;89218
2021-03-31;"Košický kraj";160;29659;124;29783;NA;94074;284;2021-03-31;89053
2021-03-30;"Košický kraj";229;24038;163;24201;NA;94074;392;2021-03-30;88769
2021-03-29;"Košický kraj";78;28843;194;29037;NA;94074;272;2021-03-29;88377
2021-03-28;"Košický kraj";39;44263;128;44391;NA;94074;167;2021-03-28;88105
2021-03-27;"Košický kraj";222;96602;265;96867;NA;94074;487;2021-03-27;87938
2021-03-26;"Košický kraj";233;45252;202;45454;NA;94074;435;2021-03-26;87451
2021-03-25;"Košický kraj";133;23804;175;23979;NA;94074;308;2021-03-25;87016
2021-03-24;"Košický kraj";165;20677;155;20832;NA;94074;320;2021-03-24;86708
2021-03-23;"Košický kraj";202;22434;192;22626;NA;94074;394;2021-03-23;86388
2021-03-22;"Košický kraj";169;26890;228;27118;NA;94074;397;2021-03-22;85994
2021-03-21;"Košický kraj";109;46746;167;46913;NA;94074;276;2021-03-21;85597
2021-03-20;"Košický kraj";126;101334;311;101645;NA;94074;437;2021-03-20;85321
2021-03-19;"Košický kraj";205;45632;260;45892;NA;94074;465;2021-03-19;84884
2021-03-18;"Košický kraj";274;23823;212;24035;NA;94074;486;2021-03-18;84419
2021-03-17;"Košický kraj";177;21545;195;21740;NA;94074;372;2021-03-17;83933
2021-03-16;"Košický kraj";386;23431;226;23657;NA;94074;612;2021-03-16;83561
2021-03-15;"Košický kraj";173;27900;297;28197;NA;94074;470;2021-03-15;82949
2021-03-14;"Košický kraj";145;44354;220;44574;NA;94074;365;2021-03-14;82479
2021-03-13;"Košický kraj";146;103790;483;104273;NA;94074;629;2021-03-13;82114
2021-03-12;"Košický kraj";366;47871;321;48192;NA;94074;687;2021-03-12;81485
2021-03-11;"Košický kraj";396;23229;263;23492;NA;94074;659;2021-03-11;80798
2021-03-10;"Košický kraj";121;22191;269;22460;NA;94074;390;2021-03-10;80139
2021-03-09;"Košický kraj";676;24509;300;24809;NA;94074;976;2021-03-09;79749
2021-03-08;"Košický kraj";559;29836;344;30180;NA;94074;903;2021-03-08;78773
2021-03-07;"Košický kraj";45;44230;299;44529;NA;94074;344;2021-03-07;77870
2021-03-06;"Košický kraj";177;105598;532;106130;NA;94074;709;2021-03-06;77526
2021-03-05;"Košický kraj";439;45567;424;45991;NA;94074;863;2021-03-05;76817
2021-03-04;"Košický kraj";417;23862;320;24182;NA;94074;737;2021-03-04;75954
2021-03-03;"Košický kraj";390;23168;298;23466;NA;94074;688;2021-03-03;75217
2021-03-02;"Košický kraj";464;24150;368;24518;NA;94074;832;2021-03-02;74529
2021-03-01;"Košický kraj";389;30013;514;30527;NA;94074;903;2021-03-01;73697
2021-02-28;"Košický kraj";265;43053;334;43387;NA;94074;599;2021-02-28;72794
2021-02-27;"Košický kraj";301;101274;787;102061;NA;94074;1088;2021-02-27;72195
2021-02-26;"Košický kraj";440;45466;492;45958;NA;94074;932;2021-02-26;71107
2021-02-25;"Košický kraj";331;19872;342;20214;NA;94074;673;2021-02-25;70175
2021-02-24;"Košický kraj";263;18815;506;19321;NA;94074;769;2021-02-24;69502
2021-02-23;"Košický kraj";642;21592;341;21933;NA;94074;983;2021-02-23;68733
2021-02-22;"Košický kraj";362;30830;434;31264;NA;94074;796;2021-02-22;67750
2021-02-21;"Košický kraj";170;40464;385;40849;NA;94074;555;2021-02-21;66954
2021-02-20;"Košický kraj";283;92550;770;93320;NA;94074;1053;2021-02-20;66399
2021-02-19;"Košický kraj";507;42016;586;42602;NA;94074;1093;2021-02-19;65346
2021-02-18;"Košický kraj";397;18442;345;18787;NA;94074;742;2021-02-18;64253
2021-02-17;"Košický kraj";322;18080;387;18467;NA;94074;709;2021-02-17;63511
2021-02-16;"Košický kraj";600;22111;463;22574;NA;94074;1063;2021-02-16;62802
2021-02-15;"Košický kraj";216;27633;419;28052;NA;94074;635;2021-02-15;61739
2021-02-14;"Košický kraj";241;56743;524;57267;NA;94074;765;2021-02-14;61104
2021-02-13;"Košický kraj";206;93965;765;94730;NA;94074;971;2021-02-13;60339
2021-02-12;"Košický kraj";448;50184;611;50795;NA;94074;1059;2021-02-12;59368
2021-02-11;"Košický kraj";435;14524;323;14847;NA;94074;758;2021-02-11;58309
2021-02-10;"Košický kraj";360;18475;431;18906;NA;94074;791;2021-02-10;57551
2021-02-09;"Košický kraj";545;24841;463;25304;NA;94074;1008;2021-02-09;56760
2021-02-08;"Košický kraj";237;24836;392;25228;NA;94074;629;2021-02-08;55752
2021-02-07;"Košický kraj";208;56897;612;57509;NA;94074;820;2021-02-07;55123
2021-02-06;"Košický kraj";318;104357;884;105241;NA;94074;1202;2021-02-06;54303
2021-02-05;"Košický kraj";384;43186;494;43680;NA;94074;878;2021-02-05;53101
2021-02-04;"Košický kraj";391;14508;371;14879;NA;94074;762;2021-02-04;52223
2021-02-03;"Košický kraj";296;12599;339;12938;NA;94074;635;2021-02-03;51461
2021-02-02;"Košický kraj";473;43883;1212;45095;NA;94074;1685;2021-02-02;50826
2021-02-01;"Košický kraj";415;21965;362;22327;NA;94074;777;2021-02-01;49141
2021-01-31;"Košický kraj";142;54154;609;54763;NA;94074;751;2021-01-31;48364
2021-01-30;"Košický kraj";320;76925;665;77590;NA;94074;985;2021-01-30;47613
2021-01-29;"Košický kraj";311;37130;466;37596;NA;94074;777;2021-01-29;46628
2021-01-28;"Košický kraj";540;9006;244;9250;NA;94074;784;2021-01-28;45851
2021-01-27;"Košický kraj";265;7575;211;7786;NA;94074;476;2021-01-27;45067
2021-01-26;"Košický kraj";530;14256;246;14502;NA;94074;776;2021-01-26;44591
2021-01-25;"Košický kraj";226;26430;413;26843;NA;94074;639;2021-01-25;43815
2021-01-24;"Košický kraj";150;44419;581;45000;NA;94074;731;2021-01-24;43176
2021-01-23;"Košický kraj";232;82705;857;83562;NA;94074;1089;2021-01-23;42445
2021-01-22;"Košický kraj";316;19997;265;20262;NA;94074;581;2021-01-22;41356
2021-01-21;"Košický kraj";274;14047;158;14205;NA;94074;432;2021-01-21;40775
2021-01-20;"Košický kraj";374;10843;201;11044;NA;94074;575;2021-01-20;40343
2021-01-19;"Košický kraj";248;9717;181;9898;NA;94074;429;2021-01-19;39768
2021-01-18;"Košický kraj";333;7659;262;7921;NA;94074;595;2021-01-18;39339
2021-01-17;"Košický kraj";155;535;14;549;NA;94074;169;2021-01-17;38744
2021-01-16;"Košický kraj";153;1403;47;1450;NA;94074;200;2021-01-16;38575
2021-01-15;"Košický kraj";308;6443;213;6656;NA;94074;521;2021-01-15;38375
2021-01-14;"Košický kraj";358;5471;221;5692;NA;94074;579;2021-01-14;37854
2021-01-13;"Košický kraj";421;4897;226;5123;NA;94074;647;2021-01-13;37275
2021-01-12;"Košický kraj";482;6689;258;6947;NA;94074;740;2021-01-12;36628
2021-01-11;"Košický kraj";309;7945;304;8249;NA;94074;613;2021-01-11;35888
2021-01-10;"Košický kraj";193;136;6;142;NA;94074;199;2021-01-10;35275
2021-01-09;"Košický kraj";469;1134;45;1179;NA;94074;514;2021-01-09;35076
2021-01-08;"Košický kraj";551;8222;388;8610;NA;94074;939;2021-01-08;34562
2021-01-07;"Košický kraj";251;6566;434;7000;NA;94074;685;2021-01-07;33623
2021-01-06;"Košický kraj";442;429;33;462;NA;94074;475;2021-01-06;32938
2021-01-05;"Košický kraj";584;8100;560;8660;NA;94074;1144;2021-01-05;32463
2021-01-04;"Košický kraj";407;7113;737;7850;NA;94074;1144;2021-01-04;31319
2021-01-03;"Košický kraj";118;661;22;683;NA;94074;140;2021-01-03;30175
2021-01-02;"Košický kraj";88;440;52;492;NA;94074;140;2021-01-02;30035
2021-01-01;"Košický kraj";398;725;49;774;NA;94074;447;2021-01-01;29895
2020-12-31;"Košický kraj";625;7877;461;8338;NA;94074;1086;2020-12-31;29448
2020-12-30;"Košický kraj";590;6477;412;6889;NA;94074;1002;2020-12-30;28362
2020-12-29;"Košický kraj";419;7573;605;8178;NA;94074;1024;2020-12-29;27360
2020-12-28;"Košický kraj";356;8296;804;9100;NA;94074;1160;2020-12-28;26336
2020-12-27;"Košický kraj";159;147;16;163;NA;94074;175;2020-12-27;25176
2020-12-26;"Košický kraj";163;274;23;297;NA;94074;186;2020-12-26;25001
2020-12-25;"Košický kraj";237;140;10;150;NA;94074;247;2020-12-25;24815
2020-12-24;"Košický kraj";564;1470;90;1560;NA;94074;654;2020-12-24;24568
2020-12-23;"Košický kraj";304;7942;354;8296;NA;94074;658;2020-12-23;23914
2020-12-22;"Košický kraj";438;7920;459;8379;NA;94074;897;2020-12-22;23256
2020-12-21;"Košický kraj";405;6984;509;7493;NA;94074;914;2020-12-21;22359
2020-12-20;"Košický kraj";215;73;11;84;NA;94074;226;2020-12-20;21445
2020-12-19;"Košický kraj";207;1309;63;1372;NA;94074;270;2020-12-19;21219
2020-12-18;"Košický kraj";310;8484;326;8810;NA;94074;636;2020-12-18;20949
2020-12-17;"Košický kraj";463;5292;255;5547;NA;94074;718;2020-12-17;20313
2020-12-16;"Košický kraj";455;5898;316;6214;NA;94074;771;2020-12-16;19595
2020-12-15;"Košický kraj";319;5086;338;5424;NA;94074;657;2020-12-15;18824
2020-12-14;"Košický kraj";256;3401;264;3665;NA;94074;520;2020-12-14;18167
2020-12-13;"Košický kraj";47;181;2;183;NA;94074;49;2020-12-13;17647
2020-12-12;"Košický kraj";369;1587;118;1705;NA;94074;487;2020-12-12;17598
2020-12-11;"Košický kraj";354;5461;258;5719;NA;94074;612;2020-12-11;17111
2020-12-10;"Košický kraj";283;4064;176;4240;NA;94074;459;2020-12-10;16499
2020-12-09;"Košický kraj";279;3786;166;3952;NA;94074;445;2020-12-09;16040
2020-12-08;"Košický kraj";226;4105;355;4460;NA;94074;581;2020-12-08;15595
2020-12-07;"Košický kraj";270;2383;106;2489;NA;94074;376;2020-12-07;15014
2020-12-06;"Košický kraj";121;97;20;117;NA;94074;141;2020-12-06;14638
2020-12-05;"Košický kraj";90;1096;48;1144;NA;94074;138;2020-12-05;14497
2020-12-04;"Košický kraj";224;2680;82;2762;NA;94074;306;2020-12-04;14359
2020-12-03;"Košický kraj";211;7717;173;7890;NA;94074;384;2020-12-03;14053
2020-12-02;"Košický kraj";193;8132;496;8628;NA;94074;689;2020-12-02;13669
2020-12-01;"Košický kraj";178;2237;124;2361;NA;94074;302;2020-12-01;12980
2020-11-30;"Košický kraj";171;3754;62;3816;NA;94074;233;2020-11-30;12678
2020-11-29;"Košický kraj";31;325;17;342;NA;94074;48;2020-11-29;12445
2020-11-28;"Košický kraj";69;721;52;773;NA;94074;121;2020-11-28;12397
2020-11-27;"Košický kraj";149;2921;78;2999;NA;94074;227;2020-11-27;12276
2020-11-26;"Košický kraj";239;1234;60;1294;NA;94074;299;2020-11-26;12049
2020-11-25;"Košický kraj";237;1785;123;1908;NA;94074;360;2020-11-25;11750
2020-11-24;"Košický kraj";196;1976;67;2043;NA;94074;263;2020-11-24;11390
2020-11-23;"Košický kraj";51;4115;63;4178;NA;94074;114;2020-11-23;11127
2020-11-22;"Košický kraj";57;57;5;62;NA;94074;62;2020-11-22;11013
2020-11-21;"Košický kraj";87;858;36;894;NA;94074;123;2020-11-21;10951
2020-11-20;"Košický kraj";176;3084;49;3133;NA;94074;225;2020-11-20;10828
2020-11-19;"Košický kraj";206;1736;48;1784;NA;94074;254;2020-11-19;10603
2020-11-18;"Košický kraj";122;532;17;549;NA;94074;139;2020-11-18;10349
2020-11-17;"Košický kraj";152;82;9;91;NA;94074;161;2020-11-17;10210
2020-11-16;"Košický kraj";114;596;27;623;NA;94074;141;2020-11-16;10049
2020-11-15;"Košický kraj";15;338;7;345;NA;94074;22;2020-11-15;9908
2020-11-14;"Košický kraj";234;520;12;532;NA;94074;246;2020-11-14;9886
2020-11-13;"Košický kraj";207;664;29;693;NA;94074;236;2020-11-13;9640
2020-11-12;"Košický kraj";192;736;13;749;NA;94074;205;2020-11-12;9404
2020-11-11;"Košický kraj";301;593;7;600;NA;94074;308;2020-11-11;9199
2020-11-10;"Košický kraj";190;541;11;552;NA;94074;201;2020-11-10;8891
2020-11-09;"Košický kraj";129;380;17;397;NA;94074;146;2020-11-09;8690
2020-11-08;"Košický kraj";78;1306;8;1314;NA;94074;86;2020-11-08;8544
2020-11-07;"Košický kraj";192;3909;22;3931;NA;94074;214;2020-11-07;8458
2020-11-06;"Košický kraj";195;5310;34;5344;NA;94074;229;2020-11-06;8244
2020-11-05;"Košický kraj";342;330;31;361;NA;94074;373;2020-11-05;8015
2020-11-04;"Košický kraj";101;154;6;160;NA;94074;107;2020-11-04;7642
2020-11-03;"Košický kraj";358;1122;13;1135;NA;94074;371;2020-11-03;7535
2020-11-02;"Košický kraj";111;6125;56;6181;NA;94074;167;2020-11-02;7164
2020-11-01;"Košický kraj";346;6522;34;6556;NA;94074;380;2020-11-01;6997
2020-10-31;"Košický kraj";82;14035;106;14141;NA;94074;188;2020-10-31;6617
2020-10-30;"Košický kraj";379;2835;27;2862;NA;94074;406;2020-10-30;6429
2020-10-29;"Košický kraj";333;983;13;996;NA;94074;346;2020-10-29;6023
2020-10-28;"Košický kraj";224;305;13;318;NA;94074;237;2020-10-28;5677
2020-10-27;"Košický kraj";386;439;21;460;NA;94074;407;2020-10-27;5440
2020-10-26;"Košický kraj";56;212;12;224;NA;94074;68;2020-10-26;5033
2020-10-25;"Košický kraj";154;79;2;81;NA;94074;156;2020-10-25;4965
2020-10-24;"Košický kraj";313;118;16;134;NA;94074;329;2020-10-24;4809
2020-10-23;"Košický kraj";315;331;8;339;NA;94074;323;2020-10-23;4480
2020-10-22;"Košický kraj";349;530;16;546;NA;94074;365;2020-10-22;4157
2020-10-21;"Košický kraj";129;84;2;86;NA;94074;131;2020-10-21;3792
2020-10-20;"Košický kraj";181;14;1;15;NA;94074;182;2020-10-20;3661
2020-10-19;"Košický kraj";64;38;1;39;NA;94074;65;2020-10-19;3479
2020-10-18;"Košický kraj";158;0;0;0;NA;94074;158;2020-10-18;3414
2020-10-17;"Košický kraj";142;0;0;0;NA;94074;142;2020-10-17;3256
2020-10-16;"Košický kraj";206;19;0;19;NA;94074;206;2020-10-16;3114
2020-10-15;"Košický kraj";177;19;5;24;NA;94074;182;2020-10-15;2908
2020-10-14;"Košický kraj";211;8;0;8;NA;94074;211;2020-10-14;2726
2020-10-13;"Košický kraj";179;80;3;83;NA;94074;182;2020-10-13;2515
2020-10-12;"Košický kraj";74;0;0;0;NA;94074;74;2020-10-12;2333
2020-10-11;"Košický kraj";121;0;0;0;NA;94074;121;2020-10-11;2259
2020-10-10;"Košický kraj";70;0;0;0;NA;94074;70;2020-10-10;2138
2020-10-09;"Košický kraj";188;0;0;0;NA;94074;188;2020-10-09;2068
2020-10-08;"Košický kraj";102;0;0;0;NA;94074;102;2020-10-08;1880
2020-10-07;"Košický kraj";158;0;0;0;NA;94074;158;2020-10-07;1778
2020-10-06;"Košický kraj";70;0;0;0;NA;94074;70;2020-10-06;1620
2020-10-05;"Košický kraj";39;0;0;0;NA;94074;39;2020-10-05;1550
2020-10-04;"Košický kraj";45;0;0;0;NA;94074;45;2020-10-04;1511
2020-10-03;"Košický kraj";105;0;0;0;NA;94074;105;2020-10-03;1466
2020-10-02;"Košický kraj";57;0;0;0;NA;94074;57;2020-10-02;1361
2020-10-01;"Košický kraj";69;0;0;0;NA;94074;69;2020-10-01;1304
2020-09-30;"Košický kraj";95;0;0;0;NA;94074;95;2020-09-30;1235
2020-09-29;"Košický kraj";75;0;0;0;NA;94074;75;2020-09-29;1140
2020-09-28;"Košický kraj";19;0;0;0;NA;94074;19;2020-09-28;1065
2020-09-27;"Košický kraj";21;0;0;0;NA;94074;21;2020-09-27;1046
2020-09-26;"Košický kraj";53;0;0;0;NA;94074;53;2020-09-26;1025
2020-09-25;"Košický kraj";72;0;0;0;NA;94074;72;2020-09-25;972
2020-09-24;"Košický kraj";35;0;0;0;NA;94074;35;2020-09-24;900
2020-09-23;"Košický kraj";23;0;0;0;NA;94074;23;2020-09-23;865
2020-09-22;"Košický kraj";39;0;0;0;NA;94074;39;2020-09-22;842
2020-09-21;"Košický kraj";5;0;0;0;NA;94074;5;2020-09-21;803
2020-09-20;"Košický kraj";3;0;0;0;NA;94074;3;2020-09-20;798
2020-09-19;"Košický kraj";13;0;0;0;NA;94074;13;2020-09-19;795
2020-09-18;"Košický kraj";20;0;0;0;NA;94074;20;2020-09-18;782
2020-09-17;"Košický kraj";22;0;0;0;NA;94074;22;2020-09-17;762
2020-09-16;"Košický kraj";12;0;0;0;NA;94074;12;2020-09-16;740
2020-09-15;"Košický kraj";10;0;0;0;NA;94074;10;2020-09-15;728
2020-09-14;"Košický kraj";6;0;0;0;NA;94074;6;2020-09-14;718
2020-09-13;"Košický kraj";3;0;0;0;NA;94074;3;2020-09-13;712
2020-09-12;"Košický kraj";16;0;0;0;NA;94074;16;2020-09-12;709
2020-09-11;"Košický kraj";20;0;0;0;NA;94074;20;2020-09-11;693
2020-09-10;"Košický kraj";11;0;0;0;NA;94074;11;2020-09-10;673
2020-09-09;"Košický kraj";37;0;0;0;NA;94074;37;2020-09-09;662
2020-09-08;"Košický kraj";10;0;0;0;NA;94074;10;2020-09-08;625
2020-09-07;"Košický kraj";4;0;0;0;NA;94074;4;2020-09-07;615
2020-09-06;"Košický kraj";2;0;0;0;NA;94074;2;2020-09-06;611
2020-09-05;"Košický kraj";10;0;0;0;NA;94074;10;2020-09-05;609
2020-09-04;"Košický kraj";14;0;0;0;NA;94074;14;2020-09-04;599
2020-09-03;"Košický kraj";22;0;0;0;NA;94074;22;2020-09-03;585
2020-09-02;"Košický kraj";13;0;0;0;NA;94074;13;2020-09-02;563
2020-09-01;"Košický kraj";21;0;0;0;NA;94074;21;2020-09-01;550
2020-08-31;"Košický kraj";9;0;0;0;NA;94074;9;2020-08-31;529
2020-08-30;"Košický kraj";21;0;0;0;NA;94074;21;2020-08-30;520
2020-08-29;"Košický kraj";1;0;0;0;NA;94074;1;2020-08-29;499
2020-08-28;"Košický kraj";19;0;0;0;NA;94074;19;2020-08-28;498
2020-08-27;"Košický kraj";15;0;0;0;NA;94074;15;2020-08-27;479
2020-08-26;"Košický kraj";8;0;0;0;NA;94074;8;2020-08-26;464
2020-08-25;"Košický kraj";23;0;0;0;NA;94074;23;2020-08-25;456
2020-08-24;"Košický kraj";6;0;0;0;NA;94074;6;2020-08-24;433
2020-08-23;"Košický kraj";8;0;0;0;NA;94074;8;2020-08-23;427
2020-08-22;"Košický kraj";13;0;0;0;NA;94074;13;2020-08-22;419
2020-08-21;"Košický kraj";10;0;0;0;NA;94074;10;2020-08-21;406
2020-08-20;"Košický kraj";10;0;0;0;NA;94074;10;2020-08-20;396
2020-08-19;"Košický kraj";3;0;0;0;NA;94074;3;2020-08-19;386
2020-08-18;"Košický kraj";7;0;0;0;NA;94074;7;2020-08-18;383
2020-08-17;"Košický kraj";2;0;0;0;NA;94074;2;2020-08-17;376
2020-08-16;"Košický kraj";2;0;0;0;NA;94074;2;2020-08-16;374
2020-08-15;"Košický kraj";3;0;0;0;NA;94074;3;2020-08-15;372
2020-08-14;"Košický kraj";1;0;0;0;NA;94074;1;2020-08-14;369
2020-08-13;"Košický kraj";3;0;0;0;NA;94074;3;2020-08-13;368
2020-08-12;"Košický kraj";12;0;0;0;NA;94074;12;2020-08-12;365
2020-08-11;"Košický kraj";5;0;0;0;NA;94074;5;2020-08-11;353
2020-08-10;"Košický kraj";1;0;0;0;NA;94074;1;2020-08-10;348
2020-08-09;"Košický kraj";0;0;0;0;NA;94074;0;2020-08-09;347
2020-08-08;"Košický kraj";5;0;0;0;NA;94074;5;2020-08-08;347
2020-08-07;"Košický kraj";7;0;0;0;NA;94074;7;2020-08-07;342
2020-08-06;"Košický kraj";3;0;0;0;NA;94074;3;2020-08-06;335
2020-08-05;"Košický kraj";4;0;0;0;NA;94074;4;2020-08-05;332
2020-08-04;"Košický kraj";1;0;0;0;NA;94074;1;2020-08-04;328
2020-08-03;"Košický kraj";1;0;0;0;NA;94074;1;2020-08-03;327
2020-08-02;"Košický kraj";0;0;0;0;NA;94074;0;2020-08-02;326
2020-08-01;"Košický kraj";0;0;0;0;NA;94074;0;2020-08-01;326
2020-07-31;"Košický kraj";0;0;0;0;NA;94074;0;2020-07-31;326
2020-07-30;"Košický kraj";2;0;0;0;NA;94074;2;2020-07-30;326
2020-07-29;"Košický kraj";1;0;0;0;NA;94074;1;2020-07-29;324
2020-07-28;"Košický kraj";9;0;0;0;NA;94074;9;2020-07-28;323
2020-07-27;"Košický kraj";4;0;0;0;NA;94074;4;2020-07-27;314
2020-07-26;"Košický kraj";0;0;0;0;NA;94074;0;2020-07-26;310
2020-07-25;"Košický kraj";2;0;0;0;NA;94074;2;2020-07-25;310
2020-07-24;"Košický kraj";2;0;0;0;NA;94074;2;2020-07-24;308
2020-07-23;"Košický kraj";1;0;0;0;NA;94074;1;2020-07-23;306
2020-07-22;"Košický kraj";1;0;0;0;NA;94074;1;2020-07-22;305
2020-07-21;"Košický kraj";0;0;0;0;NA;94074;0;2020-07-21;304
2020-07-20;"Košický kraj";0;0;0;0;NA;94074;0;2020-07-20;304
2020-07-19;"Košický kraj";0;0;0;0;NA;94074;0;2020-07-19;304
2020-07-18;"Košický kraj";1;0;0;0;NA;94074;1;2020-07-18;304
2020-07-17;"Košický kraj";1;0;0;0;NA;94074;1;2020-07-17;303
2020-07-16;"Košický kraj";0;0;0;0;NA;94074;0;2020-07-16;302
2020-07-15;"Košický kraj";2;0;0;0;NA;94074;2;2020-07-15;302
2020-07-14;"Košický kraj";1;0;0;0;NA;94074;1;2020-07-14;300
2020-07-13;"Košický kraj";1;0;0;0;NA;94074;1;2020-07-13;299
2020-07-12;"Košický kraj";0;0;0;0;NA;94074;0;2020-07-12;298
2020-07-11;"Košický kraj";0;0;0;0;NA;94074;0;2020-07-11;298
2020-07-10;"Košický kraj";1;0;0;0;NA;94074;1;2020-07-10;298
2020-07-09;"Košický kraj";1;0;0;0;NA;94074;1;2020-07-09;297
2020-07-08;"Košický kraj";12;0;0;0;NA;94074;12;2020-07-08;296
2020-07-07;"Košický kraj";0;0;0;0;NA;94074;0;2020-07-07;284
2020-07-06;"Košický kraj";0;0;0;0;NA;94074;0;2020-07-06;284
2020-07-05;"Košický kraj";0;0;0;0;NA;94074;0;2020-07-05;284
2020-07-04;"Košický kraj";0;0;0;0;NA;94074;0;2020-07-04;284
2020-07-03;"Košický kraj";1;0;0;0;NA;94074;1;2020-07-03;284
2020-07-02;"Košický kraj";0;0;0;0;NA;94074;0;2020-07-02;283
2020-07-01;"Košický kraj";1;0;0;0;NA;94074;1;2020-07-01;283
2020-06-30;"Košický kraj";0;0;0;0;NA;94074;0;2020-06-30;282
2020-06-29;"Košický kraj";0;0;0;0;NA;94074;0;2020-06-29;282
2020-06-28;"Košický kraj";0;0;0;0;NA;94074;0;2020-06-28;282
2020-06-27;"Košický kraj";0;0;0;0;NA;94074;0;2020-06-27;282
2020-06-26;"Košický kraj";0;0;0;0;NA;94074;0;2020-06-26;282
2020-06-25;"Košický kraj";3;0;0;0;NA;94074;3;2020-06-25;282
2020-06-24;"Košický kraj";3;0;0;0;NA;94074;3;2020-06-24;279
2020-06-23;"Košický kraj";3;0;0;0;NA;94074;3;2020-06-23;276
2020-06-22;"Košický kraj";0;0;0;0;NA;94074;0;2020-06-22;273
2020-06-21;"Košický kraj";0;0;0;0;NA;94074;0;2020-06-21;273
2020-06-20;"Košický kraj";0;0;0;0;NA;94074;0;2020-06-20;273
2020-06-19;"Košický kraj";0;0;0;0;NA;94074;0;2020-06-19;273
2020-06-18;"Košický kraj";1;0;0;0;NA;94074;1;2020-06-18;273
2020-06-17;"Košický kraj";0;0;0;0;NA;94074;0;2020-06-17;272
2020-06-16;"Košický kraj";2;0;0;0;NA;94074;2;2020-06-16;272
2020-06-14;"Košický kraj";0;0;0;0;NA;94074;0;2020-06-14;270
2020-06-13;"Košický kraj";0;0;0;0;NA;94074;0;2020-06-13;270
2020-06-12;"Košický kraj";0;0;0;0;NA;94074;0;2020-06-12;270
2020-06-11;"Košický kraj";0;0;0;0;NA;94074;0;2020-06-11;270
2020-06-10;"Košický kraj";6;0;0;0;NA;94074;6;2020-06-10;270
2020-06-09;"Košický kraj";0;0;0;0;NA;94074;0;2020-06-09;264
2020-06-08;"Košický kraj";0;0;0;0;NA;94074;0;2020-06-08;264
2020-06-07;"Košický kraj";2;0;0;0;NA;94074;2;2020-06-07;264
2020-06-05;"Košický kraj";0;0;0;0;NA;94074;0;2020-06-05;262
2020-06-03;"Košický kraj";0;0;0;0;NA;94074;0;2020-06-03;262
2020-06-02;"Košický kraj";1;0;0;0;NA;94074;1;2020-06-02;262
2020-05-31;"Košický kraj";0;0;0;0;NA;94074;0;2020-05-31;261
2020-05-29;"Košický kraj";1;0;0;0;NA;94074;1;2020-05-29;261
2020-05-27;"Košický kraj";0;0;0;0;NA;94074;0;2020-05-27;260
2020-05-26;"Košický kraj";1;0;0;0;NA;94074;1;2020-05-26;260
2020-05-25;"Košický kraj";1;0;0;0;NA;94074;1;2020-05-25;259
2020-05-24;"Košický kraj";0;0;0;0;NA;94074;0;2020-05-24;258
2020-05-23;"Košický kraj";0;0;0;0;NA;94074;0;2020-05-23;258
2020-05-22;"Košický kraj";0;0;0;0;NA;94074;0;2020-05-22;258
2020-05-21;"Košický kraj";0;0;0;0;NA;94074;0;2020-05-21;258
2020-05-20;"Košický kraj";3;0;0;0;NA;94074;3;2020-05-20;258
2020-05-19;"Košický kraj";0;0;0;0;NA;94074;0;2020-05-19;255
2020-05-17;"Košický kraj";1;0;0;0;NA;94074;1;2020-05-17;255
2020-05-16;"Košický kraj";1;0;0;0;NA;94074;1;2020-05-16;254
2020-05-15;"Košický kraj";10;0;0;0;NA;94074;10;2020-05-15;253
2020-05-14;"Košický kraj";1;0;0;0;NA;94074;1;2020-05-14;243
2020-05-13;"Košický kraj";6;0;0;0;NA;94074;6;2020-05-13;242
2020-05-12;"Košický kraj";0;0;0;0;NA;94074;0;2020-05-12;236
2020-05-11;"Košický kraj";0;0;0;0;NA;94074;0;2020-05-11;236
2020-05-09;"Košický kraj";0;0;0;0;NA;94074;0;2020-05-09;236
2020-05-07;"Košický kraj";0;0;0;0;NA;94074;0;2020-05-07;236
2020-05-06;"Košický kraj";1;0;0;0;NA;94074;1;2020-05-06;236
2020-05-05;"Košický kraj";0;0;0;0;NA;94074;0;2020-05-05;235
2020-05-04;"Košický kraj";0;0;0;0;NA;94074;0;2020-05-04;235
2020-05-03;"Košický kraj";0;0;0;0;NA;94074;0;2020-05-03;235
2020-05-02;"Košický kraj";1;0;0;0;NA;94074;1;2020-05-02;235
2020-05-01;"Košický kraj";0;0;0;0;NA;94074;0;2020-05-01;234
2020-04-30;"Košický kraj";1;0;0;0;NA;94074;1;2020-04-30;234
2020-04-29;"Košický kraj";1;0;0;0;NA;94074;1;2020-04-29;233
2020-04-28;"Košický kraj";1;0;0;0;NA;94074;1;2020-04-28;232
2020-04-27;"Košický kraj";1;0;0;0;NA;94074;1;2020-04-27;231
2020-04-26;"Košický kraj";0;0;0;0;NA;94074;0;2020-04-26;230
2020-04-25;"Košický kraj";0;0;0;0;NA;94074;0;2020-04-25;230
2020-04-24;"Košický kraj";3;0;0;0;NA;94074;3;2020-04-24;230
2020-04-23;"Košický kraj";4;0;0;0;NA;94074;4;2020-04-23;227
2020-04-22;"Košický kraj";21;0;0;0;NA;94074;21;2020-04-22;223
2020-04-21;"Košický kraj";4;0;0;0;NA;94074;4;2020-04-21;202
2020-04-20;"Košický kraj";0;0;0;0;NA;94074;0;2020-04-20;198
2020-04-19;"Košický kraj";1;0;0;0;NA;94074;1;2020-04-19;198
2020-04-18;"Košický kraj";2;0;0;0;NA;94074;2;2020-04-18;197
2020-04-17;"Košický kraj";7;0;0;0;NA;94074;7;2020-04-17;195
2020-04-16;"Košický kraj";29;0;0;0;NA;94074;29;2020-04-16;188
2020-04-15;"Košický kraj";50;0;0;0;NA;94074;50;2020-04-15;159
2020-04-14;"Košický kraj";4;0;0;0;NA;94074;4;2020-04-14;109
2020-04-13;"Košický kraj";5;0;0;0;NA;94074;5;2020-04-13;105
2020-04-12;"Košický kraj";4;0;0;0;NA;94074;4;2020-04-12;100
2020-04-11;"Košický kraj";2;0;0;0;NA;94074;2;2020-04-11;96
2020-04-10;"Košický kraj";1;0;0;0;NA;94074;1;2020-04-10;94
2020-04-09;"Košický kraj";4;0;0;0;NA;94074;4;2020-04-09;93
2020-04-08;"Košický kraj";5;0;0;0;NA;94074;5;2020-04-08;89
2020-04-07;"Košický kraj";34;0;0;0;NA;94074;34;2020-04-07;84
2020-04-06;"Košický kraj";6;0;0;0;NA;94074;6;2020-04-06;50
2020-04-05;"Košický kraj";4;0;0;0;NA;94074;4;2020-04-05;44
2020-04-04;"Košický kraj";5;0;0;0;NA;94074;5;2020-04-04;40
2020-04-03;"Košický kraj";4;0;0;0;NA;94074;4;2020-04-03;35
2020-04-02;"Košický kraj";3;0;0;0;NA;94074;3;2020-04-02;31
2020-04-01;"Košický kraj";3;0;0;0;NA;94074;3;2020-04-01;28
2020-03-31;"Košický kraj";1;0;0;0;NA;94074;1;2020-03-31;25
2020-03-30;"Košický kraj";5;0;0;0;NA;94074;5;2020-03-30;24
2020-03-29;"Košický kraj";0;0;0;0;NA;94074;0;2020-03-29;19
2020-03-28;"Košický kraj";1;0;0;0;NA;94074;1;2020-03-28;19
2020-03-27;"Košický kraj";1;0;0;0;NA;94074;1;2020-03-27;18
2020-03-26;"Košický kraj";3;0;0;0;NA;94074;3;2020-03-26;17
2020-03-25;"Košický kraj";2;0;0;0;NA;94074;2;2020-03-25;14
2020-03-24;"Košický kraj";0;0;0;0;NA;94074;0;2020-03-24;12
2020-03-23;"Košický kraj";2;0;0;0;NA;94074;2;2020-03-23;12
2020-03-22;"Košický kraj";0;0;0;0;NA;94074;0;2020-03-22;10
2020-03-21;"Košický kraj";3;0;0;0;NA;94074;3;2020-03-21;10
2020-03-20;"Košický kraj";1;0;0;0;NA;94074;1;2020-03-20;7
2020-03-19;"Košický kraj";0;0;0;0;NA;94074;0;2020-03-19;6
2020-03-18;"Košický kraj";0;0;0;0;NA;94074;0;2020-03-18;6
2020-03-17;"Košický kraj";0;0;0;0;NA;94074;0;2020-03-17;6
2020-03-16;"Košický kraj";3;0;0;0;NA;94074;3;2020-03-16;6
2020-03-15;"Košický kraj";1;0;0;0;NA;94074;1;2020-03-15;3
2020-03-14;"Košický kraj";0;0;0;0;NA;94074;0;2020-03-14;2
2020-03-13;"Košický kraj";2;0;0;0;NA;94074;2;2020-03-13;2
2020-03-12;"Košický kraj";0;0;0;0;NA;94074;0;2020-03-12;0
2020-03-11;"Košický kraj";0;0;0;0;NA;94074;0;2020-03-11;0
2020-03-09;"Košický kraj";1;0;0;0;NA;94074;1;2020-03-09;0
2020-03-08;"Košický kraj";0;0;0;0;NA;94074;0;2020-03-08;-1
2020-03-07;"Košický kraj";0;0;0;0;NA;94074;0;2020-03-07;-1
2020-03-06;"Košický kraj";0;0;0;0;NA;94074;0;2020-03-06;-1
2021-05-30;"Nitriansky kraj";1;9067;8;9075;39152;90816;9;2021-05-30;90816
2021-05-29;"Nitriansky kraj";2;12642;7;12649;NA;90816;9;2021-05-29;90807
2021-05-28;"Nitriansky kraj";10;8264;6;8270;NA;90816;16;2021-05-28;90798
2021-05-27;"Nitriansky kraj";4;5945;7;5952;NA;90816;11;2021-05-27;90782
2021-05-26;"Nitriansky kraj";11;8067;6;8073;NA;90816;17;2021-05-26;90771
2021-05-25;"Nitriansky kraj";15;7437;9;7446;NA;90816;24;2021-05-25;90754
2021-05-24;"Nitriansky kraj";14;9390;16;9406;NA;90816;30;2021-05-24;90730
2021-05-23;"Nitriansky kraj";1;9516;13;9529;NA;90816;14;2021-05-23;90700
2021-05-22;"Nitriansky kraj";7;16523;10;16533;NA;90816;17;2021-05-22;90686
2021-05-21;"Nitriansky kraj";18;10214;15;10229;NA;90816;33;2021-05-21;90669
2021-05-20;"Nitriansky kraj";8;7059;7;7066;NA;90816;15;2021-05-20;90636
2021-05-19;"Nitriansky kraj";20;6640;14;6654;NA;90816;34;2021-05-19;90621
2021-05-18;"Nitriansky kraj";23;7577;18;7595;NA;90816;41;2021-05-18;90587
2021-05-17;"Nitriansky kraj";22;9575;20;9595;NA;90816;42;2021-05-17;90546
2021-05-16;"Nitriansky kraj";4;13830;15;13845;NA;90816;19;2021-05-16;90504
2021-05-15;"Nitriansky kraj";5;25389;23;25412;NA;90816;28;2021-05-15;90485
2021-05-14;"Nitriansky kraj";18;13268;23;13291;NA;90816;41;2021-05-14;90457
2021-05-13;"Nitriansky kraj";24;7893;19;7912;NA;90816;43;2021-05-13;90416
2021-05-12;"Nitriansky kraj";10;7466;26;7492;NA;90816;36;2021-05-12;90373
2021-05-11;"Nitriansky kraj";36;8008;13;8021;NA;90816;49;2021-05-11;90337
2021-05-10;"Nitriansky kraj";16;13590;33;13623;NA;90816;49;2021-05-10;90288
2021-05-09;"Nitriansky kraj";8;21879;35;21914;NA;90816;43;2021-05-09;90239
2021-05-08;"Nitriansky kraj";0;24510;29;24539;NA;90816;29;2021-05-08;90196
2021-05-07;"Nitriansky kraj";32;14890;20;14910;NA;90816;52;2021-05-07;90167
2021-05-06;"Nitriansky kraj";30;9275;20;9295;NA;90816;50;2021-05-06;90115
2021-05-05;"Nitriansky kraj";19;8518;23;8541;NA;90816;42;2021-05-05;90065
2021-05-04;"Nitriansky kraj";46;8954;27;8981;NA;90816;73;2021-05-04;90023
2021-05-03;"Nitriansky kraj";32;14755;44;14799;NA;90816;76;2021-05-03;89950
2021-05-02;"Nitriansky kraj";4;31751;46;31797;NA;90816;50;2021-05-02;89874
2021-05-01;"Nitriansky kraj";23;60318;43;60361;NA;90816;66;2021-05-01;89824
2021-04-30;"Nitriansky kraj";28;0;0;0;NA;90816;28;2021-04-30;89758
2021-04-29;"Nitriansky kraj";27;0;0;0;NA;90816;27;2021-04-29;89730
2021-04-28;"Nitriansky kraj";36;0;0;0;NA;90816;36;2021-04-28;89703
2021-04-27;"Nitriansky kraj";51;0;0;0;NA;90816;51;2021-04-27;89667
2021-04-26;"Nitriansky kraj";38;0;0;0;NA;90816;38;2021-04-26;89616
2021-04-25;"Nitriansky kraj";7;0;0;0;NA;90816;7;2021-04-25;89578
2021-04-24;"Nitriansky kraj";23;0;0;0;NA;90816;23;2021-04-24;89571
2021-04-23;"Nitriansky kraj";54;0;0;0;NA;90816;54;2021-04-23;89548
2021-04-22;"Nitriansky kraj";32;0;0;0;NA;90816;32;2021-04-22;89494
2021-04-21;"Nitriansky kraj";38;0;0;0;NA;90816;38;2021-04-21;89462
2021-04-20;"Nitriansky kraj";67;0;0;0;NA;90816;67;2021-04-20;89424
2021-04-19;"Nitriansky kraj";35;0;0;0;NA;90816;35;2021-04-19;89357
2021-04-18;"Nitriansky kraj";0;0;0;0;NA;90816;0;2021-04-18;89322
2021-04-17;"Nitriansky kraj";34;0;0;0;NA;90816;34;2021-04-17;89322
2021-04-16;"Nitriansky kraj";46;0;0;0;NA;90816;46;2021-04-16;89288
2021-04-15;"Nitriansky kraj";75;0;0;0;NA;90816;75;2021-04-15;89242
2021-04-14;"Nitriansky kraj";43;0;0;0;NA;90816;43;2021-04-14;89167
2021-04-13;"Nitriansky kraj";110;0;0;0;NA;90816;110;2021-04-13;89124
2021-04-12;"Nitriansky kraj";29;0;0;0;NA;90816;29;2021-04-12;89014
2021-04-11;"Nitriansky kraj";1;0;0;0;NA;90816;1;2021-04-11;88985
2021-04-10;"Nitriansky kraj";35;0;0;0;NA;90816;35;2021-04-10;88984
2021-04-09;"Nitriansky kraj";69;0;0;0;NA;90816;69;2021-04-09;88949
2021-04-08;"Nitriansky kraj";71;0;0;0;NA;90816;71;2021-04-08;88880
2021-04-07;"Nitriansky kraj";64;0;0;0;NA;90816;64;2021-04-07;88809
2021-04-06;"Nitriansky kraj";65;0;0;0;NA;90816;65;2021-04-06;88745
2021-04-05;"Nitriansky kraj";37;0;0;0;NA;90816;37;2021-04-05;88680
2021-04-04;"Nitriansky kraj";5;0;0;0;NA;90816;5;2021-04-04;88643
2021-04-03;"Nitriansky kraj";26;0;0;0;NA;90816;26;2021-04-03;88638
2021-04-02;"Nitriansky kraj";32;0;0;0;NA;90816;32;2021-04-02;88612
2021-04-01;"Nitriansky kraj";63;0;0;0;NA;90816;63;2021-04-01;88580
2021-03-31;"Nitriansky kraj";73;21752;94;21846;NA;90816;167;2021-03-31;88517
2021-03-30;"Nitriansky kraj";125;17044;83;17127;NA;90816;208;2021-03-30;88350
2021-03-29;"Nitriansky kraj";81;25139;100;25239;NA;90816;181;2021-03-29;88142
2021-03-28;"Nitriansky kraj";6;45581;106;45687;NA;90816;112;2021-03-28;87961
2021-03-27;"Nitriansky kraj";39;103659;174;103833;NA;90816;213;2021-03-27;87849
2021-03-26;"Nitriansky kraj";90;40444;115;40559;NA;90816;205;2021-03-26;87636
2021-03-25;"Nitriansky kraj";95;19149;94;19243;NA;90816;189;2021-03-25;87431
2021-03-24;"Nitriansky kraj";90;14784;91;14875;NA;90816;181;2021-03-24;87242
2021-03-23;"Nitriansky kraj";167;16753;66;16819;NA;90816;233;2021-03-23;87061
2021-03-22;"Nitriansky kraj";101;23699;124;23823;NA;90816;225;2021-03-22;86828
2021-03-21;"Nitriansky kraj";27;42318;99;42417;NA;90816;126;2021-03-21;86603
2021-03-20;"Nitriansky kraj";36;99816;207;100023;NA;90816;243;2021-03-20;86477
2021-03-19;"Nitriansky kraj";76;37115;101;37216;NA;90816;177;2021-03-19;86234
2021-03-18;"Nitriansky kraj";103;20051;113;20164;NA;90816;216;2021-03-18;86057
2021-03-17;"Nitriansky kraj";87;15832;127;15959;NA;90816;214;2021-03-17;85841
2021-03-16;"Nitriansky kraj";172;18085;121;18206;NA;90816;293;2021-03-16;85627
2021-03-15;"Nitriansky kraj";130;24491;165;24656;NA;90816;295;2021-03-15;85334
2021-03-14;"Nitriansky kraj";3;45758;107;45865;NA;90816;110;2021-03-14;85039
2021-03-13;"Nitriansky kraj";65;112081;241;112322;NA;90816;306;2021-03-13;84929
2021-03-12;"Nitriansky kraj";127;40776;159;40935;NA;90816;286;2021-03-12;84623
2021-03-11;"Nitriansky kraj";131;18685;130;18815;NA;90816;261;2021-03-11;84337
2021-03-10;"Nitriansky kraj";96;17422;143;17565;NA;90816;239;2021-03-10;84076
2021-03-09;"Nitriansky kraj";260;17645;149;17794;NA;90816;409;2021-03-09;83837
2021-03-08;"Nitriansky kraj";145;27214;172;27386;NA;90816;317;2021-03-08;83428
2021-03-07;"Nitriansky kraj";48;46867;185;47052;NA;90816;233;2021-03-07;83111
2021-03-06;"Nitriansky kraj";86;110858;326;111184;NA;90816;412;2021-03-06;82878
2021-03-05;"Nitriansky kraj";133;39068;200;39268;NA;90816;333;2021-03-05;82466
2021-03-04;"Nitriansky kraj";176;18206;173;18379;NA;90816;349;2021-03-04;82133
2021-03-03;"Nitriansky kraj";172;17210;177;17387;NA;90816;349;2021-03-03;81784
2021-03-02;"Nitriansky kraj";274;20999;366;21365;NA;90816;640;2021-03-02;81435
2021-03-01;"Nitriansky kraj";133;27881;279;28160;NA;90816;412;2021-03-01;80795
2021-02-28;"Nitriansky kraj";80;40866;218;41084;NA;90816;298;2021-02-28;80383
2021-02-27;"Nitriansky kraj";101;106352;496;106848;NA;90816;597;2021-02-27;80085
2021-02-26;"Nitriansky kraj";109;36722;306;37028;NA;90816;415;2021-02-26;79488
2021-02-25;"Nitriansky kraj";188;15235;212;15447;NA;90816;400;2021-02-25;79073
2021-02-24;"Nitriansky kraj";125;13833;260;14093;NA;90816;385;2021-02-24;78673
2021-02-23;"Nitriansky kraj";273;15402;273;15675;NA;90816;546;2021-02-23;78288
2021-02-22;"Nitriansky kraj";154;26466;330;26796;NA;90816;484;2021-02-22;77742
2021-02-21;"Nitriansky kraj";22;43657;320;43977;NA;90816;342;2021-02-21;77258
2021-02-20;"Nitriansky kraj";128;108304;584;108888;NA;90816;712;2021-02-20;76916
2021-02-19;"Nitriansky kraj";173;36849;328;37177;NA;90816;501;2021-02-19;76204
2021-02-18;"Nitriansky kraj";202;17051;275;17326;NA;90816;477;2021-02-18;75703
2021-02-17;"Nitriansky kraj";198;12080;310;12390;NA;90816;508;2021-02-17;75226
2021-02-16;"Nitriansky kraj";284;14477;282;14759;NA;90816;566;2021-02-16;74718
2021-02-15;"Nitriansky kraj";122;27620;471;28091;NA;90816;593;2021-02-15;74152
2021-02-14;"Nitriansky kraj";8;50408;318;50726;NA;90816;326;2021-02-14;73559
2021-02-13;"Nitriansky kraj";127;110035;689;110724;NA;90816;816;2021-02-13;73233
2021-02-12;"Nitriansky kraj";162;33400;407;33807;NA;90816;569;2021-02-12;72417
2021-02-11;"Nitriansky kraj";195;12406;270;12676;NA;90816;465;2021-02-11;71848
2021-02-10;"Nitriansky kraj";186;17632;644;18276;NA;90816;830;2021-02-10;71383
2021-02-09;"Nitriansky kraj";260;18523;385;18908;NA;90816;645;2021-02-09;70553
2021-02-08;"Nitriansky kraj";177;37534;569;38103;NA;90816;746;2021-02-08;69908
2021-02-07;"Nitriansky kraj";20;52307;513;52820;NA;90816;533;2021-02-07;69162
2021-02-06;"Nitriansky kraj";129;101942;765;102707;NA;90816;894;2021-02-06;68629
2021-02-05;"Nitriansky kraj";244;26144;491;26635;NA;90816;735;2021-02-05;67735
2021-02-04;"Nitriansky kraj";308;15681;512;16193;NA;90816;820;2021-02-04;67000
2021-02-03;"Nitriansky kraj";191;13468;382;13850;NA;90816;573;2021-02-03;66180
2021-02-02;"Nitriansky kraj";327;17878;382;18260;NA;90816;709;2021-02-02;65607
2021-02-01;"Nitriansky kraj";221;24049;460;24509;NA;90816;681;2021-02-01;64898
2021-01-31;"Nitriansky kraj";9;45339;496;45835;NA;90816;505;2021-01-31;64217
2021-01-30;"Nitriansky kraj";152;98142;1077;99219;NA;90816;1229;2021-01-30;63712
2021-01-29;"Nitriansky kraj";302;22461;477;22938;NA;90816;779;2021-01-29;62483
2021-01-28;"Nitriansky kraj";269;11370;398;11768;NA;90816;667;2021-01-28;61704
2021-01-27;"Nitriansky kraj";235;6760;299;7059;NA;90816;534;2021-01-27;61037
2021-01-26;"Nitriansky kraj";345;16045;454;16499;NA;90816;799;2021-01-26;60503
2021-01-25;"Nitriansky kraj";201;21729;429;22158;NA;90816;630;2021-01-25;59704
2021-01-24;"Nitriansky kraj";12;78775;889;79664;NA;90816;901;2021-01-24;59074
2021-01-23;"Nitriansky kraj";277;97395;1434;98829;NA;90816;1711;2021-01-23;58173
2021-01-22;"Nitriansky kraj";139;35826;619;36445;NA;90816;758;2021-01-22;56462
2021-01-21;"Nitriansky kraj";305;14649;412;15061;NA;90816;717;2021-01-21;55704
2021-01-20;"Nitriansky kraj";326;11991;625;12616;NA;90816;951;2021-01-20;54987
2021-01-19;"Nitriansky kraj";344;11022;633;11655;NA;90816;977;2021-01-19;54036
2021-01-18;"Nitriansky kraj";367;8902;520;9422;NA;90816;887;2021-01-18;53059
2021-01-17;"Nitriansky kraj";97;15061;275;15336;NA;90816;372;2021-01-17;52172
2021-01-16;"Nitriansky kraj";64;36838;679;37517;NA;90816;743;2021-01-16;51800
2021-01-15;"Nitriansky kraj";373;15940;474;16414;NA;90816;847;2021-01-15;51057
2021-01-14;"Nitriansky kraj";627;10577;452;11029;NA;90816;1079;2021-01-14;50210
2021-01-13;"Nitriansky kraj";663;9234;484;9718;NA;90816;1147;2021-01-13;49131
2021-01-12;"Nitriansky kraj";642;9014;557;9571;NA;90816;1199;2021-01-12;47984
2021-01-11;"Nitriansky kraj";422;8625;556;9181;NA;90816;978;2021-01-11;46785
2021-01-10;"Nitriansky kraj";44;19841;730;20571;NA;90816;774;2021-01-10;45807
2021-01-09;"Nitriansky kraj";532;36823;1071;37894;NA;90816;1603;2021-01-09;45033
2021-01-08;"Nitriansky kraj";817;14297;711;15008;NA;90816;1528;2021-01-08;43430
2021-01-07;"Nitriansky kraj";438;11046;858;11904;NA;90816;1296;2021-01-07;41902
2021-01-06;"Nitriansky kraj";259;3192;197;3389;NA;90816;456;2021-01-06;40606
2021-01-05;"Nitriansky kraj";732;8901;1202;10103;NA;90816;1934;2021-01-05;40150
2021-01-04;"Nitriansky kraj";362;8692;1329;10021;NA;90816;1691;2021-01-04;38216
2021-01-03;"Nitriansky kraj";42;84;20;104;NA;90816;62;2021-01-03;36525
2021-01-02;"Nitriansky kraj";249;1090;26;1116;NA;90816;275;2021-01-02;36463
2021-01-01;"Nitriansky kraj";119;781;95;876;NA;90816;214;2021-01-01;36188
2020-12-31;"Nitriansky kraj";786;7646;962;8608;NA;90816;1748;2020-12-31;35974
2020-12-30;"Nitriansky kraj";1094;9619;1165;10784;NA;90816;2259;2020-12-30;34226
2020-12-29;"Nitriansky kraj";607;8277;1286;9563;NA;90816;1893;2020-12-29;31967
2020-12-28;"Nitriansky kraj";83;6981;1271;8252;NA;90816;1354;2020-12-28;30074
2020-12-27;"Nitriansky kraj";22;60;8;68;NA;90816;30;2020-12-27;28720
2020-12-26;"Nitriansky kraj";54;297;56;353;NA;90816;110;2020-12-26;28690
2020-12-25;"Nitriansky kraj";35;60;11;71;NA;90816;46;2020-12-25;28580
2020-12-24;"Nitriansky kraj";514;1861;176;2037;NA;90816;690;2020-12-24;28534
2020-12-23;"Nitriansky kraj";349;15295;843;16138;NA;90816;1192;2020-12-23;27844
2020-12-22;"Nitriansky kraj";673;10989;994;11983;NA;90816;1667;2020-12-22;26652
2020-12-21;"Nitriansky kraj";128;7953;976;8929;NA;90816;1104;2020-12-21;24985
2020-12-20;"Nitriansky kraj";77;50;10;60;NA;90816;87;2020-12-20;23881
2020-12-19;"Nitriansky kraj";262;2259;159;2418;NA;90816;421;2020-12-19;23794
2020-12-18;"Nitriansky kraj";512;8437;551;8988;NA;90816;1063;2020-12-18;23373
2020-12-17;"Nitriansky kraj";586;6894;514;7408;NA;90816;1100;2020-12-17;22310
2020-12-16;"Nitriansky kraj";357;8785;546;9331;NA;90816;903;2020-12-16;21210
2020-12-15;"Nitriansky kraj";461;9365;769;10134;NA;90816;1230;2020-12-15;20307
2020-12-14;"Nitriansky kraj";217;8089;827;8916;NA;90816;1044;2020-12-14;19077
2020-12-13;"Nitriansky kraj";12;69;6;75;NA;90816;18;2020-12-13;18033
2020-12-12;"Nitriansky kraj";341;1832;125;1957;NA;90816;466;2020-12-12;18015
2020-12-11;"Nitriansky kraj";409;5431;416;5847;NA;90816;825;2020-12-11;17549
2020-12-10;"Nitriansky kraj";360;5473;351;5824;NA;90816;711;2020-12-10;16724
2020-12-09;"Nitriansky kraj";362;5506;529;6035;NA;90816;891;2020-12-09;16013
2020-12-08;"Nitriansky kraj";340;8168;548;8716;NA;90816;888;2020-12-08;15122
2020-12-07;"Nitriansky kraj";139;6243;573;6816;NA;90816;712;2020-12-07;14234
2020-12-06;"Nitriansky kraj";15;89;4;93;NA;90816;19;2020-12-06;13522
2020-12-05;"Nitriansky kraj";136;1388;19;1407;NA;90816;155;2020-12-05;13503
2020-12-04;"Nitriansky kraj";232;2884;74;2958;NA;90816;306;2020-12-04;13348
2020-12-03;"Nitriansky kraj";248;2471;110;2581;NA;90816;358;2020-12-03;13042
2020-12-02;"Nitriansky kraj";252;3733;163;3896;NA;90816;415;2020-12-02;12684
2020-12-01;"Nitriansky kraj";331;2891;131;3022;NA;90816;462;2020-12-01;12269
2020-11-30;"Nitriansky kraj";91;4228;188;4416;NA;90816;279;2020-11-30;11807
2020-11-29;"Nitriansky kraj";3;634;42;676;NA;90816;45;2020-11-29;11528
2020-11-28;"Nitriansky kraj";135;892;31;923;NA;90816;166;2020-11-28;11483
2020-11-27;"Nitriansky kraj";177;2069;73;2142;NA;90816;250;2020-11-27;11317
2020-11-26;"Nitriansky kraj";191;2813;80;2893;NA;90816;271;2020-11-26;11067
2020-11-25;"Nitriansky kraj";325;2478;91;2569;NA;90816;416;2020-11-25;10796
2020-11-24;"Nitriansky kraj";147;1641;64;1705;NA;90816;211;2020-11-24;10380
2020-11-23;"Nitriansky kraj";102;9891;212;10103;NA;90816;314;2020-11-23;10169
2020-11-22;"Nitriansky kraj";7;1176;25;1201;NA;90816;32;2020-11-22;9855
2020-11-21;"Nitriansky kraj";86;1083;38;1121;NA;90816;124;2020-11-21;9823
2020-11-20;"Nitriansky kraj";264;4180;103;4283;NA;90816;367;2020-11-20;9699
2020-11-19;"Nitriansky kraj";185;3065;134;3199;NA;90816;319;2020-11-19;9332
2020-11-18;"Nitriansky kraj";188;2214;79;2293;NA;90816;267;2020-11-18;9013
2020-11-17;"Nitriansky kraj";178;596;29;625;NA;90816;207;2020-11-17;8746
2020-11-16;"Nitriansky kraj";139;1877;75;1952;NA;90816;214;2020-11-16;8539
2020-11-15;"Nitriansky kraj";14;180;5;185;NA;90816;19;2020-11-15;8325
2020-11-14;"Nitriansky kraj";114;1131;32;1163;NA;90816;146;2020-11-14;8306
2020-11-13;"Nitriansky kraj";210;936;46;982;NA;90816;256;2020-11-13;8160
2020-11-12;"Nitriansky kraj";256;1195;35;1230;NA;90816;291;2020-11-12;7904
2020-11-11;"Nitriansky kraj";279;1247;22;1269;NA;90816;301;2020-11-11;7613
2020-11-10;"Nitriansky kraj";192;2623;39;2662;NA;90816;231;2020-11-10;7312
2020-11-09;"Nitriansky kraj";128;3136;43;3179;NA;90816;171;2020-11-09;7081
2020-11-08;"Nitriansky kraj";43;1462;32;1494;NA;90816;75;2020-11-08;6910
2020-11-07;"Nitriansky kraj";130;1046;4;1050;NA;90816;134;2020-11-07;6835
2020-11-06;"Nitriansky kraj";210;2264;32;2296;NA;90816;242;2020-11-06;6701
2020-11-05;"Nitriansky kraj";178;313;14;327;NA;90816;192;2020-11-05;6459
2020-11-04;"Nitriansky kraj";211;297;16;313;NA;90816;227;2020-11-04;6267
2020-11-03;"Nitriansky kraj";216;435;25;460;NA;90816;241;2020-11-03;6040
2020-11-02;"Nitriansky kraj";171;4208;46;4254;NA;90816;217;2020-11-02;5799
2020-11-01;"Nitriansky kraj";130;2546;27;2573;NA;90816;157;2020-11-01;5582
2020-10-31;"Nitriansky kraj";261;10466;134;10600;NA;90816;395;2020-10-31;5425
2020-10-30;"Nitriansky kraj";204;2593;42;2635;NA;90816;246;2020-10-30;5030
2020-10-29;"Nitriansky kraj";293;841;39;880;NA;90816;332;2020-10-29;4784
2020-10-28;"Nitriansky kraj";216;608;59;667;NA;90816;275;2020-10-28;4452
2020-10-27;"Nitriansky kraj";296;550;47;597;NA;90816;343;2020-10-27;4177
2020-10-26;"Nitriansky kraj";69;633;56;689;NA;90816;125;2020-10-26;3834
2020-10-25;"Nitriansky kraj";50;62;8;70;NA;90816;58;2020-10-25;3709
2020-10-24;"Nitriansky kraj";169;237;11;248;NA;90816;180;2020-10-24;3651
2020-10-23;"Nitriansky kraj";282;762;41;803;NA;90816;323;2020-10-23;3471
2020-10-22;"Nitriansky kraj";137;444;39;483;NA;90816;176;2020-10-22;3148
2020-10-21;"Nitriansky kraj";146;208;3;211;NA;90816;149;2020-10-21;2972
2020-10-20;"Nitriansky kraj";197;78;6;84;NA;90816;203;2020-10-20;2823
2020-10-19;"Nitriansky kraj";148;79;1;80;NA;90816;149;2020-10-19;2620
2020-10-18;"Nitriansky kraj";22;0;0;0;NA;90816;22;2020-10-18;2471
2020-10-17;"Nitriansky kraj";67;0;0;0;NA;90816;67;2020-10-17;2449
2020-10-16;"Nitriansky kraj";133;28;3;31;NA;90816;136;2020-10-16;2382
2020-10-15;"Nitriansky kraj";106;31;2;33;NA;90816;108;2020-10-15;2246
2020-10-14;"Nitriansky kraj";80;22;4;26;NA;90816;84;2020-10-14;2138
2020-10-13;"Nitriansky kraj";101;82;2;84;NA;90816;103;2020-10-13;2054
2020-10-12;"Nitriansky kraj";36;0;0;0;NA;90816;36;2020-10-12;1951
2020-10-11;"Nitriansky kraj";8;0;0;0;NA;90816;8;2020-10-11;1915
2020-10-10;"Nitriansky kraj";107;0;0;0;NA;90816;107;2020-10-10;1907
2020-10-09;"Nitriansky kraj";120;0;0;0;NA;90816;120;2020-10-09;1800
2020-10-08;"Nitriansky kraj";132;0;0;0;NA;90816;132;2020-10-08;1680
2020-10-07;"Nitriansky kraj";81;0;0;0;NA;90816;81;2020-10-07;1548
2020-10-06;"Nitriansky kraj";48;0;0;0;NA;90816;48;2020-10-06;1467
2020-10-05;"Nitriansky kraj";20;0;0;0;NA;90816;20;2020-10-05;1419
2020-10-04;"Nitriansky kraj";17;0;0;0;NA;90816;17;2020-10-04;1399
2020-10-03;"Nitriansky kraj";96;0;0;0;NA;90816;96;2020-10-03;1382
2020-10-02;"Nitriansky kraj";108;0;0;0;NA;90816;108;2020-10-02;1286
2020-10-01;"Nitriansky kraj";95;0;0;0;NA;90816;95;2020-10-01;1178
2020-09-30;"Nitriansky kraj";100;0;0;0;NA;90816;100;2020-09-30;1083
2020-09-29;"Nitriansky kraj";50;0;0;0;NA;90816;50;2020-09-29;983
2020-09-28;"Nitriansky kraj";22;0;0;0;NA;90816;22;2020-09-28;933
2020-09-27;"Nitriansky kraj";16;0;0;0;NA;90816;16;2020-09-27;911
2020-09-26;"Nitriansky kraj";64;0;0;0;NA;90816;64;2020-09-26;895
2020-09-25;"Nitriansky kraj";90;0;0;0;NA;90816;90;2020-09-25;831
2020-09-24;"Nitriansky kraj";51;0;0;0;NA;90816;51;2020-09-24;741
2020-09-23;"Nitriansky kraj";70;0;0;0;NA;90816;70;2020-09-23;690
2020-09-22;"Nitriansky kraj";18;0;0;0;NA;90816;18;2020-09-22;620
2020-09-21;"Nitriansky kraj";10;0;0;0;NA;90816;10;2020-09-21;602
2020-09-20;"Nitriansky kraj";4;0;0;0;NA;90816;4;2020-09-20;592
2020-09-19;"Nitriansky kraj";14;0;0;0;NA;90816;14;2020-09-19;588
2020-09-18;"Nitriansky kraj";19;0;0;0;NA;90816;19;2020-09-18;574
2020-09-17;"Nitriansky kraj";30;0;0;0;NA;90816;30;2020-09-17;555
2020-09-16;"Nitriansky kraj";6;0;0;0;NA;90816;6;2020-09-16;525
2020-09-15;"Nitriansky kraj";19;0;0;0;NA;90816;19;2020-09-15;519
2020-09-14;"Nitriansky kraj";28;0;0;0;NA;90816;28;2020-09-14;500
2020-09-13;"Nitriansky kraj";3;0;0;0;NA;90816;3;2020-09-13;472
2020-09-12;"Nitriansky kraj";12;0;0;0;NA;90816;12;2020-09-12;469
2020-09-11;"Nitriansky kraj";23;0;0;0;NA;90816;23;2020-09-11;457
2020-09-10;"Nitriansky kraj";29;0;0;0;NA;90816;29;2020-09-10;434
2020-09-09;"Nitriansky kraj";19;0;0;0;NA;90816;19;2020-09-09;405
2020-09-08;"Nitriansky kraj";17;0;0;0;NA;90816;17;2020-09-08;386
2020-09-07;"Nitriansky kraj";17;0;0;0;NA;90816;17;2020-09-07;369
2020-09-06;"Nitriansky kraj";0;0;0;0;NA;90816;0;2020-09-06;352
2020-09-05;"Nitriansky kraj";22;0;0;0;NA;90816;22;2020-09-05;352
2020-09-04;"Nitriansky kraj";34;0;0;0;NA;90816;34;2020-09-04;330
2020-09-03;"Nitriansky kraj";15;0;0;0;NA;90816;15;2020-09-03;296
2020-09-02;"Nitriansky kraj";15;0;0;0;NA;90816;15;2020-09-02;281
2020-09-01;"Nitriansky kraj";2;0;0;0;NA;90816;2;2020-09-01;266
2020-08-31;"Nitriansky kraj";12;0;0;0;NA;90816;12;2020-08-31;264
2020-08-30;"Nitriansky kraj";1;0;0;0;NA;90816;1;2020-08-30;252
2020-08-29;"Nitriansky kraj";7;0;0;0;NA;90816;7;2020-08-29;251
2020-08-28;"Nitriansky kraj";12;0;0;0;NA;90816;12;2020-08-28;244
2020-08-27;"Nitriansky kraj";12;0;0;0;NA;90816;12;2020-08-27;232
2020-08-26;"Nitriansky kraj";4;0;0;0;NA;90816;4;2020-08-26;220
2020-08-25;"Nitriansky kraj";8;0;0;0;NA;90816;8;2020-08-25;216
2020-08-24;"Nitriansky kraj";1;0;0;0;NA;90816;1;2020-08-24;208
2020-08-23;"Nitriansky kraj";1;0;0;0;NA;90816;1;2020-08-23;207
2020-08-22;"Nitriansky kraj";2;0;0;0;NA;90816;2;2020-08-22;206
2020-08-21;"Nitriansky kraj";0;0;0;0;NA;90816;0;2020-08-21;204
2020-08-20;"Nitriansky kraj";7;0;0;0;NA;90816;7;2020-08-20;204
2020-08-19;"Nitriansky kraj";1;0;0;0;NA;90816;1;2020-08-19;197
2020-08-18;"Nitriansky kraj";2;0;0;0;NA;90816;2;2020-08-18;196
2020-08-17;"Nitriansky kraj";1;0;0;0;NA;90816;1;2020-08-17;194
2020-08-16;"Nitriansky kraj";0;0;0;0;NA;90816;0;2020-08-16;193
2020-08-15;"Nitriansky kraj";2;0;0;0;NA;90816;2;2020-08-15;193
2020-08-14;"Nitriansky kraj";1;0;0;0;NA;90816;1;2020-08-14;191
2020-08-13;"Nitriansky kraj";4;0;0;0;NA;90816;4;2020-08-13;190
2020-08-12;"Nitriansky kraj";0;0;0;0;NA;90816;0;2020-08-12;186
2020-08-11;"Nitriansky kraj";1;0;0;0;NA;90816;1;2020-08-11;186
2020-08-10;"Nitriansky kraj";0;0;0;0;NA;90816;0;2020-08-10;185
2020-08-09;"Nitriansky kraj";0;0;0;0;NA;90816;0;2020-08-09;185
2020-08-08;"Nitriansky kraj";0;0;0;0;NA;90816;0;2020-08-08;185
2020-08-07;"Nitriansky kraj";4;0;0;0;NA;90816;4;2020-08-07;185
2020-08-06;"Nitriansky kraj";4;0;0;0;NA;90816;4;2020-08-06;181
2020-08-05;"Nitriansky kraj";0;0;0;0;NA;90816;0;2020-08-05;177
2020-08-04;"Nitriansky kraj";7;0;0;0;NA;90816;7;2020-08-04;177
2020-08-03;"Nitriansky kraj";0;0;0;0;NA;90816;0;2020-08-03;170
2020-08-02;"Nitriansky kraj";0;0;0;0;NA;90816;0;2020-08-02;170
2020-08-01;"Nitriansky kraj";0;0;0;0;NA;90816;0;2020-08-01;170
2020-07-31;"Nitriansky kraj";0;0;0;0;NA;90816;0;2020-07-31;170
2020-07-30;"Nitriansky kraj";0;0;0;0;NA;90816;0;2020-07-30;170
2020-07-29;"Nitriansky kraj";0;0;0;0;NA;90816;0;2020-07-29;170
2020-07-28;"Nitriansky kraj";0;0;0;0;NA;90816;0;2020-07-28;170
2020-07-27;"Nitriansky kraj";0;0;0;0;NA;90816;0;2020-07-27;170
2020-07-26;"Nitriansky kraj";0;0;0;0;NA;90816;0;2020-07-26;170
2020-07-25;"Nitriansky kraj";0;0;0;0;NA;90816;0;2020-07-25;170
2020-07-24;"Nitriansky kraj";1;0;0;0;NA;90816;1;2020-07-24;170
2020-07-23;"Nitriansky kraj";3;0;0;0;NA;90816;3;2020-07-23;169
2020-07-22;"Nitriansky kraj";2;0;0;0;NA;90816;2;2020-07-22;166
2020-07-21;"Nitriansky kraj";14;0;0;0;NA;90816;14;2020-07-21;164
2020-07-20;"Nitriansky kraj";11;0;0;0;NA;90816;11;2020-07-20;150
2020-07-19;"Nitriansky kraj";0;0;0;0;NA;90816;0;2020-07-19;139
2020-07-18;"Nitriansky kraj";0;0;0;0;NA;90816;0;2020-07-18;139
2020-07-17;"Nitriansky kraj";0;0;0;0;NA;90816;0;2020-07-17;139
2020-07-16;"Nitriansky kraj";4;0;0;0;NA;90816;4;2020-07-16;139
2020-07-15;"Nitriansky kraj";5;0;0;0;NA;90816;5;2020-07-15;135
2020-07-14;"Nitriansky kraj";0;0;0;0;NA;90816;0;2020-07-14;130
2020-07-13;"Nitriansky kraj";0;0;0;0;NA;90816;0;2020-07-13;130
2020-07-12;"Nitriansky kraj";0;0;0;0;NA;90816;0;2020-07-12;130
2020-07-11;"Nitriansky kraj";0;0;0;0;NA;90816;0;2020-07-11;130
2020-07-10;"Nitriansky kraj";0;0;0;0;NA;90816;0;2020-07-10;130
2020-07-09;"Nitriansky kraj";1;0;0;0;NA;90816;1;2020-07-09;130
2020-07-08;"Nitriansky kraj";2;0;0;0;NA;90816;2;2020-07-08;129
2020-07-07;"Nitriansky kraj";0;0;0;0;NA;90816;0;2020-07-07;127
2020-07-06;"Nitriansky kraj";0;0;0;0;NA;90816;0;2020-07-06;127
2020-07-05;"Nitriansky kraj";0;0;0;0;NA;90816;0;2020-07-05;127
2020-07-04;"Nitriansky kraj";0;0;0;0;NA;90816;0;2020-07-04;127
2020-07-03;"Nitriansky kraj";0;0;0;0;NA;90816;0;2020-07-03;127
2020-07-02;"Nitriansky kraj";0;0;0;0;NA;90816;0;2020-07-02;127
2020-07-01;"Nitriansky kraj";3;0;0;0;NA;90816;3;2020-07-01;127
2020-06-30;"Nitriansky kraj";0;0;0;0;NA;90816;0;2020-06-30;124
2020-06-29;"Nitriansky kraj";0;0;0;0;NA;90816;0;2020-06-29;124
2020-06-28;"Nitriansky kraj";0;0;0;0;NA;90816;0;2020-06-28;124
2020-06-27;"Nitriansky kraj";0;0;0;0;NA;90816;0;2020-06-27;124
2020-06-26;"Nitriansky kraj";0;0;0;0;NA;90816;0;2020-06-26;124
2020-06-25;"Nitriansky kraj";0;0;0;0;NA;90816;0;2020-06-25;124
2020-06-24;"Nitriansky kraj";1;0;0;0;NA;90816;1;2020-06-24;124
2020-06-23;"Nitriansky kraj";0;0;0;0;NA;90816;0;2020-06-23;123
2020-06-22;"Nitriansky kraj";0;0;0;0;NA;90816;0;2020-06-22;123
2020-06-21;"Nitriansky kraj";0;0;0;0;NA;90816;0;2020-06-21;123
2020-06-20;"Nitriansky kraj";0;0;0;0;NA;90816;0;2020-06-20;123
2020-06-19;"Nitriansky kraj";0;0;0;0;NA;90816;0;2020-06-19;123
2020-06-18;"Nitriansky kraj";0;0;0;0;NA;90816;0;2020-06-18;123
2020-06-17;"Nitriansky kraj";0;0;0;0;NA;90816;0;2020-06-17;123
2020-06-16;"Nitriansky kraj";0;0;0;0;NA;90816;0;2020-06-16;123
2020-06-14;"Nitriansky kraj";0;0;0;0;NA;90816;0;2020-06-14;123
2020-06-13;"Nitriansky kraj";0;0;0;0;NA;90816;0;2020-06-13;123
2020-06-12;"Nitriansky kraj";0;0;0;0;NA;90816;0;2020-06-12;123
2020-06-11;"Nitriansky kraj";0;0;0;0;NA;90816;0;2020-06-11;123
2020-06-10;"Nitriansky kraj";1;0;0;0;NA;90816;1;2020-06-10;123
2020-06-09;"Nitriansky kraj";1;0;0;0;NA;90816;1;2020-06-09;122
2020-06-08;"Nitriansky kraj";0;0;0;0;NA;90816;0;2020-06-08;121
2020-06-07;"Nitriansky kraj";0;0;0;0;NA;90816;0;2020-06-07;121
2020-06-05;"Nitriansky kraj";0;0;0;0;NA;90816;0;2020-06-05;121
2020-06-03;"Nitriansky kraj";0;0;0;0;NA;90816;0;2020-06-03;121
2020-06-02;"Nitriansky kraj";1;0;0;0;NA;90816;1;2020-06-02;121
2020-05-31;"Nitriansky kraj";0;0;0;0;NA;90816;0;2020-05-31;120
2020-05-29;"Nitriansky kraj";0;0;0;0;NA;90816;0;2020-05-29;120
2020-05-27;"Nitriansky kraj";0;0;0;0;NA;90816;0;2020-05-27;120
2020-05-26;"Nitriansky kraj";0;0;0;0;NA;90816;0;2020-05-26;120
2020-05-25;"Nitriansky kraj";0;0;0;0;NA;90816;0;2020-05-25;120
2020-05-24;"Nitriansky kraj";2;0;0;0;NA;90816;2;2020-05-24;120
2020-05-23;"Nitriansky kraj";0;0;0;0;NA;90816;0;2020-05-23;118
2020-05-22;"Nitriansky kraj";1;0;0;0;NA;90816;1;2020-05-22;118
2020-05-21;"Nitriansky kraj";0;0;0;0;NA;90816;0;2020-05-21;117
2020-05-20;"Nitriansky kraj";0;0;0;0;NA;90816;0;2020-05-20;117
2020-05-19;"Nitriansky kraj";0;0;0;0;NA;90816;0;2020-05-19;117
2020-05-17;"Nitriansky kraj";0;0;0;0;NA;90816;0;2020-05-17;117
2020-05-16;"Nitriansky kraj";0;0;0;0;NA;90816;0;2020-05-16;117
2020-05-15;"Nitriansky kraj";1;0;0;0;NA;90816;1;2020-05-15;117
2020-05-14;"Nitriansky kraj";0;0;0;0;NA;90816;0;2020-05-14;116
2020-05-13;"Nitriansky kraj";0;0;0;0;NA;90816;0;2020-05-13;116
2020-05-12;"Nitriansky kraj";0;0;0;0;NA;90816;0;2020-05-12;116
2020-05-11;"Nitriansky kraj";2;0;0;0;NA;90816;2;2020-05-11;116
2020-05-09;"Nitriansky kraj";0;0;0;0;NA;90816;0;2020-05-09;114
2020-05-07;"Nitriansky kraj";1;0;0;0;NA;90816;1;2020-05-07;114
2020-05-06;"Nitriansky kraj";9;0;0;0;NA;90816;9;2020-05-06;113
2020-05-05;"Nitriansky kraj";0;0;0;0;NA;90816;0;2020-05-05;104
2020-05-04;"Nitriansky kraj";5;0;0;0;NA;90816;5;2020-05-04;104
2020-05-03;"Nitriansky kraj";2;0;0;0;NA;90816;2;2020-05-03;99
2020-05-02;"Nitriansky kraj";0;0;0;0;NA;90816;0;2020-05-02;97
2020-05-01;"Nitriansky kraj";1;0;0;0;NA;90816;1;2020-05-01;97
2020-04-30;"Nitriansky kraj";0;0;0;0;NA;90816;0;2020-04-30;96
2020-04-29;"Nitriansky kraj";0;0;0;0;NA;90816;0;2020-04-29;96
2020-04-28;"Nitriansky kraj";1;0;0;0;NA;90816;1;2020-04-28;96
2020-04-27;"Nitriansky kraj";0;0;0;0;NA;90816;0;2020-04-27;95
2020-04-26;"Nitriansky kraj";0;0;0;0;NA;90816;0;2020-04-26;95
2020-04-25;"Nitriansky kraj";0;0;0;0;NA;90816;0;2020-04-25;95
2020-04-24;"Nitriansky kraj";0;0;0;0;NA;90816;0;2020-04-24;95
2020-04-23;"Nitriansky kraj";3;0;0;0;NA;90816;3;2020-04-23;95
2020-04-22;"Nitriansky kraj";16;0;0;0;NA;90816;16;2020-04-22;92
2020-04-21;"Nitriansky kraj";6;0;0;0;NA;90816;6;2020-04-21;76
2020-04-20;"Nitriansky kraj";5;0;0;0;NA;90816;5;2020-04-20;70
2020-04-19;"Nitriansky kraj";0;0;0;0;NA;90816;0;2020-04-19;65
2020-04-18;"Nitriansky kraj";0;0;0;0;NA;90816;0;2020-04-18;65
2020-04-17;"Nitriansky kraj";7;0;0;0;NA;90816;7;2020-04-17;65
2020-04-16;"Nitriansky kraj";0;0;0;0;NA;90816;0;2020-04-16;58
2020-04-15;"Nitriansky kraj";6;0;0;0;NA;90816;6;2020-04-15;58
2020-04-14;"Nitriansky kraj";2;0;0;0;NA;90816;2;2020-04-14;52
2020-04-13;"Nitriansky kraj";1;0;0;0;NA;90816;1;2020-04-13;50
2020-04-12;"Nitriansky kraj";3;0;0;0;NA;90816;3;2020-04-12;49
2020-04-11;"Nitriansky kraj";1;0;0;0;NA;90816;1;2020-04-11;46
2020-04-10;"Nitriansky kraj";1;0;0;0;NA;90816;1;2020-04-10;45
2020-04-09;"Nitriansky kraj";0;0;0;0;NA;90816;0;2020-04-09;44
2020-04-08;"Nitriansky kraj";2;0;0;0;NA;90816;2;2020-04-08;44
2020-04-07;"Nitriansky kraj";3;0;0;0;NA;90816;3;2020-04-07;42
2020-04-06;"Nitriansky kraj";4;0;0;0;NA;90816;4;2020-04-06;39
2020-04-05;"Nitriansky kraj";5;0;0;0;NA;90816;5;2020-04-05;35
2020-04-04;"Nitriansky kraj";0;0;0;0;NA;90816;0;2020-04-04;30
2020-04-03;"Nitriansky kraj";0;0;0;0;NA;90816;0;2020-04-03;30
2020-04-02;"Nitriansky kraj";1;0;0;0;NA;90816;1;2020-04-02;30
2020-04-01;"Nitriansky kraj";0;0;0;0;NA;90816;0;2020-04-01;29
2020-03-31;"Nitriansky kraj";3;0;0;0;NA;90816;3;2020-03-31;29
2020-03-30;"Nitriansky kraj";3;0;0;0;NA;90816;3;2020-03-30;26
2020-03-29;"Nitriansky kraj";3;0;0;0;NA;90816;3;2020-03-29;23
2020-03-28;"Nitriansky kraj";1;0;0;0;NA;90816;1;2020-03-28;20
2020-03-27;"Nitriansky kraj";1;0;0;0;NA;90816;1;2020-03-27;19
2020-03-26;"Nitriansky kraj";1;0;0;0;NA;90816;1;2020-03-26;18
2020-03-25;"Nitriansky kraj";1;0;0;0;NA;90816;1;2020-03-25;17
2020-03-24;"Nitriansky kraj";0;0;0;0;NA;90816;0;2020-03-24;16
2020-03-23;"Nitriansky kraj";2;0;0;0;NA;90816;2;2020-03-23;16
2020-03-22;"Nitriansky kraj";2;0;0;0;NA;90816;2;2020-03-22;14
2020-03-21;"Nitriansky kraj";2;0;0;0;NA;90816;2;2020-03-21;12
2020-03-20;"Nitriansky kraj";1;0;0;0;NA;90816;1;2020-03-20;10
2020-03-19;"Nitriansky kraj";1;0;0;0;NA;90816;1;2020-03-19;9
2020-03-18;"Nitriansky kraj";2;0;0;0;NA;90816;2;2020-03-18;8
2020-03-17;"Nitriansky kraj";1;0;0;0;NA;90816;1;2020-03-17;6
2020-03-16;"Nitriansky kraj";0;0;0;0;NA;90816;0;2020-03-16;5
2020-03-15;"Nitriansky kraj";4;0;0;0;NA;90816;4;2020-03-15;5
2020-03-14;"Nitriansky kraj";1;0;0;0;NA;90816;1;2020-03-14;1
2020-03-13;"Nitriansky kraj";0;0;0;0;NA;90816;0;2020-03-13;0
2020-03-12;"Nitriansky kraj";0;0;0;0;NA;90816;0;2020-03-12;0
2020-03-11;"Nitriansky kraj";0;0;0;0;NA;90816;0;2020-03-11;0
2020-03-09;"Nitriansky kraj";0;0;0;0;NA;90816;0;2020-03-09;0
2020-03-08;"Nitriansky kraj";0;0;0;0;NA;90816;0;2020-03-08;0
2020-03-07;"Nitriansky kraj";0;0;0;0;NA;90816;0;2020-03-07;0
2020-03-06;"Nitriansky kraj";0;0;0;0;NA;90816;0;2020-03-06;0
2021-05-30;"Prešovský kraj";2;9108;12;9120;59713;108402;14;2021-05-30;108402
2021-05-29;"Prešovský kraj";23;12698;24;12722;NA;108402;47;2021-05-29;108388
2021-05-28;"Prešovský kraj";30;12581;19;12600;NA;108402;49;2021-05-28;108341
2021-05-27;"Prešovský kraj";16;7601;37;7638;NA;108402;53;2021-05-27;108292
2021-05-26;"Prešovský kraj";32;8138;23;8161;NA;108402;55;2021-05-26;108239
2021-05-25;"Prešovský kraj";38;8688;20;8708;NA;108402;58;2021-05-25;108184
2021-05-24;"Prešovský kraj";17;13297;37;13334;NA;108402;54;2021-05-24;108126
2021-05-23;"Prešovský kraj";3;11933;20;11953;NA;108402;23;2021-05-23;108072
2021-05-22;"Prešovský kraj";11;14422;44;14466;NA;108402;55;2021-05-22;108049
2021-05-21;"Prešovský kraj";44;13890;24;13914;NA;108402;68;2021-05-21;107994
2021-05-20;"Prešovský kraj";13;9378;29;9407;NA;108402;42;2021-05-20;107926
2021-05-19;"Prešovský kraj";60;10722;36;10758;NA;108402;96;2021-05-19;107884
2021-05-18;"Prešovský kraj";44;9058;27;9085;NA;108402;71;2021-05-18;107788
2021-05-17;"Prešovský kraj";60;12842;47;12889;NA;108402;107;2021-05-17;107717
2021-05-16;"Prešovský kraj";20;16128;66;16194;NA;108402;86;2021-05-16;107610
2021-05-15;"Prešovský kraj";20;24876;83;24959;NA;108402;103;2021-05-15;107524
2021-05-14;"Prešovský kraj";49;18548;68;18616;NA;108402;117;2021-05-14;107421
2021-05-13;"Prešovský kraj";54;10988;71;11059;NA;108402;125;2021-05-13;107304
2021-05-12;"Prešovský kraj";59;10917;40;10957;NA;108402;99;2021-05-12;107179
2021-05-11;"Prešovský kraj";61;10632;47;10679;NA;108402;108;2021-05-11;107080
2021-05-10;"Prešovský kraj";79;16190;69;16259;NA;108402;148;2021-05-10;106972
2021-05-09;"Prešovský kraj";54;21105;82;21187;NA;108402;136;2021-05-09;106824
2021-05-08;"Prešovský kraj";39;22886;51;22937;NA;108402;90;2021-05-08;106688
2021-05-07;"Prešovský kraj";81;23540;66;23606;NA;108402;147;2021-05-07;106598
2021-05-06;"Prešovský kraj";107;12833;66;12899;NA;108402;173;2021-05-06;106451
2021-05-05;"Prešovský kraj";60;12808;79;12887;NA;108402;139;2021-05-05;106278
2021-05-04;"Prešovský kraj";203;13191;67;13258;NA;108402;270;2021-05-04;106139
2021-05-03;"Prešovský kraj";68;18435;109;18544;NA;108402;177;2021-05-03;105869
2021-05-02;"Prešovský kraj";29;36175;102;36277;NA;108402;131;2021-05-02;105692
2021-05-01;"Prešovský kraj";70;56652;183;56835;NA;108402;253;2021-05-01;105561
2021-04-30;"Prešovský kraj";135;0;0;0;NA;108402;135;2021-04-30;105308
2021-04-29;"Prešovský kraj";110;0;0;0;NA;108402;110;2021-04-29;105173
2021-04-28;"Prešovský kraj";122;0;0;0;NA;108402;122;2021-04-28;105063
2021-04-27;"Prešovský kraj";154;0;0;0;NA;108402;154;2021-04-27;104941
2021-04-26;"Prešovský kraj";99;0;0;0;NA;108402;99;2021-04-26;104787
2021-04-25;"Prešovský kraj";9;0;0;0;NA;108402;9;2021-04-25;104688
2021-04-24;"Prešovský kraj";61;0;0;0;NA;108402;61;2021-04-24;104679
2021-04-23;"Prešovský kraj";171;0;0;0;NA;108402;171;2021-04-23;104618
2021-04-22;"Prešovský kraj";86;0;0;0;NA;108402;86;2021-04-22;104447
2021-04-21;"Prešovský kraj";144;0;0;0;NA;108402;144;2021-04-21;104361
2021-04-20;"Prešovský kraj";115;0;0;0;NA;108402;115;2021-04-20;104217
2021-04-19;"Prešovský kraj";106;0;0;0;NA;108402;106;2021-04-19;104102
2021-04-18;"Prešovský kraj";4;0;0;0;NA;108402;4;2021-04-18;103996
2021-04-17;"Prešovský kraj";119;0;0;0;NA;108402;119;2021-04-17;103992
2021-04-16;"Prešovský kraj";135;0;0;0;NA;108402;135;2021-04-16;103873
2021-04-15;"Prešovský kraj";112;0;0;0;NA;108402;112;2021-04-15;103738
2021-04-14;"Prešovský kraj";199;0;0;0;NA;108402;199;2021-04-14;103626
2021-04-13;"Prešovský kraj";180;0;0;0;NA;108402;180;2021-04-13;103427
2021-04-12;"Prešovský kraj";172;0;0;0;NA;108402;172;2021-04-12;103247
2021-04-11;"Prešovský kraj";11;0;0;0;NA;108402;11;2021-04-11;103075
2021-04-10;"Prešovský kraj";94;0;0;0;NA;108402;94;2021-04-10;103064
2021-04-09;"Prešovský kraj";255;0;0;0;NA;108402;255;2021-04-09;102970
2021-04-08;"Prešovský kraj";192;0;0;0;NA;108402;192;2021-04-08;102715
2021-04-07;"Prešovský kraj";314;0;0;0;NA;108402;314;2021-04-07;102523
2021-04-06;"Prešovský kraj";231;0;0;0;NA;108402;231;2021-04-06;102209
2021-04-05;"Prešovský kraj";54;0;0;0;NA;108402;54;2021-04-05;101978
2021-04-04;"Prešovský kraj";31;0;0;0;NA;108402;31;2021-04-04;101924
2021-04-03;"Prešovský kraj";104;0;0;0;NA;108402;104;2021-04-03;101893
2021-04-02;"Prešovský kraj";194;0;0;0;NA;108402;194;2021-04-02;101789
2021-04-01;"Prešovský kraj";256;0;0;0;NA;108402;256;2021-04-01;101595
2021-03-31;"Prešovský kraj";311;30160;227;30387;NA;108402;538;2021-03-31;101339
2021-03-30;"Prešovský kraj";374;20747;203;20950;NA;108402;577;2021-03-30;100801
2021-03-29;"Prešovský kraj";219;28188;229;28417;NA;108402;448;2021-03-29;100224
2021-03-28;"Prešovský kraj";26;46811;256;47067;NA;108402;282;2021-03-28;99776
2021-03-27;"Prešovský kraj";181;88639;373;89012;NA;108402;554;2021-03-27;99494
2021-03-26;"Prešovský kraj";310;47751;299;48050;NA;108402;609;2021-03-26;98940
2021-03-25;"Prešovský kraj";248;22279;213;22492;NA;108402;461;2021-03-25;98331
2021-03-24;"Prešovský kraj";381;19588;213;19801;NA;108402;594;2021-03-24;97870
2021-03-23;"Prešovský kraj";241;20329;255;20584;NA;108402;496;2021-03-23;97276
2021-03-22;"Prešovský kraj";299;28490;286;28776;NA;108402;585;2021-03-22;96780
2021-03-21;"Prešovský kraj";32;49439;266;49705;NA;108402;298;2021-03-21;96195
2021-03-20;"Prešovský kraj";180;92531;427;92958;NA;108402;607;2021-03-20;95897
2021-03-19;"Prešovský kraj";373;46196;320;46516;NA;108402;693;2021-03-19;95290
2021-03-18;"Prešovský kraj";251;21721;217;21938;NA;108402;468;2021-03-18;94597
2021-03-17;"Prešovský kraj";331;20887;231;21118;NA;108402;562;2021-03-17;94129
2021-03-16;"Prešovský kraj";461;21094;277;21371;NA;108402;738;2021-03-16;93567
2021-03-15;"Prešovský kraj";370;28789;324;29113;NA;108402;694;2021-03-15;92829
2021-03-14;"Prešovský kraj";52;50410;356;50766;NA;108402;408;2021-03-14;92135
2021-03-13;"Prešovský kraj";200;95300;532;95832;NA;108402;732;2021-03-13;91727
2021-03-12;"Prešovský kraj";425;47691;368;48059;NA;108402;793;2021-03-12;90995
2021-03-11;"Prešovský kraj";463;22059;253;22312;NA;108402;716;2021-03-11;90202
2021-03-10;"Prešovský kraj";325;20821;293;21114;NA;108402;618;2021-03-10;89486
2021-03-09;"Prešovský kraj";505;21489;288;21777;NA;108402;793;2021-03-09;88868
2021-03-08;"Prešovský kraj";314;28902;333;29235;NA;108402;647;2021-03-08;88075
2021-03-07;"Prešovský kraj";19;48024;385;48409;NA;108402;404;2021-03-07;87428
2021-03-06;"Prešovský kraj";193;96985;591;97576;NA;108402;784;2021-03-06;87024
2021-03-05;"Prešovský kraj";497;46044;397;46441;NA;108402;894;2021-03-05;86240
2021-03-04;"Prešovský kraj";372;22670;359;23029;NA;108402;731;2021-03-04;85346
2021-03-03;"Prešovský kraj";397;21621;333;21954;NA;108402;730;2021-03-03;84615
2021-03-02;"Prešovský kraj";421;22679;357;23036;NA;108402;778;2021-03-02;83885
2021-03-01;"Prešovský kraj";303;27716;406;28122;NA;108402;709;2021-03-01;83107
2021-02-28;"Prešovský kraj";75;45000;387;45387;NA;108402;462;2021-02-28;82398
2021-02-27;"Prešovský kraj";273;90231;734;90965;NA;108402;1007;2021-02-27;81936
2021-02-26;"Prešovský kraj";455;41700;439;42139;NA;108402;894;2021-02-26;80929
2021-02-25;"Prešovský kraj";270;19496;337;19833;NA;108402;607;2021-02-25;80035
2021-02-24;"Prešovský kraj";328;19026;377;19403;NA;108402;705;2021-02-24;79428
2021-02-23;"Prešovský kraj";430;21273;345;21618;NA;108402;775;2021-02-23;78723
2021-02-22;"Prešovský kraj";351;27175;356;27531;NA;108402;707;2021-02-22;77948
2021-02-21;"Prešovský kraj";66;31802;302;32104;NA;108402;368;2021-02-21;77241
2021-02-20;"Prešovský kraj";129;71413;517;71930;NA;108402;646;2021-02-20;76873
2021-02-19;"Prešovský kraj";381;38597;425;39022;NA;108402;806;2021-02-19;76227
2021-02-18;"Prešovský kraj";268;16960;322;17282;NA;108402;590;2021-02-18;75421
2021-02-17;"Prešovský kraj";293;17392;246;17638;NA;108402;539;2021-02-17;74831
2021-02-16;"Prešovský kraj";422;18862;265;19127;NA;108402;687;2021-02-16;74292
2021-02-15;"Prešovský kraj";211;31360;303;31663;NA;108402;514;2021-02-15;73605
2021-02-14;"Prešovský kraj";27;39271;318;39589;NA;108402;345;2021-02-14;73091
2021-02-13;"Prešovský kraj";157;74009;392;74401;NA;108402;549;2021-02-13;72746
2021-02-12;"Prešovský kraj";308;38720;362;39082;NA;108402;670;2021-02-12;72197
2021-02-11;"Prešovský kraj";218;16207;238;16445;NA;108402;456;2021-02-11;71527
2021-02-10;"Prešovský kraj";220;18499;279;18778;NA;108402;499;2021-02-10;71071
2021-02-09;"Prešovský kraj";323;21495;370;21865;NA;108402;693;2021-02-09;70572
2021-02-08;"Prešovský kraj";161;36971;261;37232;NA;108402;422;2021-02-08;69879
2021-02-07;"Prešovský kraj";21;34227;209;34436;NA;108402;230;2021-02-07;69457
2021-02-06;"Prešovský kraj";176;69164;360;69524;NA;108402;536;2021-02-06;69227
2021-02-05;"Prešovský kraj";177;31247;261;31508;NA;108402;438;2021-02-05;68691
2021-02-04;"Prešovský kraj";176;13073;237;13310;NA;108402;413;2021-02-04;68253
2021-02-03;"Prešovský kraj";251;8421;236;8657;NA;108402;487;2021-02-03;67840
2021-02-02;"Prešovský kraj";249;11779;264;12043;NA;108402;513;2021-02-02;67353
2021-02-01;"Prešovský kraj";220;16059;316;16375;NA;108402;536;2021-02-01;66840
2021-01-31;"Prešovský kraj";42;10587;107;10694;NA;108402;149;2021-01-31;66304
2021-01-30;"Prešovský kraj";142;23939;215;24154;NA;108402;357;2021-01-30;66155
2021-01-29;"Prešovský kraj";185;17924;326;18250;NA;108402;511;2021-01-29;65798
2021-01-28;"Prešovský kraj";311;7338;150;7488;NA;108402;461;2021-01-28;65287
2021-01-27;"Prešovský kraj";153;9886;150;10036;NA;108402;303;2021-01-27;64826
2021-01-26;"Prešovský kraj";252;16648;151;16799;NA;108402;403;2021-01-26;64523
2021-01-25;"Prešovský kraj";196;29649;251;29900;NA;108402;447;2021-01-25;64120
2021-01-24;"Prešovský kraj";12;45706;304;46010;NA;108402;316;2021-01-24;63673
2021-01-23;"Prešovský kraj";189;96726;487;97213;NA;108402;676;2021-01-23;63357
2021-01-22;"Prešovský kraj";187;35377;261;35638;NA;108402;448;2021-01-22;62681
2021-01-21;"Prešovský kraj";187;20434;212;20646;NA;108402;399;2021-01-21;62233
2021-01-20;"Prešovský kraj";253;14779;195;14974;NA;108402;448;2021-01-20;61834
2021-01-19;"Prešovský kraj";281;12329;305;12634;NA;108402;586;2021-01-19;61386
2021-01-18;"Prešovský kraj";203;10422;336;10758;NA;108402;539;2021-01-18;60800
2021-01-17;"Prešovský kraj";107;14391;1008;15399;NA;108402;1115;2021-01-17;60261
2021-01-16;"Prešovský kraj";72;1838;81;1919;NA;108402;153;2021-01-16;59146
2021-01-15;"Prešovský kraj";159;7033;257;7290;NA;108402;416;2021-01-15;58993
2021-01-14;"Prešovský kraj";268;5523;252;5775;NA;108402;520;2021-01-14;58577
2021-01-13;"Prešovský kraj";342;5649;226;5875;NA;108402;568;2021-01-13;58057
2021-01-12;"Prešovský kraj";455;8487;409;8896;NA;108402;864;2021-01-12;57489
2021-01-11;"Prešovský kraj";343;8489;479;8968;NA;108402;822;2021-01-11;56625
2021-01-10;"Prešovský kraj";63;476;23;499;NA;108402;86;2021-01-10;55803
2021-01-09;"Prešovský kraj";439;2248;125;2373;NA;108402;564;2021-01-09;55717
2021-01-08;"Prešovský kraj";430;10865;572;11437;NA;108402;1002;2021-01-08;55153
2021-01-07;"Prešovský kraj";268;7789;648;8437;NA;108402;916;2021-01-07;54151
2021-01-06;"Prešovský kraj";315;1484;134;1618;NA;108402;449;2021-01-06;53235
2021-01-05;"Prešovský kraj";655;11591;1003;12594;NA;108402;1658;2021-01-05;52786
2021-01-04;"Prešovský kraj";371;17192;1812;19004;NA;108402;2183;2021-01-04;51128
2021-01-03;"Prešovský kraj";89;459;41;500;NA;108402;130;2021-01-03;48945
2021-01-02;"Prešovský kraj";65;1556;160;1716;NA;108402;225;2021-01-02;48815
2021-01-01;"Prešovský kraj";174;956;71;1027;NA;108402;245;2021-01-01;48590
2020-12-31;"Prešovský kraj";640;11959;783;12742;NA;108402;1423;2020-12-31;48345
2020-12-30;"Prešovský kraj";729;9065;802;9867;NA;108402;1531;2020-12-30;46922
2020-12-29;"Prešovský kraj";435;9273;949;10222;NA;108402;1384;2020-12-29;45391
2020-12-28;"Prešovský kraj";393;9046;1079;10125;NA;108402;1472;2020-12-28;44007
2020-12-27;"Prešovský kraj";40;613;45;658;NA;108402;85;2020-12-27;42535
2020-12-26;"Prešovský kraj";64;176;12;188;NA;108402;76;2020-12-26;42450
2020-12-25;"Prešovský kraj";208;274;11;285;NA;108402;219;2020-12-25;42374
2020-12-24;"Prešovský kraj";452;1214;85;1299;NA;108402;537;2020-12-24;42155
2020-12-23;"Prešovský kraj";361;11369;635;12004;NA;108402;996;2020-12-23;41618
2020-12-22;"Prešovský kraj";439;9371;710;10081;NA;108402;1149;2020-12-22;40622
2020-12-21;"Prešovský kraj";432;9923;880;10803;NA;108402;1312;2020-12-21;39473
2020-12-20;"Prešovský kraj";184;396;20;416;NA;108402;204;2020-12-20;38161
2020-12-19;"Prešovský kraj";276;1658;151;1809;NA;108402;427;2020-12-19;37957
2020-12-18;"Prešovský kraj";396;8845;595;9440;NA;108402;991;2020-12-18;37530
2020-12-17;"Prešovský kraj";427;10826;891;11717;NA;108402;1318;2020-12-17;36539
2020-12-16;"Prešovský kraj";466;6017;508;6525;NA;108402;974;2020-12-16;35221
2020-12-15;"Prešovský kraj";411;5685;584;6269;NA;108402;995;2020-12-15;34247
2020-12-14;"Prešovský kraj";334;5767;508;6275;NA;108402;842;2020-12-14;33252
2020-12-13;"Prešovský kraj";89;29;8;37;NA;108402;97;2020-12-13;32410
2020-12-12;"Prešovský kraj";319;2474;166;2640;NA;108402;485;2020-12-12;32313
2020-12-11;"Prešovský kraj";560;5602;402;6004;NA;108402;962;2020-12-11;31828
2020-12-10;"Prešovský kraj";337;5202;443;5645;NA;108402;780;2020-12-10;30866
2020-12-09;"Prešovský kraj";358;4357;314;4671;NA;108402;672;2020-12-09;30086
2020-12-08;"Prešovský kraj";350;6629;651;7280;NA;108402;1001;2020-12-08;29414
2020-12-07;"Prešovský kraj";309;4345;327;4672;NA;108402;636;2020-12-07;28413
2020-12-06;"Prešovský kraj";59;655;26;681;NA;108402;85;2020-12-06;27777
2020-12-05;"Prešovský kraj";218;984;87;1071;NA;108402;305;2020-12-05;27692
2020-12-04;"Prešovský kraj";352;5070;293;5363;NA;108402;645;2020-12-04;27387
2020-12-03;"Prešovský kraj";284;2456;179;2635;NA;108402;463;2020-12-03;26742
2020-12-02;"Prešovský kraj";232;2830;225;3055;NA;108402;457;2020-12-02;26279
2020-12-01;"Prešovský kraj";281;1884;196;2080;NA;108402;477;2020-12-01;25822
2020-11-30;"Prešovský kraj";196;5333;97;5430;NA;108402;293;2020-11-30;25345
2020-11-29;"Prešovský kraj";27;379;42;421;NA;108402;69;2020-11-29;25052
2020-11-28;"Prešovský kraj";199;772;77;849;NA;108402;276;2020-11-28;24983
2020-11-27;"Prešovský kraj";232;2350;130;2480;NA;108402;362;2020-11-27;24707
2020-11-26;"Prešovský kraj";263;3014;329;3343;NA;108402;592;2020-11-26;24345
2020-11-25;"Prešovský kraj";302;2174;103;2277;NA;108402;405;2020-11-25;23753
2020-11-24;"Prešovský kraj";365;1777;156;1933;NA;108402;521;2020-11-24;23348
2020-11-23;"Prešovský kraj";164;1099;60;1159;NA;108402;224;2020-11-23;22827
2020-11-22;"Prešovský kraj";46;44;1;45;NA;108402;47;2020-11-22;22603
2020-11-21;"Prešovský kraj";205;754;62;816;NA;108402;267;2020-11-21;22556
2020-11-20;"Prešovský kraj";363;2258;102;2360;NA;108402;465;2020-11-20;22289
2020-11-19;"Prešovský kraj";359;2096;238;2334;NA;108402;597;2020-11-19;21824
2020-11-18;"Prešovský kraj";270;488;43;531;NA;108402;313;2020-11-18;21227
2020-11-17;"Prešovský kraj";347;205;23;228;NA;108402;370;2020-11-17;20914
2020-11-16;"Prešovský kraj";226;540;58;598;NA;108402;284;2020-11-16;20544
2020-11-15;"Prešovský kraj";186;39;4;43;NA;108402;190;2020-11-15;20260
2020-11-14;"Prešovský kraj";261;54;4;58;NA;108402;265;2020-11-14;20070
2020-11-13;"Prešovský kraj";395;166;8;174;NA;108402;403;2020-11-13;19805
2020-11-12;"Prešovský kraj";397;229;50;279;NA;108402;447;2020-11-12;19402
2020-11-11;"Prešovský kraj";516;161;15;176;NA;108402;531;2020-11-11;18955
2020-11-10;"Prešovský kraj";437;197;9;206;NA;108402;446;2020-11-10;18424
2020-11-09;"Prešovský kraj";190;4110;945;5055;NA;108402;1135;2020-11-09;17978
2020-11-08;"Prešovský kraj";97;2817;32;2849;NA;108402;129;2020-11-08;16843
2020-11-07;"Prešovský kraj";416;8578;81;8659;NA;108402;497;2020-11-07;16714
2020-11-06;"Prešovský kraj";520;4791;76;4867;NA;108402;596;2020-11-06;16217
2020-11-05;"Prešovský kraj";397;180;5;185;NA;108402;402;2020-11-05;15621
2020-11-04;"Prešovský kraj";350;807;8;815;NA;108402;358;2020-11-04;15219
2020-11-03;"Prešovský kraj";565;98;12;110;NA;108402;577;2020-11-03;14861
2020-11-02;"Prešovský kraj";203;4158;1004;5162;NA;108402;1207;2020-11-02;14284
2020-11-01;"Prešovský kraj";386;2906;53;2959;NA;108402;439;2020-11-01;13077
2020-10-31;"Prešovský kraj";315;10497;170;10667;NA;108402;485;2020-10-31;12638
2020-10-30;"Prešovský kraj";552;2949;65;3014;NA;108402;617;2020-10-30;12153
2020-10-29;"Prešovský kraj";594;301;38;339;NA;108402;632;2020-10-29;11536
2020-10-28;"Prešovský kraj";617;291;46;337;NA;108402;663;2020-10-28;10904
2020-10-27;"Prešovský kraj";656;268;34;302;NA;108402;690;2020-10-27;10241
2020-10-26;"Prešovský kraj";137;363;57;420;NA;108402;194;2020-10-26;9551
2020-10-25;"Prešovský kraj";237;346;11;357;NA;108402;248;2020-10-25;9357
2020-10-24;"Prešovský kraj";719;200;12;212;NA;108402;731;2020-10-24;9109
2020-10-23;"Prešovský kraj";750;218;8;226;NA;108402;758;2020-10-23;8378
2020-10-22;"Prešovský kraj";646;396;30;426;NA;108402;676;2020-10-22;7620
2020-10-21;"Prešovský kraj";383;58;8;66;NA;108402;391;2020-10-21;6944
2020-10-20;"Prešovský kraj";493;65;7;72;NA;108402;500;2020-10-20;6553
2020-10-19;"Prešovský kraj";140;235;15;250;NA;108402;155;2020-10-19;6053
2020-10-18;"Prešovský kraj";209;0;0;0;NA;108402;209;2020-10-18;5898
2020-10-17;"Prešovský kraj";342;0;0;0;NA;108402;342;2020-10-17;5689
2020-10-16;"Prešovský kraj";388;57;3;60;NA;108402;391;2020-10-16;5347
2020-10-15;"Prešovský kraj";435;85;18;103;NA;108402;453;2020-10-15;4956
2020-10-14;"Prešovský kraj";451;54;10;64;NA;108402;461;2020-10-14;4503
2020-10-13;"Prešovský kraj";264;50;6;56;NA;108402;270;2020-10-13;4042
2020-10-12;"Prešovský kraj";214;334;35;369;NA;108402;249;2020-10-12;3772
2020-10-11;"Prešovský kraj";127;0;0;0;NA;108402;127;2020-10-11;3523
2020-10-10;"Prešovský kraj";248;0;0;0;NA;108402;248;2020-10-10;3396
2020-10-09;"Prešovský kraj";406;0;0;0;NA;108402;406;2020-10-09;3148
2020-10-08;"Prešovský kraj";245;0;0;0;NA;108402;245;2020-10-08;2742
2020-10-07;"Prešovský kraj";244;0;0;0;NA;108402;244;2020-10-07;2497
2020-10-06;"Prešovský kraj";166;0;0;0;NA;108402;166;2020-10-06;2253
2020-10-05;"Prešovský kraj";84;0;0;0;NA;108402;84;2020-10-05;2087
2020-10-04;"Prešovský kraj";118;0;0;0;NA;108402;118;2020-10-04;2003
2020-10-03;"Prešovský kraj";204;0;0;0;NA;108402;204;2020-10-03;1885
2020-10-02;"Prešovský kraj";149;0;0;0;NA;108402;149;2020-10-02;1681
2020-10-01;"Prešovský kraj";136;0;0;0;NA;108402;136;2020-10-01;1532
2020-09-30;"Prešovský kraj";121;0;0;0;NA;108402;121;2020-09-30;1396
2020-09-29;"Prešovský kraj";156;0;0;0;NA;108402;156;2020-09-29;1275
2020-09-28;"Prešovský kraj";51;0;0;0;NA;108402;51;2020-09-28;1119
2020-09-27;"Prešovský kraj";10;0;0;0;NA;108402;10;2020-09-27;1068
2020-09-26;"Prešovský kraj";72;0;0;0;NA;108402;72;2020-09-26;1058
2020-09-25;"Prešovský kraj";91;0;0;0;NA;108402;91;2020-09-25;986
2020-09-24;"Prešovský kraj";52;0;0;0;NA;108402;52;2020-09-24;895
2020-09-23;"Prešovský kraj";55;0;0;0;NA;108402;55;2020-09-23;843
2020-09-22;"Prešovský kraj";29;0;0;0;NA;108402;29;2020-09-22;788
2020-09-21;"Prešovský kraj";14;0;0;0;NA;108402;14;2020-09-21;759
2020-09-20;"Prešovský kraj";5;0;0;0;NA;108402;5;2020-09-20;745
2020-09-19;"Prešovský kraj";12;0;0;0;NA;108402;12;2020-09-19;740
2020-09-18;"Prešovský kraj";29;0;0;0;NA;108402;29;2020-09-18;728
2020-09-17;"Prešovský kraj";25;0;0;0;NA;108402;25;2020-09-17;699
2020-09-16;"Prešovský kraj";8;0;0;0;NA;108402;8;2020-09-16;674
2020-09-15;"Prešovský kraj";10;0;0;0;NA;108402;10;2020-09-15;666
2020-09-14;"Prešovský kraj";47;0;0;0;NA;108402;47;2020-09-14;656
2020-09-13;"Prešovský kraj";3;0;0;0;NA;108402;3;2020-09-13;609
2020-09-12;"Prešovský kraj";4;0;0;0;NA;108402;4;2020-09-12;606
2020-09-11;"Prešovský kraj";15;0;0;0;NA;108402;15;2020-09-11;602
2020-09-10;"Prešovský kraj";10;0;0;0;NA;108402;10;2020-09-10;587
2020-09-09;"Prešovský kraj";21;0;0;0;NA;108402;21;2020-09-09;577
2020-09-08;"Prešovský kraj";23;0;0;0;NA;108402;23;2020-09-08;556
2020-09-07;"Prešovský kraj";5;0;0;0;NA;108402;5;2020-09-07;533
2020-09-06;"Prešovský kraj";3;0;0;0;NA;108402;3;2020-09-06;528
2020-09-05;"Prešovský kraj";7;0;0;0;NA;108402;7;2020-09-05;525
2020-09-04;"Prešovský kraj";24;0;0;0;NA;108402;24;2020-09-04;518
2020-09-03;"Prešovský kraj";8;0;0;0;NA;108402;8;2020-09-03;494
2020-09-02;"Prešovský kraj";9;0;0;0;NA;108402;9;2020-09-02;486
2020-09-01;"Prešovský kraj";6;0;0;0;NA;108402;6;2020-09-01;477
2020-08-31;"Prešovský kraj";3;0;0;0;NA;108402;3;2020-08-31;471
2020-08-30;"Prešovský kraj";6;0;0;0;NA;108402;6;2020-08-30;468
2020-08-29;"Prešovský kraj";4;0;0;0;NA;108402;4;2020-08-29;462
2020-08-28;"Prešovský kraj";6;0;0;0;NA;108402;6;2020-08-28;458
2020-08-27;"Prešovský kraj";7;0;0;0;NA;108402;7;2020-08-27;452
2020-08-26;"Prešovský kraj";22;0;0;0;NA;108402;22;2020-08-26;445
2020-08-25;"Prešovský kraj";1;0;0;0;NA;108402;1;2020-08-25;423
2020-08-24;"Prešovský kraj";5;0;0;0;NA;108402;5;2020-08-24;422
2020-08-23;"Prešovský kraj";3;0;0;0;NA;108402;3;2020-08-23;417
2020-08-22;"Prešovský kraj";3;0;0;0;NA;108402;3;2020-08-22;414
2020-08-21;"Prešovský kraj";11;0;0;0;NA;108402;11;2020-08-21;411
2020-08-20;"Prešovský kraj";8;0;0;0;NA;108402;8;2020-08-20;400
2020-08-19;"Prešovský kraj";8;0;0;0;NA;108402;8;2020-08-19;392
2020-08-18;"Prešovský kraj";6;0;0;0;NA;108402;6;2020-08-18;384
2020-08-17;"Prešovský kraj";1;0;0;0;NA;108402;1;2020-08-17;378
2020-08-16;"Prešovský kraj";0;0;0;0;NA;108402;0;2020-08-16;377
2020-08-15;"Prešovský kraj";8;0;0;0;NA;108402;8;2020-08-15;377
2020-08-14;"Prešovský kraj";6;0;0;0;NA;108402;6;2020-08-14;369
2020-08-13;"Prešovský kraj";8;0;0;0;NA;108402;8;2020-08-13;363
2020-08-12;"Prešovský kraj";19;0;0;0;NA;108402;19;2020-08-12;355
2020-08-11;"Prešovský kraj";3;0;0;0;NA;108402;3;2020-08-11;336
2020-08-10;"Prešovský kraj";0;0;0;0;NA;108402;0;2020-08-10;333
2020-08-09;"Prešovský kraj";0;0;0;0;NA;108402;0;2020-08-09;333
2020-08-08;"Prešovský kraj";2;0;0;0;NA;108402;2;2020-08-08;333
2020-08-07;"Prešovský kraj";6;0;0;0;NA;108402;6;2020-08-07;331
2020-08-06;"Prešovský kraj";2;0;0;0;NA;108402;2;2020-08-06;325
2020-08-05;"Prešovský kraj";8;0;0;0;NA;108402;8;2020-08-05;323
2020-08-04;"Prešovský kraj";5;0;0;0;NA;108402;5;2020-08-04;315
2020-08-03;"Prešovský kraj";4;0;0;0;NA;108402;4;2020-08-03;310
2020-08-02;"Prešovský kraj";6;0;0;0;NA;108402;6;2020-08-02;306
2020-08-01;"Prešovský kraj";0;0;0;0;NA;108402;0;2020-08-01;300
2020-07-31;"Prešovský kraj";2;0;0;0;NA;108402;2;2020-07-31;300
2020-07-30;"Prešovský kraj";6;0;0;0;NA;108402;6;2020-07-30;298
2020-07-29;"Prešovský kraj";5;0;0;0;NA;108402;5;2020-07-29;292
2020-07-28;"Prešovský kraj";0;0;0;0;NA;108402;0;2020-07-28;287
2020-07-27;"Prešovský kraj";1;0;0;0;NA;108402;1;2020-07-27;287
2020-07-26;"Prešovský kraj";1;0;0;0;NA;108402;1;2020-07-26;286
2020-07-25;"Prešovský kraj";21;0;0;0;NA;108402;21;2020-07-25;285
2020-07-24;"Prešovský kraj";1;0;0;0;NA;108402;1;2020-07-24;264
2020-07-23;"Prešovský kraj";5;0;0;0;NA;108402;5;2020-07-23;263
2020-07-22;"Prešovský kraj";1;0;0;0;NA;108402;1;2020-07-22;258
2020-07-21;"Prešovský kraj";2;0;0;0;NA;108402;2;2020-07-21;257
2020-07-20;"Prešovský kraj";1;0;0;0;NA;108402;1;2020-07-20;255
2020-07-19;"Prešovský kraj";0;0;0;0;NA;108402;0;2020-07-19;254
2020-07-18;"Prešovský kraj";0;0;0;0;NA;108402;0;2020-07-18;254
2020-07-17;"Prešovský kraj";3;0;0;0;NA;108402;3;2020-07-17;254
2020-07-16;"Prešovský kraj";1;0;0;0;NA;108402;1;2020-07-16;251
2020-07-15;"Prešovský kraj";5;0;0;0;NA;108402;5;2020-07-15;250
2020-07-14;"Prešovský kraj";5;0;0;0;NA;108402;5;2020-07-14;245
2020-07-13;"Prešovský kraj";1;0;0;0;NA;108402;1;2020-07-13;240
2020-07-12;"Prešovský kraj";1;0;0;0;NA;108402;1;2020-07-12;239
2020-07-11;"Prešovský kraj";6;0;0;0;NA;108402;6;2020-07-11;238
2020-07-10;"Prešovský kraj";5;0;0;0;NA;108402;5;2020-07-10;232
2020-07-09;"Prešovský kraj";2;0;0;0;NA;108402;2;2020-07-09;227
2020-07-08;"Prešovský kraj";14;0;0;0;NA;108402;14;2020-07-08;225
2020-07-07;"Prešovský kraj";2;0;0;0;NA;108402;2;2020-07-07;211
2020-07-06;"Prešovský kraj";0;0;0;0;NA;108402;0;2020-07-06;209
2020-07-05;"Prešovský kraj";0;0;0;0;NA;108402;0;2020-07-05;209
2020-07-04;"Prešovský kraj";1;0;0;0;NA;108402;1;2020-07-04;209
2020-07-03;"Prešovský kraj";3;0;0;0;NA;108402;3;2020-07-03;208
2020-07-02;"Prešovský kraj";0;0;0;0;NA;108402;0;2020-07-02;205
2020-07-01;"Prešovský kraj";0;0;0;0;NA;108402;0;2020-07-01;205
2020-06-30;"Prešovský kraj";7;0;0;0;NA;108402;7;2020-06-30;205
2020-06-29;"Prešovský kraj";0;0;0;0;NA;108402;0;2020-06-29;198
2020-06-28;"Prešovský kraj";0;0;0;0;NA;108402;0;2020-06-28;198
2020-06-27;"Prešovský kraj";3;0;0;0;NA;108402;3;2020-06-27;198
2020-06-26;"Prešovský kraj";3;0;0;0;NA;108402;3;2020-06-26;195
2020-06-25;"Prešovský kraj";0;0;0;0;NA;108402;0;2020-06-25;192
2020-06-24;"Prešovský kraj";4;0;0;0;NA;108402;4;2020-06-24;192
2020-06-23;"Prešovský kraj";0;0;0;0;NA;108402;0;2020-06-23;188
2020-06-22;"Prešovský kraj";0;0;0;0;NA;108402;0;2020-06-22;188
2020-06-21;"Prešovský kraj";0;0;0;0;NA;108402;0;2020-06-21;188
2020-06-20;"Prešovský kraj";0;0;0;0;NA;108402;0;2020-06-20;188
2020-06-19;"Prešovský kraj";1;0;0;0;NA;108402;1;2020-06-19;188
2020-06-18;"Prešovský kraj";0;0;0;0;NA;108402;0;2020-06-18;187
2020-06-17;"Prešovský kraj";0;0;0;0;NA;108402;0;2020-06-17;187
2020-06-16;"Prešovský kraj";6;0;0;0;NA;108402;6;2020-06-16;187
2020-06-14;"Prešovský kraj";0;0;0;0;NA;108402;0;2020-06-14;181
2020-06-13;"Prešovský kraj";0;0;0;0;NA;108402;0;2020-06-13;181
2020-06-12;"Prešovský kraj";1;0;0;0;NA;108402;1;2020-06-12;181
2020-06-11;"Prešovský kraj";0;0;0;0;NA;108402;0;2020-06-11;180
2020-06-10;"Prešovský kraj";0;0;0;0;NA;108402;0;2020-06-10;180
2020-06-09;"Prešovský kraj";0;0;0;0;NA;108402;0;2020-06-09;180
2020-06-08;"Prešovský kraj";0;0;0;0;NA;108402;0;2020-06-08;180
2020-06-07;"Prešovský kraj";0;0;0;0;NA;108402;0;2020-06-07;180
2020-06-05;"Prešovský kraj";0;0;0;0;NA;108402;0;2020-06-05;180
2020-06-03;"Prešovský kraj";0;0;0;0;NA;108402;0;2020-06-03;180
2020-06-02;"Prešovský kraj";1;0;0;0;NA;108402;1;2020-06-02;180
2020-05-31;"Prešovský kraj";1;0;0;0;NA;108402;1;2020-05-31;179
2020-05-29;"Prešovský kraj";0;0;0;0;NA;108402;0;2020-05-29;178
2020-05-27;"Prešovský kraj";0;0;0;0;NA;108402;0;2020-05-27;178
2020-05-26;"Prešovský kraj";0;0;0;0;NA;108402;0;2020-05-26;178
2020-05-25;"Prešovský kraj";0;0;0;0;NA;108402;0;2020-05-25;178
2020-05-24;"Prešovský kraj";0;0;0;0;NA;108402;0;2020-05-24;178
2020-05-23;"Prešovský kraj";0;0;0;0;NA;108402;0;2020-05-23;178
2020-05-22;"Prešovský kraj";0;0;0;0;NA;108402;0;2020-05-22;178
2020-05-21;"Prešovský kraj";1;0;0;0;NA;108402;1;2020-05-21;178
2020-05-20;"Prešovský kraj";0;0;0;0;NA;108402;0;2020-05-20;177
2020-05-19;"Prešovský kraj";0;0;0;0;NA;108402;0;2020-05-19;177
2020-05-17;"Prešovský kraj";0;0;0;0;NA;108402;0;2020-05-17;177
2020-05-16;"Prešovský kraj";0;0;0;0;NA;108402;0;2020-05-16;177
2020-05-15;"Prešovský kraj";0;0;0;0;NA;108402;0;2020-05-15;177
2020-05-14;"Prešovský kraj";0;0;0;0;NA;108402;0;2020-05-14;177
2020-05-13;"Prešovský kraj";1;0;0;0;NA;108402;1;2020-05-13;177
2020-05-12;"Prešovský kraj";0;0;0;0;NA;108402;0;2020-05-12;176
2020-05-11;"Prešovský kraj";1;0;0;0;NA;108402;1;2020-05-11;176
2020-05-09;"Prešovský kraj";0;0;0;0;NA;108402;0;2020-05-09;175
2020-05-07;"Prešovský kraj";0;0;0;0;NA;108402;0;2020-05-07;175
2020-05-06;"Prešovský kraj";0;0;0;0;NA;108402;0;2020-05-06;175
2020-05-05;"Prešovský kraj";1;0;0;0;NA;108402;1;2020-05-05;175
2020-05-04;"Prešovský kraj";0;0;0;0;NA;108402;0;2020-05-04;174
2020-05-03;"Prešovský kraj";0;0;0;0;NA;108402;0;2020-05-03;174
2020-05-02;"Prešovský kraj";0;0;0;0;NA;108402;0;2020-05-02;174
2020-05-01;"Prešovský kraj";2;0;0;0;NA;108402;2;2020-05-01;174
2020-04-30;"Prešovský kraj";0;0;0;0;NA;108402;0;2020-04-30;172
2020-04-29;"Prešovský kraj";1;0;0;0;NA;108402;1;2020-04-29;172
2020-04-28;"Prešovský kraj";1;0;0;0;NA;108402;1;2020-04-28;171
2020-04-27;"Prešovský kraj";2;0;0;0;NA;108402;2;2020-04-27;170
2020-04-26;"Prešovský kraj";0;0;0;0;NA;108402;0;2020-04-26;168
2020-04-25;"Prešovský kraj";0;0;0;0;NA;108402;0;2020-04-25;168
2020-04-24;"Prešovský kraj";0;0;0;0;NA;108402;0;2020-04-24;168
2020-04-23;"Prešovský kraj";2;0;0;0;NA;108402;2;2020-04-23;168
2020-04-22;"Prešovský kraj";11;0;0;0;NA;108402;11;2020-04-22;166
2020-04-21;"Prešovský kraj";12;0;0;0;NA;108402;12;2020-04-21;155
2020-04-20;"Prešovský kraj";2;0;0;0;NA;108402;2;2020-04-20;143
2020-04-19;"Prešovský kraj";4;0;0;0;NA;108402;4;2020-04-19;141
2020-04-18;"Prešovský kraj";1;0;0;0;NA;108402;1;2020-04-18;137
2020-04-17;"Prešovský kraj";4;0;0;0;NA;108402;4;2020-04-17;136
2020-04-16;"Prešovský kraj";9;0;0;0;NA;108402;9;2020-04-16;132
2020-04-15;"Prešovský kraj";21;0;0;0;NA;108402;21;2020-04-15;123
2020-04-14;"Prešovský kraj";1;0;0;0;NA;108402;1;2020-04-14;102
2020-04-13;"Prešovský kraj";2;0;0;0;NA;108402;2;2020-04-13;101
2020-04-12;"Prešovský kraj";6;0;0;0;NA;108402;6;2020-04-12;99
2020-04-11;"Prešovský kraj";4;0;0;0;NA;108402;4;2020-04-11;93
2020-04-10;"Prešovský kraj";0;0;0;0;NA;108402;0;2020-04-10;89
2020-04-09;"Prešovský kraj";1;0;0;0;NA;108402;1;2020-04-09;89
2020-04-08;"Prešovský kraj";0;0;0;0;NA;108402;0;2020-04-08;88
2020-04-07;"Prešovský kraj";7;0;0;0;NA;108402;7;2020-04-07;88
2020-04-06;"Prešovský kraj";10;0;0;0;NA;108402;10;2020-04-06;81
2020-04-05;"Prešovský kraj";13;0;0;0;NA;108402;13;2020-04-05;71
2020-04-04;"Prešovský kraj";1;0;0;0;NA;108402;1;2020-04-04;58
2020-04-03;"Prešovský kraj";4;0;0;0;NA;108402;4;2020-04-03;57
2020-04-02;"Prešovský kraj";6;0;0;0;NA;108402;6;2020-04-02;53
2020-04-01;"Prešovský kraj";6;0;0;0;NA;108402;6;2020-04-01;47
2020-03-31;"Prešovský kraj";6;0;0;0;NA;108402;6;2020-03-31;41
2020-03-30;"Prešovský kraj";2;0;0;0;NA;108402;2;2020-03-30;35
2020-03-29;"Prešovský kraj";2;0;0;0;NA;108402;2;2020-03-29;33
2020-03-28;"Prešovský kraj";2;0;0;0;NA;108402;2;2020-03-28;31
2020-03-27;"Prešovský kraj";1;0;0;0;NA;108402;1;2020-03-27;29
2020-03-26;"Prešovský kraj";8;0;0;0;NA;108402;8;2020-03-26;28
2020-03-25;"Prešovský kraj";1;0;0;0;NA;108402;1;2020-03-25;20
2020-03-24;"Prešovský kraj";4;0;0;0;NA;108402;4;2020-03-24;19
2020-03-23;"Prešovský kraj";0;0;0;0;NA;108402;0;2020-03-23;15
2020-03-22;"Prešovský kraj";1;0;0;0;NA;108402;1;2020-03-22;15
2020-03-21;"Prešovský kraj";2;0;0;0;NA;108402;2;2020-03-21;14
2020-03-20;"Prešovský kraj";3;0;0;0;NA;108402;3;2020-03-20;12
2020-03-19;"Prešovský kraj";2;0;0;0;NA;108402;2;2020-03-19;9
2020-03-18;"Prešovský kraj";1;0;0;0;NA;108402;1;2020-03-18;7
2020-03-17;"Prešovský kraj";1;0;0;0;NA;108402;1;2020-03-17;6
2020-03-16;"Prešovský kraj";4;0;0;0;NA;108402;4;2020-03-16;5
2020-03-15;"Prešovský kraj";0;0;0;0;NA;108402;0;2020-03-15;1
2020-03-14;"Prešovský kraj";1;0;0;0;NA;108402;1;2020-03-14;1
2020-03-13;"Prešovský kraj";0;0;0;0;NA;108402;0;2020-03-13;0
2020-03-12;"Prešovský kraj";0;0;0;0;NA;108402;0;2020-03-12;0
2020-03-11;"Prešovský kraj";0;0;0;0;NA;108402;0;2020-03-11;0
2020-03-09;"Prešovský kraj";0;0;0;0;NA;108402;0;2020-03-09;0
2020-03-08;"Prešovský kraj";0;0;0;0;NA;108402;0;2020-03-08;0
2020-03-07;"Prešovský kraj";0;0;0;0;NA;108402;0;2020-03-07;0
2020-03-06;"Prešovský kraj";0;0;0;0;NA;108402;0;2020-03-06;0
2021-05-30;"Trenčiansky kraj";0;7883;16;7899;53007;97392;16;2021-05-30;97392
2021-05-29;"Trenčiansky kraj";13;7800;14;7814;NA;97392;27;2021-05-29;97376
2021-05-28;"Trenčiansky kraj";22;8996;24;9020;NA;97392;46;2021-05-28;97349
2021-05-27;"Trenčiansky kraj";6;5204;12;5216;NA;97392;18;2021-05-27;97303
2021-05-26;"Trenčiansky kraj";26;5067;15;5082;NA;97392;41;2021-05-26;97285
2021-05-25;"Trenčiansky kraj";18;6348;25;6373;NA;97392;43;2021-05-25;97244
2021-05-24;"Trenčiansky kraj";19;9107;36;9143;NA;97392;55;2021-05-24;97201
2021-05-23;"Trenčiansky kraj";0;9082;26;9108;NA;97392;26;2021-05-23;97146
2021-05-22;"Trenčiansky kraj";11;11314;21;11335;NA;97392;32;2021-05-22;97120
2021-05-21;"Trenčiansky kraj";23;11571;26;11597;NA;97392;49;2021-05-21;97088
2021-05-20;"Trenčiansky kraj";23;6319;25;6344;NA;97392;48;2021-05-20;97039
2021-05-19;"Trenčiansky kraj";16;5693;32;5725;NA;97392;48;2021-05-19;96991
2021-05-18;"Trenčiansky kraj";26;7753;28;7781;NA;97392;54;2021-05-18;96943
2021-05-17;"Trenčiansky kraj";37;7669;43;7712;NA;97392;80;2021-05-17;96889
2021-05-16;"Trenčiansky kraj";25;15615;41;15656;NA;97392;66;2021-05-16;96809
2021-05-15;"Trenčiansky kraj";3;21237;32;21269;NA;97392;35;2021-05-15;96743
2021-05-14;"Trenčiansky kraj";41;18666;42;18708;NA;97392;83;2021-05-14;96708
2021-05-13;"Trenčiansky kraj";41;8194;24;8218;NA;97392;65;2021-05-13;96625
2021-05-12;"Trenčiansky kraj";41;7899;34;7933;NA;97392;75;2021-05-12;96560
2021-05-11;"Trenčiansky kraj";66;10006;29;10035;NA;97392;95;2021-05-11;96485
2021-05-10;"Trenčiansky kraj";48;13974;58;14032;NA;97392;106;2021-05-10;96390
2021-05-09;"Trenčiansky kraj";52;17737;39;17776;NA;97392;91;2021-05-09;96284
2021-05-08;"Trenčiansky kraj";3;24000;33;24033;NA;97392;36;2021-05-08;96193
2021-05-07;"Trenčiansky kraj";45;23538;56;23594;NA;97392;101;2021-05-07;96157
2021-05-06;"Trenčiansky kraj";26;10777;44;10821;NA;97392;70;2021-05-06;96056
2021-05-05;"Trenčiansky kraj";73;9374;41;9415;NA;97392;114;2021-05-05;95986
2021-05-04;"Trenčiansky kraj";55;12732;53;12785;NA;97392;108;2021-05-04;95872
2021-05-03;"Trenčiansky kraj";60;15330;51;15381;NA;97392;111;2021-05-03;95764
2021-05-02;"Trenčiansky kraj";0;31152;65;31217;NA;97392;65;2021-05-02;95653
2021-05-01;"Trenčiansky kraj";71;56982;60;57042;NA;97392;131;2021-05-01;95588
2021-04-30;"Trenčiansky kraj";77;0;0;0;NA;97392;77;2021-04-30;95457
2021-04-29;"Trenčiansky kraj";49;0;0;0;NA;97392;49;2021-04-29;95380
2021-04-28;"Trenčiansky kraj";79;0;0;0;NA;97392;79;2021-04-28;95331
2021-04-27;"Trenčiansky kraj";107;0;0;0;NA;97392;107;2021-04-27;95252
2021-04-26;"Trenčiansky kraj";52;0;0;0;NA;97392;52;2021-04-26;95145
2021-04-25;"Trenčiansky kraj";0;0;0;0;NA;97392;0;2021-04-25;95093
2021-04-24;"Trenčiansky kraj";76;0;0;0;NA;97392;76;2021-04-24;95093
2021-04-23;"Trenčiansky kraj";143;0;0;0;NA;97392;143;2021-04-23;95017
2021-04-22;"Trenčiansky kraj";71;0;0;0;NA;97392;71;2021-04-22;94874
2021-04-21;"Trenčiansky kraj";79;0;0;0;NA;97392;79;2021-04-21;94803
2021-04-20;"Trenčiansky kraj";142;0;0;0;NA;97392;142;2021-04-20;94724
2021-04-19;"Trenčiansky kraj";102;0;0;0;NA;97392;102;2021-04-19;94582
2021-04-18;"Trenčiansky kraj";3;0;0;0;NA;97392;3;2021-04-18;94480
2021-04-17;"Trenčiansky kraj";77;0;0;0;NA;97392;77;2021-04-17;94477
2021-04-16;"Trenčiansky kraj";100;0;0;0;NA;97392;100;2021-04-16;94400
2021-04-15;"Trenčiansky kraj";71;0;0;0;NA;97392;71;2021-04-15;94300
2021-04-14;"Trenčiansky kraj";135;0;0;0;NA;97392;135;2021-04-14;94229
2021-04-13;"Trenčiansky kraj";189;0;0;0;NA;97392;189;2021-04-13;94094
2021-04-12;"Trenčiansky kraj";97;0;0;0;NA;97392;97;2021-04-12;93905
2021-04-11;"Trenčiansky kraj";1;0;0;0;NA;97392;1;2021-04-11;93808
2021-04-10;"Trenčiansky kraj";81;0;0;0;NA;97392;81;2021-04-10;93807
2021-04-09;"Trenčiansky kraj";120;0;0;0;NA;97392;120;2021-04-09;93726
2021-04-08;"Trenčiansky kraj";112;0;0;0;NA;97392;112;2021-04-08;93606
2021-04-07;"Trenčiansky kraj";204;0;0;0;NA;97392;204;2021-04-07;93494
2021-04-06;"Trenčiansky kraj";157;0;0;0;NA;97392;157;2021-04-06;93290
2021-04-05;"Trenčiansky kraj";15;0;0;0;NA;97392;15;2021-04-05;93133
2021-04-04;"Trenčiansky kraj";2;0;0;0;NA;97392;2;2021-04-04;93118
2021-04-03;"Trenčiansky kraj";86;0;0;0;NA;97392;86;2021-04-03;93116
2021-04-02;"Trenčiansky kraj";126;0;0;0;NA;97392;126;2021-04-02;93030
2021-04-01;"Trenčiansky kraj";159;0;0;0;NA;97392;159;2021-04-01;92904
2021-03-31;"Trenčiansky kraj";198;20100;130;20230;NA;97392;328;2021-03-31;92745
2021-03-30;"Trenčiansky kraj";272;17304;136;17440;NA;97392;408;2021-03-30;92417
2021-03-29;"Trenčiansky kraj";142;19479;170;19649;NA;97392;312;2021-03-29;92009
2021-03-28;"Trenčiansky kraj";3;34759;116;34875;NA;97392;119;2021-03-28;91697
2021-03-27;"Trenčiansky kraj";130;77314;293;77607;NA;97392;423;2021-03-27;91578
2021-03-26;"Trenčiansky kraj";211;35092;157;35249;NA;97392;368;2021-03-26;91155
2021-03-25;"Trenčiansky kraj";184;16579;176;16755;NA;97392;360;2021-03-25;90787
2021-03-24;"Trenčiansky kraj";259;13099;171;13270;NA;97392;430;2021-03-24;90427
2021-03-23;"Trenčiansky kraj";349;17588;174;17762;NA;97392;523;2021-03-23;89997
2021-03-22;"Trenčiansky kraj";141;21118;213;21331;NA;97392;354;2021-03-22;89474
2021-03-21;"Trenčiansky kraj";85;32711;164;32875;NA;97392;249;2021-03-21;89120
2021-03-20;"Trenčiansky kraj";128;80035;322;80357;NA;97392;450;2021-03-20;88871
2021-03-19;"Trenčiansky kraj";231;34784;232;35016;NA;97392;463;2021-03-19;88421
2021-03-18;"Trenčiansky kraj";262;16105;178;16283;NA;97392;440;2021-03-18;87958
2021-03-17;"Trenčiansky kraj";366;13436;163;13599;NA;97392;529;2021-03-17;87518
2021-03-16;"Trenčiansky kraj";450;15281;241;15522;NA;97392;691;2021-03-16;86989
2021-03-15;"Trenčiansky kraj";162;21235;261;21496;NA;97392;423;2021-03-15;86298
2021-03-14;"Trenčiansky kraj";42;33892;233;34125;NA;97392;275;2021-03-14;85875
2021-03-13;"Trenčiansky kraj";270;79187;453;79640;NA;97392;723;2021-03-13;85600
2021-03-12;"Trenčiansky kraj";366;34787;307;35094;NA;97392;673;2021-03-12;84877
2021-03-11;"Trenčiansky kraj";302;15557;213;15770;NA;97392;515;2021-03-11;84204
2021-03-10;"Trenčiansky kraj";402;13585;237;13822;NA;97392;639;2021-03-10;83689
2021-03-09;"Trenčiansky kraj";586;17982;285;18267;NA;97392;871;2021-03-09;83050
2021-03-08;"Trenčiansky kraj";174;21704;363;22067;NA;97392;537;2021-03-08;82179
2021-03-07;"Trenčiansky kraj";4;33991;318;34309;NA;97392;322;2021-03-07;81642
2021-03-06;"Trenčiansky kraj";260;79661;529;80190;NA;97392;789;2021-03-06;81320
2021-03-05;"Trenčiansky kraj";326;32946;416;33362;NA;97392;742;2021-03-05;80531
2021-03-04;"Trenčiansky kraj";323;16820;315;17135;NA;97392;638;2021-03-04;79789
2021-03-03;"Trenčiansky kraj";413;13953;346;14299;NA;97392;759;2021-03-03;79151
2021-03-02;"Trenčiansky kraj";612;17797;344;18141;NA;97392;956;2021-03-02;78392
2021-03-01;"Trenčiansky kraj";217;21127;445;21572;NA;97392;662;2021-03-01;77436
2021-02-28;"Trenčiansky kraj";45;30238;376;30614;NA;97392;421;2021-02-28;76774
2021-02-27;"Trenčiansky kraj";277;78735;686;79421;NA;97392;963;2021-02-27;76353
2021-02-26;"Trenčiansky kraj";420;32932;435;33367;NA;97392;855;2021-02-26;75390
2021-02-25;"Trenčiansky kraj";424;14029;328;14357;NA;97392;752;2021-02-25;74535
2021-02-24;"Trenčiansky kraj";427;12003;399;12402;NA;97392;826;2021-02-24;73783
2021-02-23;"Trenčiansky kraj";577;14904;390;15294;NA;97392;967;2021-02-23;72957
2021-02-22;"Trenčiansky kraj";160;19969;468;20437;NA;97392;628;2021-02-22;71990
2021-02-21;"Trenčiansky kraj";64;29478;392;29870;NA;97392;456;2021-02-21;71362
2021-02-20;"Trenčiansky kraj";274;77840;745;78585;NA;97392;1019;2021-02-20;70906
2021-02-19;"Trenčiansky kraj";272;30245;520;30765;NA;97392;792;2021-02-19;69887
2021-02-18;"Trenčiansky kraj";355;14378;410;14788;NA;97392;765;2021-02-18;69095
2021-02-17;"Trenčiansky kraj";363;11413;376;11789;NA;97392;739;2021-02-17;68330
2021-02-16;"Trenčiansky kraj";488;17761;406;18167;NA;97392;894;2021-02-16;67591
2021-02-15;"Trenčiansky kraj";151;21846;463;22309;NA;97392;614;2021-02-15;66697
2021-02-14;"Trenčiansky kraj";2;31255;324;31579;NA;97392;326;2021-02-14;66083
2021-02-13;"Trenčiansky kraj";274;63006;522;63528;NA;97392;796;2021-02-13;65757
2021-02-12;"Trenčiansky kraj";276;27966;412;28378;NA;97392;688;2021-02-12;64961
2021-02-11;"Trenčiansky kraj";291;11566;323;11889;NA;97392;614;2021-02-11;64273
2021-02-10;"Trenčiansky kraj";304;11402;317;11719;NA;97392;621;2021-02-10;63659
2021-02-09;"Trenčiansky kraj";514;18401;360;18761;NA;97392;874;2021-02-09;63038
2021-02-08;"Trenčiansky kraj";182;26972;430;27402;NA;97392;612;2021-02-08;62164
2021-02-07;"Trenčiansky kraj";31;36772;341;37113;NA;97392;372;2021-02-07;61552
2021-02-06;"Trenčiansky kraj";216;63931;560;64491;NA;97392;776;2021-02-06;61180
2021-02-05;"Trenčiansky kraj";202;18154;367;18521;NA;97392;569;2021-02-05;60404
2021-02-04;"Trenčiansky kraj";266;7248;311;7559;NA;97392;577;2021-02-04;59835
2021-02-03;"Trenčiansky kraj";162;6677;320;6997;NA;97392;482;2021-02-03;59258
2021-02-02;"Trenčiansky kraj";347;8058;380;8438;NA;97392;727;2021-02-02;58776
2021-02-01;"Trenčiansky kraj";167;8917;311;9228;NA;97392;478;2021-02-01;58049
2021-01-31;"Trenčiansky kraj";7;19103;159;19262;NA;97392;166;2021-01-31;57571
2021-01-30;"Trenčiansky kraj";228;38167;332;38499;NA;97392;560;2021-01-30;57405
2021-01-29;"Trenčiansky kraj";214;7586;235;7821;NA;97392;449;2021-01-29;56845
2021-01-28;"Trenčiansky kraj";307;5442;158;5600;NA;97392;465;2021-01-28;56396
2021-01-27;"Trenčiansky kraj";166;4842;181;5023;NA;97392;347;2021-01-27;55931
2021-01-26;"Trenčiansky kraj";303;14585;250;14835;NA;97392;553;2021-01-26;55584
2021-01-25;"Trenčiansky kraj";160;24302;207;24509;NA;97392;367;2021-01-25;55031
2021-01-24;"Trenčiansky kraj";51;38369;282;38651;NA;97392;333;2021-01-24;54664
2021-01-23;"Trenčiansky kraj";206;114125;749;114874;NA;97392;955;2021-01-23;54331
2021-01-22;"Trenčiansky kraj";148;21833;242;22075;NA;97392;390;2021-01-22;53376
2021-01-21;"Trenčiansky kraj";143;8582;166;8748;NA;97392;309;2021-01-21;52986
2021-01-20;"Trenčiansky kraj";181;8189;227;8416;NA;97392;408;2021-01-20;52677
2021-01-19;"Trenčiansky kraj";363;6618;262;6880;NA;97392;625;2021-01-19;52269
2021-01-18;"Trenčiansky kraj";72;4970;321;5291;NA;97392;393;2021-01-18;51644
2021-01-17;"Trenčiansky kraj";124;156;11;167;NA;97392;135;2021-01-17;51251
2021-01-16;"Trenčiansky kraj";39;1288;53;1341;NA;97392;92;2021-01-16;51116
2021-01-15;"Trenčiansky kraj";264;4029;218;4247;NA;97392;482;2021-01-15;51024
2021-01-14;"Trenčiansky kraj";275;3193;189;3382;NA;97392;464;2021-01-14;50542
2021-01-13;"Trenčiansky kraj";222;3893;215;4108;NA;97392;437;2021-01-13;50078
2021-01-12;"Trenčiansky kraj";508;4604;261;4865;NA;97392;769;2021-01-12;49641
2021-01-11;"Trenčiansky kraj";142;4367;354;4721;NA;97392;496;2021-01-11;48872
2021-01-10;"Trenčiansky kraj";89;4969;77;5046;NA;97392;166;2021-01-10;48376
2021-01-09;"Trenčiansky kraj";276;8280;128;8408;NA;97392;404;2021-01-09;48210
2021-01-08;"Trenčiansky kraj";489;6434;484;6918;NA;97392;973;2021-01-08;47806
2021-01-07;"Trenčiansky kraj";420;6138;577;6715;NA;97392;997;2021-01-07;46833
2021-01-06;"Trenčiansky kraj";221;1021;64;1085;NA;97392;285;2021-01-06;45836
2021-01-05;"Trenčiansky kraj";669;5753;706;6459;NA;97392;1375;2021-01-05;45551
2021-01-04;"Trenčiansky kraj";337;5248;782;6030;NA;97392;1119;2021-01-04;44176
2021-01-03;"Trenčiansky kraj";38;114;15;129;NA;97392;53;2021-01-03;43057
2021-01-02;"Trenčiansky kraj";129;196;23;219;NA;97392;152;2021-01-02;43004
2021-01-01;"Trenčiansky kraj";329;347;23;370;NA;97392;352;2021-01-01;42852
2020-12-31;"Trenčiansky kraj";597;4943;557;5500;NA;97392;1154;2020-12-31;42500
2020-12-30;"Trenčiansky kraj";836;7012;762;7774;NA;97392;1598;2020-12-30;41346
2020-12-29;"Trenčiansky kraj";459;6191;1018;7209;NA;97392;1477;2020-12-29;39748
2020-12-28;"Trenčiansky kraj";258;4195;777;4972;NA;97392;1035;2020-12-28;38271
2020-12-27;"Trenčiansky kraj";5;208;36;244;NA;97392;41;2020-12-27;37236
2020-12-26;"Trenčiansky kraj";174;74;10;84;NA;97392;184;2020-12-26;37195
2020-12-25;"Trenčiansky kraj";251;325;47;372;NA;97392;298;2020-12-25;37011
2020-12-24;"Trenčiansky kraj";552;2194;256;2450;NA;97392;808;2020-12-24;36713
2020-12-23;"Trenčiansky kraj";421;6552;661;7213;NA;97392;1082;2020-12-23;35905
2020-12-22;"Trenčiansky kraj";673;5760;694;6454;NA;97392;1367;2020-12-22;34823
2020-12-21;"Trenčiansky kraj";248;13321;956;14277;NA;97392;1204;2020-12-21;33456
2020-12-20;"Trenčiansky kraj";238;12504;292;12796;NA;97392;530;2020-12-20;32252
2020-12-19;"Trenčiansky kraj";341;1611;150;1761;NA;97392;491;2020-12-19;31722
2020-12-18;"Trenčiansky kraj";521;5199;615;5814;NA;97392;1136;2020-12-18;31231
2020-12-17;"Trenčiansky kraj";670;3843;524;4367;NA;97392;1194;2020-12-17;30095
2020-12-16;"Trenčiansky kraj";461;4464;647;5111;NA;97392;1108;2020-12-16;28901
2020-12-15;"Trenčiansky kraj";595;3805;670;4475;NA;97392;1265;2020-12-15;27793
2020-12-14;"Trenčiansky kraj";318;3194;613;3807;NA;97392;931;2020-12-14;26528
2020-12-13;"Trenčiansky kraj";77;49;6;55;NA;97392;83;2020-12-13;25597
2020-12-12;"Trenčiansky kraj";314;1191;132;1323;NA;97392;446;2020-12-12;25514
2020-12-11;"Trenčiansky kraj";751;4066;479;4545;NA;97392;1230;2020-12-11;25068
2020-12-10;"Trenčiansky kraj";271;3354;473;3827;NA;97392;744;2020-12-10;23838
2020-12-09;"Trenčiansky kraj";508;3788;466;4254;NA;97392;974;2020-12-09;23094
2020-12-08;"Trenčiansky kraj";546;3440;522;3962;NA;97392;1068;2020-12-08;22120
2020-12-07;"Trenčiansky kraj";258;3832;468;4300;NA;97392;726;2020-12-07;21052
2020-12-06;"Trenčiansky kraj";114;187;11;198;NA;97392;125;2020-12-06;20326
2020-12-05;"Trenčiansky kraj";223;616;56;672;NA;97392;279;2020-12-05;20201
2020-12-04;"Trenčiansky kraj";253;2989;273;3262;NA;97392;526;2020-12-04;19922
2020-12-03;"Trenčiansky kraj";503;1739;179;1918;NA;97392;682;2020-12-03;19396
2020-12-02;"Trenčiansky kraj";418;1887;232;2119;NA;97392;650;2020-12-02;18714
2020-12-01;"Trenčiansky kraj";321;5633;317;5950;NA;97392;638;2020-12-01;18064
2020-11-30;"Trenčiansky kraj";167;11424;491;11915;NA;97392;658;2020-11-30;17426
2020-11-29;"Trenčiansky kraj";29;30;5;35;NA;97392;34;2020-11-29;16768
2020-11-28;"Trenčiansky kraj";202;1051;93;1144;NA;97392;295;2020-11-28;16734
2020-11-27;"Trenčiansky kraj";330;1888;186;2074;NA;97392;516;2020-11-27;16439
2020-11-26;"Trenčiansky kraj";395;1252;122;1374;NA;97392;517;2020-11-26;15923
2020-11-25;"Trenčiansky kraj";322;1444;160;1604;NA;97392;482;2020-11-25;15406
2020-11-24;"Trenčiansky kraj";348;2553;308;2861;NA;97392;656;2020-11-24;14924
2020-11-23;"Trenčiansky kraj";159;1186;122;1308;NA;97392;281;2020-11-23;14268
2020-11-22;"Trenčiansky kraj";26;30;7;37;NA;97392;33;2020-11-22;13987
2020-11-21;"Trenčiansky kraj";255;1376;69;1445;NA;97392;324;2020-11-21;13954
2020-11-20;"Trenčiansky kraj";316;861;93;954;NA;97392;409;2020-11-20;13630
2020-11-19;"Trenčiansky kraj";316;740;113;853;NA;97392;429;2020-11-19;13221
2020-11-18;"Trenčiansky kraj";233;379;66;445;NA;97392;299;2020-11-18;12792
2020-11-17;"Trenčiansky kraj";222;106;15;121;NA;97392;237;2020-11-17;12493
2020-11-16;"Trenčiansky kraj";245;236;45;281;NA;97392;290;2020-11-16;12256
2020-11-15;"Trenčiansky kraj";109;29;6;35;NA;97392;115;2020-11-15;11966
2020-11-14;"Trenčiansky kraj";190;74;11;85;NA;97392;201;2020-11-14;11851
2020-11-13;"Trenčiansky kraj";308;131;13;144;NA;97392;321;2020-11-13;11650
2020-11-12;"Trenčiansky kraj";324;124;5;129;NA;97392;329;2020-11-12;11329
2020-11-11;"Trenčiansky kraj";366;113;10;123;NA;97392;376;2020-11-11;11000
2020-11-10;"Trenčiansky kraj";277;106;6;112;NA;97392;283;2020-11-10;10624
2020-11-09;"Trenčiansky kraj";115;1407;48;1455;NA;97392;163;2020-11-09;10341
2020-11-08;"Trenčiansky kraj";81;1271;8;1279;NA;97392;89;2020-11-08;10178
2020-11-07;"Trenčiansky kraj";319;3662;59;3721;NA;97392;378;2020-11-07;10089
2020-11-06;"Trenčiansky kraj";383;6893;84;6977;NA;97392;467;2020-11-06;9711
2020-11-05;"Trenčiansky kraj";399;98;15;113;NA;97392;414;2020-11-05;9244
2020-11-04;"Trenčiansky kraj";370;91;9;100;NA;97392;379;2020-11-04;8830
2020-11-03;"Trenčiansky kraj";575;97;8;105;NA;97392;583;2020-11-03;8451
2020-11-02;"Trenčiansky kraj";197;1833;68;1901;NA;97392;265;2020-11-02;7868
2020-11-01;"Trenčiansky kraj";257;808;24;832;NA;97392;281;2020-11-01;7603
2020-10-31;"Trenčiansky kraj";332;4719;82;4801;NA;97392;414;2020-10-31;7322
2020-10-30;"Trenčiansky kraj";299;5283;102;5385;NA;97392;401;2020-10-30;6908
2020-10-29;"Trenčiansky kraj";496;764;68;832;NA;97392;564;2020-10-29;6507
2020-10-28;"Trenčiansky kraj";269;192;33;225;NA;97392;302;2020-10-28;5943
2020-10-27;"Trenčiansky kraj";473;127;27;154;NA;97392;500;2020-10-27;5641
2020-10-26;"Trenčiansky kraj";177;107;36;143;NA;97392;213;2020-10-26;5141
2020-10-25;"Trenčiansky kraj";138;9;5;14;NA;97392;143;2020-10-25;4928
2020-10-24;"Trenčiansky kraj";395;128;6;134;NA;97392;401;2020-10-24;4785
2020-10-23;"Trenčiansky kraj";301;154;8;162;NA;97392;309;2020-10-23;4384
2020-10-22;"Trenčiansky kraj";273;82;12;94;NA;97392;285;2020-10-22;4075
2020-10-21;"Trenčiansky kraj";183;53;9;62;NA;97392;192;2020-10-21;3790
2020-10-20;"Trenčiansky kraj";212;47;6;53;NA;97392;218;2020-10-20;3598
2020-10-19;"Trenčiansky kraj";41;83;25;108;NA;97392;66;2020-10-19;3380
2020-10-18;"Trenčiansky kraj";104;0;0;0;NA;97392;104;2020-10-18;3314
2020-10-17;"Trenčiansky kraj";157;0;0;0;NA;97392;157;2020-10-17;3210
2020-10-16;"Trenčiansky kraj";225;42;6;48;NA;97392;231;2020-10-16;3053
2020-10-15;"Trenčiansky kraj";255;39;4;43;NA;97392;259;2020-10-15;2822
2020-10-14;"Trenčiansky kraj";162;42;7;49;NA;97392;169;2020-10-14;2563
2020-10-13;"Trenčiansky kraj";124;105;12;117;NA;97392;136;2020-10-13;2394
2020-10-12;"Trenčiansky kraj";55;0;0;0;NA;97392;55;2020-10-12;2258
2020-10-11;"Trenčiansky kraj";73;0;0;0;NA;97392;73;2020-10-11;2203
2020-10-10;"Trenčiansky kraj";180;0;0;0;NA;97392;180;2020-10-10;2130
2020-10-09;"Trenčiansky kraj";198;0;0;0;NA;97392;198;2020-10-09;1950
2020-10-08;"Trenčiansky kraj";115;0;0;0;NA;97392;115;2020-10-08;1752
2020-10-07;"Trenčiansky kraj";75;0;0;0;NA;97392;75;2020-10-07;1637
2020-10-06;"Trenčiansky kraj";72;0;0;0;NA;97392;72;2020-10-06;1562
2020-10-05;"Trenčiansky kraj";32;0;0;0;NA;97392;32;2020-10-05;1490
2020-10-04;"Trenčiansky kraj";37;0;0;0;NA;97392;37;2020-10-04;1458
2020-10-03;"Trenčiansky kraj";79;0;0;0;NA;97392;79;2020-10-03;1421
2020-10-02;"Trenčiansky kraj";69;0;0;0;NA;97392;69;2020-10-02;1342
2020-10-01;"Trenčiansky kraj";58;0;0;0;NA;97392;58;2020-10-01;1273
2020-09-30;"Trenčiansky kraj";76;0;0;0;NA;97392;76;2020-09-30;1215
2020-09-29;"Trenčiansky kraj";43;0;0;0;NA;97392;43;2020-09-29;1139
2020-09-28;"Trenčiansky kraj";7;0;0;0;NA;97392;7;2020-09-28;1096
2020-09-27;"Trenčiansky kraj";12;0;0;0;NA;97392;12;2020-09-27;1089
2020-09-26;"Trenčiansky kraj";37;0;0;0;NA;97392;37;2020-09-26;1077
2020-09-25;"Trenčiansky kraj";72;0;0;0;NA;97392;72;2020-09-25;1040
2020-09-24;"Trenčiansky kraj";41;0;0;0;NA;97392;41;2020-09-24;968
2020-09-23;"Trenčiansky kraj";32;0;0;0;NA;97392;32;2020-09-23;927
2020-09-22;"Trenčiansky kraj";26;0;0;0;NA;97392;26;2020-09-22;895
2020-09-21;"Trenčiansky kraj";23;0;0;0;NA;97392;23;2020-09-21;869
2020-09-20;"Trenčiansky kraj";21;0;0;0;NA;97392;21;2020-09-20;846
2020-09-19;"Trenčiansky kraj";20;0;0;0;NA;97392;20;2020-09-19;825
2020-09-18;"Trenčiansky kraj";41;0;0;0;NA;97392;41;2020-09-18;805
2020-09-17;"Trenčiansky kraj";20;0;0;0;NA;97392;20;2020-09-17;764
2020-09-16;"Trenčiansky kraj";14;0;0;0;NA;97392;14;2020-09-16;744
2020-09-15;"Trenčiansky kraj";8;0;0;0;NA;97392;8;2020-09-15;730
2020-09-14;"Trenčiansky kraj";5;0;0;0;NA;97392;5;2020-09-14;722
2020-09-13;"Trenčiansky kraj";12;0;0;0;NA;97392;12;2020-09-13;717
2020-09-12;"Trenčiansky kraj";2;0;0;0;NA;97392;2;2020-09-12;705
2020-09-11;"Trenčiansky kraj";27;0;0;0;NA;97392;27;2020-09-11;703
2020-09-10;"Trenčiansky kraj";15;0;0;0;NA;97392;15;2020-09-10;676
2020-09-09;"Trenčiansky kraj";11;0;0;0;NA;97392;11;2020-09-09;661
2020-09-08;"Trenčiansky kraj";12;0;0;0;NA;97392;12;2020-09-08;650
2020-09-07;"Trenčiansky kraj";6;0;0;0;NA;97392;6;2020-09-07;638
2020-09-06;"Trenčiansky kraj";1;0;0;0;NA;97392;1;2020-09-06;632
2020-09-05;"Trenčiansky kraj";3;0;0;0;NA;97392;3;2020-09-05;631
2020-09-04;"Trenčiansky kraj";9;0;0;0;NA;97392;9;2020-09-04;628
2020-09-03;"Trenčiansky kraj";10;0;0;0;NA;97392;10;2020-09-03;619
2020-09-02;"Trenčiansky kraj";5;0;0;0;NA;97392;5;2020-09-02;609
2020-09-01;"Trenčiansky kraj";1;0;0;0;NA;97392;1;2020-09-01;604
2020-08-31;"Trenčiansky kraj";12;0;0;0;NA;97392;12;2020-08-31;603
2020-08-30;"Trenčiansky kraj";0;0;0;0;NA;97392;0;2020-08-30;591
2020-08-29;"Trenčiansky kraj";1;0;0;0;NA;97392;1;2020-08-29;591
2020-08-28;"Trenčiansky kraj";12;0;0;0;NA;97392;12;2020-08-28;590
2020-08-27;"Trenčiansky kraj";10;0;0;0;NA;97392;10;2020-08-27;578
2020-08-26;"Trenčiansky kraj";15;0;0;0;NA;97392;15;2020-08-26;568
2020-08-25;"Trenčiansky kraj";12;0;0;0;NA;97392;12;2020-08-25;553
2020-08-24;"Trenčiansky kraj";4;0;0;0;NA;97392;4;2020-08-24;541
2020-08-23;"Trenčiansky kraj";5;0;0;0;NA;97392;5;2020-08-23;537
2020-08-22;"Trenčiansky kraj";6;0;0;0;NA;97392;6;2020-08-22;532
2020-08-21;"Trenčiansky kraj";6;0;0;0;NA;97392;6;2020-08-21;526
2020-08-20;"Trenčiansky kraj";20;0;0;0;NA;97392;20;2020-08-20;520
2020-08-19;"Trenčiansky kraj";17;0;0;0;NA;97392;17;2020-08-19;500
2020-08-18;"Trenčiansky kraj";9;0;0;0;NA;97392;9;2020-08-18;483
2020-08-17;"Trenčiansky kraj";4;0;0;0;NA;97392;4;2020-08-17;474
2020-08-16;"Trenčiansky kraj";0;0;0;0;NA;97392;0;2020-08-16;470
2020-08-15;"Trenčiansky kraj";9;0;0;0;NA;97392;9;2020-08-15;470
2020-08-14;"Trenčiansky kraj";15;0;0;0;NA;97392;15;2020-08-14;461
2020-08-13;"Trenčiansky kraj";23;0;0;0;NA;97392;23;2020-08-13;446
2020-08-12;"Trenčiansky kraj";6;0;0;0;NA;97392;6;2020-08-12;423
2020-08-11;"Trenčiansky kraj";7;0;0;0;NA;97392;7;2020-08-11;417
2020-08-10;"Trenčiansky kraj";9;0;0;0;NA;97392;9;2020-08-10;410
2020-08-09;"Trenčiansky kraj";1;0;0;0;NA;97392;1;2020-08-09;401
2020-08-08;"Trenčiansky kraj";4;0;0;0;NA;97392;4;2020-08-08;400
2020-08-07;"Trenčiansky kraj";4;0;0;0;NA;97392;4;2020-08-07;396
2020-08-06;"Trenčiansky kraj";13;0;0;0;NA;97392;13;2020-08-06;392
2020-08-05;"Trenčiansky kraj";39;0;0;0;NA;97392;39;2020-08-05;379
2020-08-04;"Trenčiansky kraj";9;0;0;0;NA;97392;9;2020-08-04;340
2020-08-03;"Trenčiansky kraj";0;0;0;0;NA;97392;0;2020-08-03;331
2020-08-02;"Trenčiansky kraj";2;0;0;0;NA;97392;2;2020-08-02;331
2020-08-01;"Trenčiansky kraj";6;0;0;0;NA;97392;6;2020-08-01;329
2020-07-31;"Trenčiansky kraj";16;0;0;0;NA;97392;16;2020-07-31;323
2020-07-30;"Trenčiansky kraj";4;0;0;0;NA;97392;4;2020-07-30;307
2020-07-29;"Trenčiansky kraj";5;0;0;0;NA;97392;5;2020-07-29;303
2020-07-28;"Trenčiansky kraj";11;0;0;0;NA;97392;11;2020-07-28;298
2020-07-27;"Trenčiansky kraj";4;0;0;0;NA;97392;4;2020-07-27;287
2020-07-26;"Trenčiansky kraj";1;0;0;0;NA;97392;1;2020-07-26;283
2020-07-25;"Trenčiansky kraj";7;0;0;0;NA;97392;7;2020-07-25;282
2020-07-24;"Trenčiansky kraj";5;0;0;0;NA;97392;5;2020-07-24;275
2020-07-23;"Trenčiansky kraj";10;0;0;0;NA;97392;10;2020-07-23;270
2020-07-22;"Trenčiansky kraj";11;0;0;0;NA;97392;11;2020-07-22;260
2020-07-21;"Trenčiansky kraj";6;0;0;0;NA;97392;6;2020-07-21;249
2020-07-20;"Trenčiansky kraj";13;0;0;0;NA;97392;13;2020-07-20;243
2020-07-19;"Trenčiansky kraj";0;0;0;0;NA;97392;0;2020-07-19;230
2020-07-18;"Trenčiansky kraj";0;0;0;0;NA;97392;0;2020-07-18;230
2020-07-17;"Trenčiansky kraj";1;0;0;0;NA;97392;1;2020-07-17;230
2020-07-16;"Trenčiansky kraj";0;0;0;0;NA;97392;0;2020-07-16;229
2020-07-15;"Trenčiansky kraj";2;0;0;0;NA;97392;2;2020-07-15;229
2020-07-14;"Trenčiansky kraj";8;0;0;0;NA;97392;8;2020-07-14;227
2020-07-13;"Trenčiansky kraj";1;0;0;0;NA;97392;1;2020-07-13;219
2020-07-12;"Trenčiansky kraj";0;0;0;0;NA;97392;0;2020-07-12;218
2020-07-11;"Trenčiansky kraj";0;0;0;0;NA;97392;0;2020-07-11;218
2020-07-10;"Trenčiansky kraj";3;0;0;0;NA;97392;3;2020-07-10;218
2020-07-09;"Trenčiansky kraj";2;0;0;0;NA;97392;2;2020-07-09;215
2020-07-08;"Trenčiansky kraj";1;0;0;0;NA;97392;1;2020-07-08;213
2020-07-07;"Trenčiansky kraj";9;0;0;0;NA;97392;9;2020-07-07;212
2020-07-06;"Trenčiansky kraj";1;0;0;0;NA;97392;1;2020-07-06;203
2020-07-05;"Trenčiansky kraj";1;0;0;0;NA;97392;1;2020-07-05;202
2020-07-04;"Trenčiansky kraj";0;0;0;0;NA;97392;0;2020-07-04;201
2020-07-03;"Trenčiansky kraj";2;0;0;0;NA;97392;2;2020-07-03;201
2020-07-02;"Trenčiansky kraj";10;0;0;0;NA;97392;10;2020-07-02;199
2020-07-01;"Trenčiansky kraj";1;0;0;0;NA;97392;1;2020-07-01;189
2020-06-30;"Trenčiansky kraj";6;0;0;0;NA;97392;6;2020-06-30;188
2020-06-29;"Trenčiansky kraj";1;0;0;0;NA;97392;1;2020-06-29;182
2020-06-28;"Trenčiansky kraj";0;0;0;0;NA;97392;0;2020-06-28;181
2020-06-27;"Trenčiansky kraj";0;0;0;0;NA;97392;0;2020-06-27;181
2020-06-26;"Trenčiansky kraj";0;0;0;0;NA;97392;0;2020-06-26;181
2020-06-25;"Trenčiansky kraj";2;0;0;0;NA;97392;2;2020-06-25;181
2020-06-24;"Trenčiansky kraj";1;0;0;0;NA;97392;1;2020-06-24;179
2020-06-23;"Trenčiansky kraj";0;0;0;0;NA;97392;0;2020-06-23;178
2020-06-22;"Trenčiansky kraj";0;0;0;0;NA;97392;0;2020-06-22;178
2020-06-21;"Trenčiansky kraj";0;0;0;0;NA;97392;0;2020-06-21;178
2020-06-20;"Trenčiansky kraj";0;0;0;0;NA;97392;0;2020-06-20;178
2020-06-19;"Trenčiansky kraj";0;0;0;0;NA;97392;0;2020-06-19;178
2020-06-18;"Trenčiansky kraj";0;0;0;0;NA;97392;0;2020-06-18;178
2020-06-17;"Trenčiansky kraj";0;0;0;0;NA;97392;0;2020-06-17;178
2020-06-16;"Trenčiansky kraj";0;0;0;0;NA;97392;0;2020-06-16;178
2020-06-14;"Trenčiansky kraj";0;0;0;0;NA;97392;0;2020-06-14;178
2020-06-13;"Trenčiansky kraj";0;0;0;0;NA;97392;0;2020-06-13;178
2020-06-12;"Trenčiansky kraj";0;0;0;0;NA;97392;0;2020-06-12;178
2020-06-11;"Trenčiansky kraj";0;0;0;0;NA;97392;0;2020-06-11;178
2020-06-10;"Trenčiansky kraj";1;0;0;0;NA;97392;1;2020-06-10;178
2020-06-09;"Trenčiansky kraj";0;0;0;0;NA;97392;0;2020-06-09;177
2020-06-08;"Trenčiansky kraj";0;0;0;0;NA;97392;0;2020-06-08;177
2020-06-07;"Trenčiansky kraj";0;0;0;0;NA;97392;0;2020-06-07;177
2020-06-05;"Trenčiansky kraj";0;0;0;0;NA;97392;0;2020-06-05;177
2020-06-03;"Trenčiansky kraj";0;0;0;0;NA;97392;0;2020-06-03;177
2020-06-02;"Trenčiansky kraj";0;0;0;0;NA;97392;0;2020-06-02;177
2020-05-31;"Trenčiansky kraj";0;0;0;0;NA;97392;0;2020-05-31;177
2020-05-29;"Trenčiansky kraj";0;0;0;0;NA;97392;0;2020-05-29;177
2020-05-27;"Trenčiansky kraj";2;0;0;0;NA;97392;2;2020-05-27;177
2020-05-26;"Trenčiansky kraj";0;0;0;0;NA;97392;0;2020-05-26;175
2020-05-25;"Trenčiansky kraj";0;0;0;0;NA;97392;0;2020-05-25;175
2020-05-24;"Trenčiansky kraj";0;0;0;0;NA;97392;0;2020-05-24;175
2020-05-23;"Trenčiansky kraj";0;0;0;0;NA;97392;0;2020-05-23;175
2020-05-22;"Trenčiansky kraj";0;0;0;0;NA;97392;0;2020-05-22;175
2020-05-21;"Trenčiansky kraj";0;0;0;0;NA;97392;0;2020-05-21;175
2020-05-20;"Trenčiansky kraj";0;0;0;0;NA;97392;0;2020-05-20;175
2020-05-19;"Trenčiansky kraj";0;0;0;0;NA;97392;0;2020-05-19;175
2020-05-17;"Trenčiansky kraj";0;0;0;0;NA;97392;0;2020-05-17;175
2020-05-16;"Trenčiansky kraj";0;0;0;0;NA;97392;0;2020-05-16;175
2020-05-15;"Trenčiansky kraj";1;0;0;0;NA;97392;1;2020-05-15;175
2020-05-14;"Trenčiansky kraj";2;0;0;0;NA;97392;2;2020-05-14;174
2020-05-13;"Trenčiansky kraj";1;0;0;0;NA;97392;1;2020-05-13;172
2020-05-12;"Trenčiansky kraj";1;0;0;0;NA;97392;1;2020-05-12;171
2020-05-11;"Trenčiansky kraj";3;0;0;0;NA;97392;3;2020-05-11;170
2020-05-09;"Trenčiansky kraj";2;0;0;0;NA;97392;2;2020-05-09;167
2020-05-07;"Trenčiansky kraj";6;0;0;0;NA;97392;6;2020-05-07;165
2020-05-06;"Trenčiansky kraj";0;0;0;0;NA;97392;0;2020-05-06;159
2020-05-05;"Trenčiansky kraj";2;0;0;0;NA;97392;2;2020-05-05;159
2020-05-04;"Trenčiansky kraj";0;0;0;0;NA;97392;0;2020-05-04;157
2020-05-03;"Trenčiansky kraj";0;0;0;0;NA;97392;0;2020-05-03;157
2020-05-02;"Trenčiansky kraj";0;0;0;0;NA;97392;0;2020-05-02;157
2020-05-01;"Trenčiansky kraj";0;0;0;0;NA;97392;0;2020-05-01;157
2020-04-30;"Trenčiansky kraj";0;0;0;0;NA;97392;0;2020-04-30;157
2020-04-29;"Trenčiansky kraj";2;0;0;0;NA;97392;2;2020-04-29;157
2020-04-28;"Trenčiansky kraj";1;0;0;0;NA;97392;1;2020-04-28;155
2020-04-27;"Trenčiansky kraj";0;0;0;0;NA;97392;0;2020-04-27;154
2020-04-26;"Trenčiansky kraj";1;0;0;0;NA;97392;1;2020-04-26;154
2020-04-25;"Trenčiansky kraj";0;0;0;0;NA;97392;0;2020-04-25;153
2020-04-24;"Trenčiansky kraj";0;0;0;0;NA;97392;0;2020-04-24;153
2020-04-23;"Trenčiansky kraj";11;0;0;0;NA;97392;11;2020-04-23;153
2020-04-22;"Trenčiansky kraj";1;0;0;0;NA;97392;1;2020-04-22;142
2020-04-21;"Trenčiansky kraj";11;0;0;0;NA;97392;11;2020-04-21;141
2020-04-20;"Trenčiansky kraj";15;0;0;0;NA;97392;15;2020-04-20;130
2020-04-19;"Trenčiansky kraj";2;0;0;0;NA;97392;2;2020-04-19;115
2020-04-18;"Trenčiansky kraj";3;0;0;0;NA;97392;3;2020-04-18;113
2020-04-17;"Trenčiansky kraj";4;0;0;0;NA;97392;4;2020-04-17;110
2020-04-16;"Trenčiansky kraj";10;0;0;0;NA;97392;10;2020-04-16;106
2020-04-15;"Trenčiansky kraj";4;0;0;0;NA;97392;4;2020-04-15;96
2020-04-14;"Trenčiansky kraj";0;0;0;0;NA;97392;0;2020-04-14;92
2020-04-13;"Trenčiansky kraj";1;0;0;0;NA;97392;1;2020-04-13;92
2020-04-12;"Trenčiansky kraj";2;0;0;0;NA;97392;2;2020-04-12;91
2020-04-11;"Trenčiansky kraj";3;0;0;0;NA;97392;3;2020-04-11;89
2020-04-10;"Trenčiansky kraj";0;0;0;0;NA;97392;0;2020-04-10;86
2020-04-09;"Trenčiansky kraj";0;0;0;0;NA;97392;0;2020-04-09;86
2020-04-08;"Trenčiansky kraj";2;0;0;0;NA;97392;2;2020-04-08;86
2020-04-07;"Trenčiansky kraj";18;0;0;0;NA;97392;18;2020-04-07;84
2020-04-06;"Trenčiansky kraj";0;0;0;0;NA;97392;0;2020-04-06;66
2020-04-05;"Trenčiansky kraj";3;0;0;0;NA;97392;3;2020-04-05;66
2020-04-04;"Trenčiansky kraj";5;0;0;0;NA;97392;5;2020-04-04;63
2020-04-03;"Trenčiansky kraj";4;0;0;0;NA;97392;4;2020-04-03;58
2020-04-02;"Trenčiansky kraj";1;0;0;0;NA;97392;1;2020-04-02;54
2020-04-01;"Trenčiansky kraj";3;0;0;0;NA;97392;3;2020-04-01;53
2020-03-31;"Trenčiansky kraj";1;0;0;0;NA;97392;1;2020-03-31;50
2020-03-30;"Trenčiansky kraj";3;0;0;0;NA;97392;3;2020-03-30;49
2020-03-29;"Trenčiansky kraj";6;0;0;0;NA;97392;6;2020-03-29;46
2020-03-28;"Trenčiansky kraj";9;0;0;0;NA;97392;9;2020-03-28;40
2020-03-27;"Trenčiansky kraj";2;0;0;0;NA;97392;2;2020-03-27;31
2020-03-26;"Trenčiansky kraj";6;0;0;0;NA;97392;6;2020-03-26;29
2020-03-25;"Trenčiansky kraj";3;0;0;0;NA;97392;3;2020-03-25;23
2020-03-24;"Trenčiansky kraj";1;0;0;0;NA;97392;1;2020-03-24;20
2020-03-23;"Trenčiansky kraj";0;0;0;0;NA;97392;0;2020-03-23;19
2020-03-22;"Trenčiansky kraj";0;0;0;0;NA;97392;0;2020-03-22;19
2020-03-21;"Trenčiansky kraj";2;0;0;0;NA;97392;2;2020-03-21;19
2020-03-20;"Trenčiansky kraj";2;0;0;0;NA;97392;2;2020-03-20;17
2020-03-19;"Trenčiansky kraj";8;0;0;0;NA;97392;8;2020-03-19;15
2020-03-18;"Trenčiansky kraj";0;0;0;0;NA;97392;0;2020-03-18;7
2020-03-17;"Trenčiansky kraj";0;0;0;0;NA;97392;0;2020-03-17;7
2020-03-16;"Trenčiansky kraj";1;0;0;0;NA;97392;1;2020-03-16;7
2020-03-15;"Trenčiansky kraj";5;0;0;0;NA;97392;5;2020-03-15;6
2020-03-14;"Trenčiansky kraj";0;0;0;0;NA;97392;0;2020-03-14;1
2020-03-13;"Trenčiansky kraj";0;0;0;0;NA;97392;0;2020-03-13;1
2020-03-12;"Trenčiansky kraj";1;0;0;0;NA;97392;1;2020-03-12;1
2020-03-11;"Trenčiansky kraj";0;0;0;0;NA;97392;0;2020-03-11;0
2020-03-09;"Trenčiansky kraj";0;0;0;0;NA;97392;0;2020-03-09;0
2020-03-08;"Trenčiansky kraj";0;0;0;0;NA;97392;0;2020-03-08;0
2020-03-07;"Trenčiansky kraj";0;0;0;0;NA;97392;0;2020-03-07;0
2020-03-06;"Trenčiansky kraj";0;0;0;0;NA;97392;0;2020-03-06;0
2021-05-30;"Trnavský kraj";0;6746;7;6753;45579;88253;7;2021-05-30;88253
2021-05-29;"Trnavský kraj";11;8964;4;8968;NA;88253;15;2021-05-29;88246
2021-05-28;"Trnavský kraj";14;7160;11;7171;NA;88253;25;2021-05-28;88231
2021-05-27;"Trnavský kraj";22;4601;8;4609;NA;88253;30;2021-05-27;88206
2021-05-26;"Trnavský kraj";6;4869;8;4877;NA;88253;14;2021-05-26;88176
2021-05-25;"Trnavský kraj";19;5022;27;5049;NA;88253;46;2021-05-25;88162
2021-05-24;"Trnavský kraj";15;6520;22;6542;NA;88253;37;2021-05-24;88116
2021-05-23;"Trnavský kraj";0;7920;8;7928;NA;88253;8;2021-05-23;88079
2021-05-22;"Trnavský kraj";13;13098;21;13119;NA;88253;34;2021-05-22;88071
2021-05-21;"Trnavský kraj";16;8520;19;8539;NA;88253;35;2021-05-21;88037
2021-05-20;"Trnavský kraj";15;5509;11;5520;NA;88253;26;2021-05-20;88002
2021-05-19;"Trnavský kraj";18;5430;13;5443;NA;88253;31;2021-05-19;87976
2021-05-18;"Trnavský kraj";26;5768;15;5783;NA;88253;41;2021-05-18;87945
2021-05-17;"Trnavský kraj";17;6259;24;6283;NA;88253;41;2021-05-17;87904
2021-05-16;"Trnavský kraj";10;9984;8;9992;NA;88253;18;2021-05-16;87863
2021-05-15;"Trnavský kraj";11;18525;14;18539;NA;88253;25;2021-05-15;87845
2021-05-14;"Trnavský kraj";34;10279;21;10300;NA;88253;55;2021-05-14;87820
2021-05-13;"Trnavský kraj";26;6913;12;6925;NA;88253;38;2021-05-13;87765
2021-05-12;"Trnavský kraj";34;6621;26;6647;NA;88253;60;2021-05-12;87727
2021-05-11;"Trnavský kraj";32;6393;13;6406;NA;88253;45;2021-05-11;87667
2021-05-10;"Trnavský kraj";58;9135;24;9159;NA;88253;82;2021-05-10;87622
2021-05-09;"Trnavský kraj";21;12571;12;12583;NA;88253;33;2021-05-09;87540
2021-05-08;"Trnavský kraj";4;23028;22;23050;NA;88253;26;2021-05-08;87507
2021-05-07;"Trnavský kraj";26;15397;30;15427;NA;88253;56;2021-05-07;87481
2021-05-06;"Trnavský kraj";22;8397;22;8419;NA;88253;44;2021-05-06;87425
2021-05-05;"Trnavský kraj";34;6273;22;6295;NA;88253;56;2021-05-05;87381
2021-05-04;"Trnavský kraj";51;8539;17;8556;NA;88253;68;2021-05-04;87325
2021-05-03;"Trnavský kraj";20;8954;22;8976;NA;88253;42;2021-05-03;87257
2021-05-02;"Trnavský kraj";0;25657;29;25686;NA;88253;29;2021-05-02;87215
2021-05-01;"Trnavský kraj";30;81347;64;81411;NA;88253;94;2021-05-01;87186
2021-04-30;"Trnavský kraj";45;0;0;0;NA;88253;45;2021-04-30;87092
2021-04-29;"Trnavský kraj";25;0;0;0;NA;88253;25;2021-04-29;87047
2021-04-28;"Trnavský kraj";46;0;0;0;NA;88253;46;2021-04-28;87022
2021-04-27;"Trnavský kraj";54;0;0;0;NA;88253;54;2021-04-27;86976
2021-04-26;"Trnavský kraj";53;0;0;0;NA;88253;53;2021-04-26;86922
2021-04-25;"Trnavský kraj";0;0;0;0;NA;88253;0;2021-04-25;86869
2021-04-24;"Trnavský kraj";46;0;0;0;NA;88253;46;2021-04-24;86869
2021-04-23;"Trnavský kraj";71;0;0;0;NA;88253;71;2021-04-23;86823
2021-04-22;"Trnavský kraj";40;0;0;0;NA;88253;40;2021-04-22;86752
2021-04-21;"Trnavský kraj";60;0;0;0;NA;88253;60;2021-04-21;86712
2021-04-20;"Trnavský kraj";57;0;0;0;NA;88253;57;2021-04-20;86652
2021-04-19;"Trnavský kraj";46;0;0;0;NA;88253;46;2021-04-19;86595
2021-04-18;"Trnavský kraj";7;0;0;0;NA;88253;7;2021-04-18;86549
2021-04-17;"Trnavský kraj";58;0;0;0;NA;88253;58;2021-04-17;86542
2021-04-16;"Trnavský kraj";67;0;0;0;NA;88253;67;2021-04-16;86484
2021-04-15;"Trnavský kraj";65;0;0;0;NA;88253;65;2021-04-15;86417
2021-04-14;"Trnavský kraj";78;0;0;0;NA;88253;78;2021-04-14;86352
2021-04-13;"Trnavský kraj";126;0;0;0;NA;88253;126;2021-04-13;86274
2021-04-12;"Trnavský kraj";40;0;0;0;NA;88253;40;2021-04-12;86148
2021-04-11;"Trnavský kraj";3;0;0;0;NA;88253;3;2021-04-11;86108
2021-04-10;"Trnavský kraj";60;0;0;0;NA;88253;60;2021-04-10;86105
2021-04-09;"Trnavský kraj";95;0;0;0;NA;88253;95;2021-04-09;86045
2021-04-08;"Trnavský kraj";85;0;0;0;NA;88253;85;2021-04-08;85950
2021-04-07;"Trnavský kraj";131;0;0;0;NA;88253;131;2021-04-07;85865
2021-04-06;"Trnavský kraj";92;0;0;0;NA;88253;92;2021-04-06;85734
2021-04-05;"Trnavský kraj";91;0;0;0;NA;88253;91;2021-04-05;85642
2021-04-04;"Trnavský kraj";9;0;0;0;NA;88253;9;2021-04-04;85551
2021-04-03;"Trnavský kraj";29;0;0;0;NA;88253;29;2021-04-03;85542
2021-04-02;"Trnavský kraj";91;0;0;0;NA;88253;91;2021-04-02;85513
2021-04-01;"Trnavský kraj";118;0;0;0;NA;88253;118;2021-04-01;85422
2021-03-31;"Trnavský kraj";140;15819;82;15901;NA;88253;222;2021-03-31;85304
2021-03-30;"Trnavský kraj";182;10482;79;10561;NA;88253;261;2021-03-30;85082
2021-03-29;"Trnavský kraj";126;19249;122;19371;NA;88253;248;2021-03-29;84821
2021-03-28;"Trnavský kraj";26;50792;134;50926;NA;88253;160;2021-03-28;84573
2021-03-27;"Trnavský kraj";64;129602;245;129847;NA;88253;309;2021-03-27;84413
2021-03-26;"Trnavský kraj";139;30217;130;30347;NA;88253;269;2021-03-26;84104
2021-03-25;"Trnavský kraj";135;14212;80;14292;NA;88253;215;2021-03-25;83835
2021-03-24;"Trnavský kraj";159;10521;89;10610;NA;88253;248;2021-03-24;83620
2021-03-23;"Trnavský kraj";221;12735;104;12839;NA;88253;325;2021-03-23;83372
2021-03-22;"Trnavský kraj";103;17068;110;17178;NA;88253;213;2021-03-22;83047
2021-03-21;"Trnavský kraj";31;49119;150;49269;NA;88253;181;2021-03-21;82834
2021-03-20;"Trnavský kraj";112;136963;317;137280;NA;88253;429;2021-03-20;82653
2021-03-19;"Trnavský kraj";174;29071;137;29208;NA;88253;311;2021-03-19;82224
2021-03-18;"Trnavský kraj";158;12217;136;12353;NA;88253;294;2021-03-18;81913
2021-03-17;"Trnavský kraj";245;10434;103;10537;NA;88253;348;2021-03-17;81619
2021-03-16;"Trnavský kraj";311;12811;135;12946;NA;88253;446;2021-03-16;81271
2021-03-15;"Trnavský kraj";127;18678;146;18824;NA;88253;273;2021-03-15;80825
2021-03-14;"Trnavský kraj";14;47608;164;47772;NA;88253;178;2021-03-14;80552
2021-03-13;"Trnavský kraj";155;139224;409;139633;NA;88253;564;2021-03-13;80374
2021-03-12;"Trnavský kraj";201;28559;181;28740;NA;88253;382;2021-03-12;79810
2021-03-11;"Trnavský kraj";204;13285;140;13425;NA;88253;344;2021-03-11;79428
2021-03-10;"Trnavský kraj";242;10583;135;10718;NA;88253;377;2021-03-10;79084
2021-03-09;"Trnavský kraj";442;12820;155;12975;NA;88253;597;2021-03-09;78707
2021-03-08;"Trnavský kraj";182;21825;166;21991;NA;88253;348;2021-03-08;78110
2021-03-07;"Trnavský kraj";30;45463;227;45690;NA;88253;257;2021-03-07;77762
2021-03-06;"Trnavský kraj";154;135635;531;136166;NA;88253;685;2021-03-06;77505
2021-03-05;"Trnavský kraj";299;28620;243;28863;NA;88253;542;2021-03-05;76820
2021-03-04;"Trnavský kraj";238;14489;175;14664;NA;88253;413;2021-03-04;76278
2021-03-03;"Trnavský kraj";413;11566;246;11812;NA;88253;659;2021-03-03;75865
2021-03-02;"Trnavský kraj";477;12347;191;12538;NA;88253;668;2021-03-02;75206
2021-03-01;"Trnavský kraj";189;18587;234;18821;NA;88253;423;2021-03-01;74538
2021-02-28;"Trnavský kraj";87;47709;321;48030;NA;88253;408;2021-02-28;74115
2021-02-27;"Trnavský kraj";264;140725;804;141529;NA;88253;1068;2021-02-27;73707
2021-02-26;"Trnavský kraj";362;26815;286;27101;NA;88253;648;2021-02-26;72639
2021-02-25;"Trnavský kraj";433;10490;227;10717;NA;88253;660;2021-02-25;71991
2021-02-24;"Trnavský kraj";407;9110;290;9400;NA;88253;697;2021-02-24;71331
2021-02-23;"Trnavský kraj";469;11322;284;11606;NA;88253;753;2021-02-23;70634
2021-02-22;"Trnavský kraj";206;19896;330;20226;NA;88253;536;2021-02-22;69881
2021-02-21;"Trnavský kraj";38;48221;329;48550;NA;88253;367;2021-02-21;69345
2021-02-20;"Trnavský kraj";273;135835;859;136694;NA;88253;1132;2021-02-20;68978
2021-02-19;"Trnavský kraj";335;26982;347;27329;NA;88253;682;2021-02-19;67846
2021-02-18;"Trnavský kraj";344;11263;348;11611;NA;88253;692;2021-02-18;67164
2021-02-17;"Trnavský kraj";431;8781;416;9197;NA;88253;847;2021-02-17;66472
2021-02-16;"Trnavský kraj";426;11413;295;11708;NA;88253;721;2021-02-16;65625
2021-02-15;"Trnavský kraj";146;18075;291;18366;NA;88253;437;2021-02-15;64904
2021-02-14;"Trnavský kraj";51;57642;495;58137;NA;88253;546;2021-02-14;64467
2021-02-13;"Trnavský kraj";218;137051;994;138045;NA;88253;1212;2021-02-13;63921
2021-02-12;"Trnavský kraj";300;23682;336;24018;NA;88253;636;2021-02-12;62709
2021-02-11;"Trnavský kraj";422;9911;360;10271;NA;88253;782;2021-02-11;62073
2021-02-10;"Trnavský kraj";511;9334;344;9678;NA;88253;855;2021-02-10;61291
2021-02-09;"Trnavský kraj";544;12752;369;13121;NA;88253;913;2021-02-09;60436
2021-02-08;"Trnavský kraj";220;33539;498;34037;NA;88253;718;2021-02-08;59523
2021-02-07;"Trnavský kraj";140;68646;623;69269;NA;88253;763;2021-02-07;58805
2021-02-06;"Trnavský kraj";348;112687;1482;114169;NA;88253;1830;2021-02-06;58042
2021-02-05;"Trnavský kraj";377;16063;373;16436;NA;88253;750;2021-02-05;56212
2021-02-04;"Trnavský kraj";456;7317;456;7773;NA;88253;912;2021-02-04;55462
2021-02-03;"Trnavský kraj";472;6584;434;7018;NA;88253;906;2021-02-03;54550
2021-02-02;"Trnavský kraj";446;14240;424;14664;NA;88253;870;2021-02-02;53644
2021-02-01;"Trnavský kraj";198;38882;679;39561;NA;88253;877;2021-02-01;52774
2021-01-31;"Trnavský kraj";19;64673;817;65490;NA;88253;836;2021-01-31;51897
2021-01-30;"Trnavský kraj";323;111483;1288;112771;NA;88253;1611;2021-01-30;51061
2021-01-29;"Trnavský kraj";421;9690;290;9980;NA;88253;711;2021-01-29;49450
2021-01-28;"Trnavský kraj";389;5815;286;6101;NA;88253;675;2021-01-28;48739
2021-01-27;"Trnavský kraj";433;5300;219;5519;NA;88253;652;2021-01-27;48064
2021-01-26;"Trnavský kraj";565;25392;636;26028;NA;88253;1201;2021-01-26;47412
2021-01-25;"Trnavský kraj";210;41420;607;42027;NA;88253;817;2021-01-25;46211
2021-01-24;"Trnavský kraj";91;66399;779;67178;NA;88253;870;2021-01-24;45394
2021-01-23;"Trnavský kraj";372;117933;1349;119282;NA;88253;1721;2021-01-23;44524
2021-01-22;"Trnavský kraj";217;33122;507;33629;NA;88253;724;2021-01-22;42803
2021-01-21;"Trnavský kraj";311;13922;378;14300;NA;88253;689;2021-01-21;42079
2021-01-20;"Trnavský kraj";503;8118;274;8392;NA;88253;777;2021-01-20;41390
2021-01-19;"Trnavský kraj";415;7013;347;7360;NA;88253;762;2021-01-19;40613
2021-01-18;"Trnavský kraj";247;6234;484;6718;NA;88253;731;2021-01-18;39851
2021-01-17;"Trnavský kraj";128;854;215;1069;NA;88253;343;2021-01-17;39120
2021-01-16;"Trnavský kraj";103;898;24;922;NA;88253;127;2021-01-16;38777
2021-01-15;"Trnavský kraj";278;5457;335;5792;NA;88253;613;2021-01-15;38650
2021-01-14;"Trnavský kraj";452;4001;338;4339;NA;88253;790;2021-01-14;38037
2021-01-13;"Trnavský kraj";457;4751;378;5129;NA;88253;835;2021-01-13;37247
2021-01-12;"Trnavský kraj";469;7175;483;7658;NA;88253;952;2021-01-12;36412
2021-01-11;"Trnavský kraj";370;5012;392;5404;NA;88253;762;2021-01-11;35460
2021-01-10;"Trnavský kraj";71;13;0;13;NA;88253;71;2021-01-10;34698
2021-01-09;"Trnavský kraj";417;1775;100;1875;NA;88253;517;2021-01-09;34627
2021-01-08;"Trnavský kraj";381;6554;532;7086;NA;88253;913;2021-01-08;34110
2021-01-07;"Trnavský kraj";501;4080;390;4470;NA;88253;891;2021-01-07;33197
2021-01-06;"Trnavský kraj";179;758;132;890;NA;88253;311;2021-01-06;32306
2021-01-05;"Trnavský kraj";611;5925;636;6561;NA;88253;1247;2021-01-05;31995
2021-01-04;"Trnavský kraj";302;5239;689;5928;NA;88253;991;2021-01-04;30748
2021-01-03;"Trnavský kraj";60;53;7;60;NA;88253;67;2021-01-03;29757
2021-01-02;"Trnavský kraj";282;417;32;449;NA;88253;314;2021-01-02;29690
2021-01-01;"Trnavský kraj";143;455;76;531;NA;88253;219;2021-01-01;29376
2020-12-31;"Trnavský kraj";498;8488;858;9346;NA;88253;1356;2020-12-31;29157
2020-12-30;"Trnavský kraj";785;5318;612;5930;NA;88253;1397;2020-12-30;27801
2020-12-29;"Trnavský kraj";322;5364;639;6003;NA;88253;961;2020-12-29;26404
2020-12-28;"Trnavský kraj";213;5334;615;5949;NA;88253;828;2020-12-28;25443
2020-12-27;"Trnavský kraj";27;20;4;24;NA;88253;31;2020-12-27;24615
2020-12-26;"Trnavský kraj";148;44;1;45;NA;88253;149;2020-12-26;24584
2020-12-25;"Trnavský kraj";65;49;5;54;NA;88253;70;2020-12-25;24435
2020-12-24;"Trnavský kraj";333;1359;117;1476;NA;88253;450;2020-12-24;24365
2020-12-23;"Trnavský kraj";210;7259;414;7673;NA;88253;624;2020-12-23;23915
2020-12-22;"Trnavský kraj";311;5590;491;6081;NA;88253;802;2020-12-22;23291
2020-12-21;"Trnavský kraj";328;4527;399;4926;NA;88253;727;2020-12-21;22489
2020-12-20;"Trnavský kraj";134;133;12;145;NA;88253;146;2020-12-20;21762
2020-12-19;"Trnavský kraj";201;1407;103;1510;NA;88253;304;2020-12-19;21616
2020-12-18;"Trnavský kraj";341;4898;378;5276;NA;88253;719;2020-12-18;21312
2020-12-17;"Trnavský kraj";375;5271;443;5714;NA;88253;818;2020-12-17;20593
2020-12-16;"Trnavský kraj";312;5249;405;5654;NA;88253;717;2020-12-16;19775
2020-12-15;"Trnavský kraj";492;6623;632;7255;NA;88253;1124;2020-12-15;19058
2020-12-14;"Trnavský kraj";161;3505;292;3797;NA;88253;453;2020-12-14;17934
2020-12-13;"Trnavský kraj";7;7;0;7;NA;88253;7;2020-12-13;17481
2020-12-12;"Trnavský kraj";254;1456;114;1570;NA;88253;368;2020-12-12;17474
2020-12-11;"Trnavský kraj";384;4683;262;4945;NA;88253;646;2020-12-11;17106
2020-12-10;"Trnavský kraj";183;5194;320;5514;NA;88253;503;2020-12-10;16460
2020-12-09;"Trnavský kraj";521;4283;321;4604;NA;88253;842;2020-12-09;15957
2020-12-08;"Trnavský kraj";281;4090;304;4394;NA;88253;585;2020-12-08;15115
2020-12-07;"Trnavský kraj";178;2895;199;3094;NA;88253;377;2020-12-07;14530
2020-12-06;"Trnavský kraj";46;0;0;0;NA;88253;46;2020-12-06;14153
2020-12-05;"Trnavský kraj";129;2218;41;2259;NA;88253;170;2020-12-05;14107
2020-12-04;"Trnavský kraj";242;3948;158;4106;NA;88253;400;2020-12-04;13937
2020-12-03;"Trnavský kraj";248;2770;190;2960;NA;88253;438;2020-12-03;13537
2020-12-02;"Trnavský kraj";284;4516;176;4692;NA;88253;460;2020-12-02;13099
2020-12-01;"Trnavský kraj";253;3190;205;3395;NA;88253;458;2020-12-01;12639
2020-11-30;"Trnavský kraj";200;7360;186;7546;NA;88253;386;2020-11-30;12181
2020-11-29;"Trnavský kraj";17;738;36;774;NA;88253;53;2020-11-29;11795
2020-11-28;"Trnavský kraj";83;1453;77;1530;NA;88253;160;2020-11-28;11742
2020-11-27;"Trnavský kraj";148;1779;85;1864;NA;88253;233;2020-11-27;11582
2020-11-26;"Trnavský kraj";234;1123;68;1191;NA;88253;302;2020-11-26;11349
2020-11-25;"Trnavský kraj";232;1168;74;1242;NA;88253;306;2020-11-25;11047
2020-11-24;"Trnavský kraj";295;1909;96;2005;NA;88253;391;2020-11-24;10741
2020-11-23;"Trnavský kraj";242;7393;129;7522;NA;88253;371;2020-11-23;10350
2020-11-22;"Trnavský kraj";10;82;9;91;NA;88253;19;2020-11-22;9979
2020-11-21;"Trnavský kraj";129;1354;36;1390;NA;88253;165;2020-11-21;9960
2020-11-20;"Trnavský kraj";246;1154;64;1218;NA;88253;310;2020-11-20;9795
2020-11-19;"Trnavský kraj";157;823;64;887;NA;88253;221;2020-11-19;9485
2020-11-18;"Trnavský kraj";235;822;82;904;NA;88253;317;2020-11-18;9264
2020-11-17;"Trnavský kraj";129;705;74;779;NA;88253;203;2020-11-17;8947
2020-11-16;"Trnavský kraj";187;732;32;764;NA;88253;219;2020-11-16;8744
2020-11-15;"Trnavský kraj";23;73;4;77;NA;88253;27;2020-11-15;8525
2020-11-14;"Trnavský kraj";86;397;12;409;NA;88253;98;2020-11-14;8498
2020-11-13;"Trnavský kraj";219;1312;21;1333;NA;88253;240;2020-11-13;8400
2020-11-12;"Trnavský kraj";162;420;18;438;NA;88253;180;2020-11-12;8160
2020-11-11;"Trnavský kraj";257;392;15;407;NA;88253;272;2020-11-11;7980
2020-11-10;"Trnavský kraj";189;889;30;919;NA;88253;219;2020-11-10;7708
2020-11-09;"Trnavský kraj";196;369;23;392;NA;88253;219;2020-11-09;7489
2020-11-08;"Trnavský kraj";55;400;4;404;NA;88253;59;2020-11-08;7270
2020-11-07;"Trnavský kraj";207;6070;74;6144;NA;88253;281;2020-11-07;7211
2020-11-06;"Trnavský kraj";260;1531;19;1550;NA;88253;279;2020-11-06;6930
2020-11-05;"Trnavský kraj";150;220;27;247;NA;88253;177;2020-11-05;6651
2020-11-04;"Trnavský kraj";188;212;10;222;NA;88253;198;2020-11-04;6474
2020-11-03;"Trnavský kraj";317;127;8;135;NA;88253;325;2020-11-03;6276
2020-11-02;"Trnavský kraj";281;1728;31;1759;NA;88253;312;2020-11-02;5951
2020-11-01;"Trnavský kraj";87;494;27;521;NA;88253;114;2020-11-01;5639
2020-10-31;"Trnavský kraj";259;5024;41;5065;NA;88253;300;2020-10-31;5525
2020-10-30;"Trnavský kraj";198;3784;27;3811;NA;88253;225;2020-10-30;5225
2020-10-29;"Trnavský kraj";273;1461;16;1477;NA;88253;289;2020-10-29;5000
2020-10-28;"Trnavský kraj";319;117;16;133;NA;88253;335;2020-10-28;4711
2020-10-27;"Trnavský kraj";199;461;36;497;NA;88253;235;2020-10-27;4376
2020-10-26;"Trnavský kraj";153;29;2;31;NA;88253;155;2020-10-26;4141
2020-10-25;"Trnavský kraj";95;19;1;20;NA;88253;96;2020-10-25;3986
2020-10-24;"Trnavský kraj";158;109;2;111;NA;88253;160;2020-10-24;3890
2020-10-23;"Trnavský kraj";201;89;4;93;NA;88253;205;2020-10-23;3730
2020-10-22;"Trnavský kraj";195;55;2;57;NA;88253;197;2020-10-22;3525
2020-10-21;"Trnavský kraj";134;73;3;76;NA;88253;137;2020-10-21;3328
2020-10-20;"Trnavský kraj";202;82;3;85;NA;88253;205;2020-10-20;3191
2020-10-19;"Trnavský kraj";67;55;0;55;NA;88253;67;2020-10-19;2986
2020-10-18;"Trnavský kraj";84;0;0;0;NA;88253;84;2020-10-18;2919
2020-10-17;"Trnavský kraj";123;0;0;0;NA;88253;123;2020-10-17;2835
2020-10-16;"Trnavský kraj";86;45;2;47;NA;88253;88;2020-10-16;2712
2020-10-15;"Trnavský kraj";155;66;2;68;NA;88253;157;2020-10-15;2624
2020-10-14;"Trnavský kraj";236;468;3;471;NA;88253;239;2020-10-14;2467
2020-10-13;"Trnavský kraj";138;16;2;18;NA;88253;140;2020-10-13;2228
2020-10-12;"Trnavský kraj";33;41;1;42;NA;88253;34;2020-10-12;2088
2020-10-11;"Trnavský kraj";31;0;0;0;NA;88253;31;2020-10-11;2054
2020-10-10;"Trnavský kraj";128;0;0;0;NA;88253;128;2020-10-10;2023
2020-10-09;"Trnavský kraj";156;0;0;0;NA;88253;156;2020-10-09;1895
2020-10-08;"Trnavský kraj";153;0;0;0;NA;88253;153;2020-10-08;1739
2020-10-07;"Trnavský kraj";80;0;0;0;NA;88253;80;2020-10-07;1586
2020-10-06;"Trnavský kraj";112;0;0;0;NA;88253;112;2020-10-06;1506
2020-10-05;"Trnavský kraj";33;0;0;0;NA;88253;33;2020-10-05;1394
2020-10-04;"Trnavský kraj";44;0;0;0;NA;88253;44;2020-10-04;1361
2020-10-03;"Trnavský kraj";60;0;0;0;NA;88253;60;2020-10-03;1317
2020-10-02;"Trnavský kraj";41;0;0;0;NA;88253;41;2020-10-02;1257
2020-10-01;"Trnavský kraj";53;0;0;0;NA;88253;53;2020-10-01;1216
2020-09-30;"Trnavský kraj";91;0;0;0;NA;88253;91;2020-09-30;1163
2020-09-29;"Trnavský kraj";40;0;0;0;NA;88253;40;2020-09-29;1072
2020-09-28;"Trnavský kraj";69;0;0;0;NA;88253;69;2020-09-28;1032
2020-09-27;"Trnavský kraj";30;0;0;0;NA;88253;30;2020-09-27;963
2020-09-26;"Trnavský kraj";46;0;0;0;NA;88253;46;2020-09-26;933
2020-09-25;"Trnavský kraj";32;0;0;0;NA;88253;32;2020-09-25;887
2020-09-24;"Trnavský kraj";42;0;0;0;NA;88253;42;2020-09-24;855
2020-09-23;"Trnavský kraj";43;0;0;0;NA;88253;43;2020-09-23;813
2020-09-22;"Trnavský kraj";55;0;0;0;NA;88253;55;2020-09-22;770
2020-09-21;"Trnavský kraj";41;0;0;0;NA;88253;41;2020-09-21;715
2020-09-20;"Trnavský kraj";17;0;0;0;NA;88253;17;2020-09-20;674
2020-09-19;"Trnavský kraj";4;0;0;0;NA;88253;4;2020-09-19;657
2020-09-18;"Trnavský kraj";33;0;0;0;NA;88253;33;2020-09-18;653
2020-09-17;"Trnavský kraj";42;0;0;0;NA;88253;42;2020-09-17;620
2020-09-16;"Trnavský kraj";49;0;0;0;NA;88253;49;2020-09-16;578
2020-09-15;"Trnavský kraj";5;0;0;0;NA;88253;5;2020-09-15;529
2020-09-14;"Trnavský kraj";26;0;0;0;NA;88253;26;2020-09-14;524
2020-09-13;"Trnavský kraj";9;0;0;0;NA;88253;9;2020-09-13;498
2020-09-12;"Trnavský kraj";12;0;0;0;NA;88253;12;2020-09-12;489
2020-09-11;"Trnavský kraj";16;0;0;0;NA;88253;16;2020-09-11;477
2020-09-10;"Trnavský kraj";32;0;0;0;NA;88253;32;2020-09-10;461
2020-09-09;"Trnavský kraj";14;0;0;0;NA;88253;14;2020-09-09;429
2020-09-08;"Trnavský kraj";11;0;0;0;NA;88253;11;2020-09-08;415
2020-09-07;"Trnavský kraj";7;0;0;0;NA;88253;7;2020-09-07;404
2020-09-06;"Trnavský kraj";5;0;0;0;NA;88253;5;2020-09-06;397
2020-09-05;"Trnavský kraj";7;0;0;0;NA;88253;7;2020-09-05;392
2020-09-04;"Trnavský kraj";16;0;0;0;NA;88253;16;2020-09-04;385
2020-09-03;"Trnavský kraj";8;0;0;0;NA;88253;8;2020-09-03;369
2020-09-02;"Trnavský kraj";7;0;0;0;NA;88253;7;2020-09-02;361
2020-09-01;"Trnavský kraj";1;0;0;0;NA;88253;1;2020-09-01;354
2020-08-31;"Trnavský kraj";6;0;0;0;NA;88253;6;2020-08-31;353
2020-08-30;"Trnavský kraj";1;0;0;0;NA;88253;1;2020-08-30;347
2020-08-29;"Trnavský kraj";3;0;0;0;NA;88253;3;2020-08-29;346
2020-08-28;"Trnavský kraj";14;0;0;0;NA;88253;14;2020-08-28;343
2020-08-27;"Trnavský kraj";6;0;0;0;NA;88253;6;2020-08-27;329
2020-08-26;"Trnavský kraj";4;0;0;0;NA;88253;4;2020-08-26;323
2020-08-25;"Trnavský kraj";7;0;0;0;NA;88253;7;2020-08-25;319
2020-08-24;"Trnavský kraj";1;0;0;0;NA;88253;1;2020-08-24;312
2020-08-23;"Trnavský kraj";6;0;0;0;NA;88253;6;2020-08-23;311
2020-08-22;"Trnavský kraj";3;0;0;0;NA;88253;3;2020-08-22;305
2020-08-21;"Trnavský kraj";4;0;0;0;NA;88253;4;2020-08-21;302
2020-08-20;"Trnavský kraj";23;0;0;0;NA;88253;23;2020-08-20;298
2020-08-19;"Trnavský kraj";13;0;0;0;NA;88253;13;2020-08-19;275
2020-08-18;"Trnavský kraj";20;0;0;0;NA;88253;20;2020-08-18;262
2020-08-17;"Trnavský kraj";3;0;0;0;NA;88253;3;2020-08-17;242
2020-08-16;"Trnavský kraj";0;0;0;0;NA;88253;0;2020-08-16;239
2020-08-15;"Trnavský kraj";7;0;0;0;NA;88253;7;2020-08-15;239
2020-08-14;"Trnavský kraj";6;0;0;0;NA;88253;6;2020-08-14;232
2020-08-13;"Trnavský kraj";10;0;0;0;NA;88253;10;2020-08-13;226
2020-08-12;"Trnavský kraj";2;0;0;0;NA;88253;2;2020-08-12;216
2020-08-11;"Trnavský kraj";30;0;0;0;NA;88253;30;2020-08-11;214
2020-08-10;"Trnavský kraj";0;0;0;0;NA;88253;0;2020-08-10;184
2020-08-09;"Trnavský kraj";0;0;0;0;NA;88253;0;2020-08-09;184
2020-08-08;"Trnavský kraj";13;0;0;0;NA;88253;13;2020-08-08;184
2020-08-07;"Trnavský kraj";4;0;0;0;NA;88253;4;2020-08-07;171
2020-08-06;"Trnavský kraj";4;0;0;0;NA;88253;4;2020-08-06;167
2020-08-05;"Trnavský kraj";0;0;0;0;NA;88253;0;2020-08-05;163
2020-08-04;"Trnavský kraj";1;0;0;0;NA;88253;1;2020-08-04;163
2020-08-03;"Trnavský kraj";2;0;0;0;NA;88253;2;2020-08-03;162
2020-08-02;"Trnavský kraj";1;0;0;0;NA;88253;1;2020-08-02;160
2020-08-01;"Trnavský kraj";0;0;0;0;NA;88253;0;2020-08-01;159
2020-07-31;"Trnavský kraj";7;0;0;0;NA;88253;7;2020-07-31;159
2020-07-30;"Trnavský kraj";6;0;0;0;NA;88253;6;2020-07-30;152
2020-07-29;"Trnavský kraj";0;0;0;0;NA;88253;0;2020-07-29;146
2020-07-28;"Trnavský kraj";1;0;0;0;NA;88253;1;2020-07-28;146
2020-07-27;"Trnavský kraj";2;0;0;0;NA;88253;2;2020-07-27;145
2020-07-26;"Trnavský kraj";0;0;0;0;NA;88253;0;2020-07-26;143
2020-07-25;"Trnavský kraj";0;0;0;0;NA;88253;0;2020-07-25;143
2020-07-24;"Trnavský kraj";1;0;0;0;NA;88253;1;2020-07-24;143
2020-07-23;"Trnavský kraj";2;0;0;0;NA;88253;2;2020-07-23;142
2020-07-22;"Trnavský kraj";1;0;0;0;NA;88253;1;2020-07-22;140
2020-07-21;"Trnavský kraj";2;0;0;0;NA;88253;2;2020-07-21;139
2020-07-20;"Trnavský kraj";0;0;0;0;NA;88253;0;2020-07-20;137
2020-07-19;"Trnavský kraj";0;0;0;0;NA;88253;0;2020-07-19;137
2020-07-18;"Trnavský kraj";0;0;0;0;NA;88253;0;2020-07-18;137
2020-07-17;"Trnavský kraj";0;0;0;0;NA;88253;0;2020-07-17;137
2020-07-16;"Trnavský kraj";0;0;0;0;NA;88253;0;2020-07-16;137
2020-07-15;"Trnavský kraj";1;0;0;0;NA;88253;1;2020-07-15;137
2020-07-14;"Trnavský kraj";0;0;0;0;NA;88253;0;2020-07-14;136
2020-07-13;"Trnavský kraj";0;0;0;0;NA;88253;0;2020-07-13;136
2020-07-12;"Trnavský kraj";0;0;0;0;NA;88253;0;2020-07-12;136
2020-07-11;"Trnavský kraj";0;0;0;0;NA;88253;0;2020-07-11;136
2020-07-10;"Trnavský kraj";0;0;0;0;NA;88253;0;2020-07-10;136
2020-07-09;"Trnavský kraj";0;0;0;0;NA;88253;0;2020-07-09;136
2020-07-08;"Trnavský kraj";3;0;0;0;NA;88253;3;2020-07-08;136
2020-07-07;"Trnavský kraj";4;0;0;0;NA;88253;4;2020-07-07;133
2020-07-06;"Trnavský kraj";0;0;0;0;NA;88253;0;2020-07-06;129
2020-07-05;"Trnavský kraj";0;0;0;0;NA;88253;0;2020-07-05;129
2020-07-04;"Trnavský kraj";0;0;0;0;NA;88253;0;2020-07-04;129
2020-07-03;"Trnavský kraj";0;0;0;0;NA;88253;0;2020-07-03;129
2020-07-02;"Trnavský kraj";3;0;0;0;NA;88253;3;2020-07-02;129
2020-07-01;"Trnavský kraj";0;0;0;0;NA;88253;0;2020-07-01;126
2020-06-30;"Trnavský kraj";0;0;0;0;NA;88253;0;2020-06-30;126
2020-06-29;"Trnavský kraj";0;0;0;0;NA;88253;0;2020-06-29;126
2020-06-28;"Trnavský kraj";0;0;0;0;NA;88253;0;2020-06-28;126
2020-06-27;"Trnavský kraj";0;0;0;0;NA;88253;0;2020-06-27;126
2020-06-26;"Trnavský kraj";0;0;0;0;NA;88253;0;2020-06-26;126
2020-06-25;"Trnavský kraj";0;0;0;0;NA;88253;0;2020-06-25;126
2020-06-24;"Trnavský kraj";0;0;0;0;NA;88253;0;2020-06-24;126
2020-06-23;"Trnavský kraj";0;0;0;0;NA;88253;0;2020-06-23;126
2020-06-22;"Trnavský kraj";0;0;0;0;NA;88253;0;2020-06-22;126
2020-06-21;"Trnavský kraj";0;0;0;0;NA;88253;0;2020-06-21;126
2020-06-20;"Trnavský kraj";0;0;0;0;NA;88253;0;2020-06-20;126
2020-06-19;"Trnavský kraj";0;0;0;0;NA;88253;0;2020-06-19;126
2020-06-18;"Trnavský kraj";2;0;0;0;NA;88253;2;2020-06-18;126
2020-06-17;"Trnavský kraj";0;0;0;0;NA;88253;0;2020-06-17;124
2020-06-16;"Trnavský kraj";0;0;0;0;NA;88253;0;2020-06-16;124
2020-06-14;"Trnavský kraj";0;0;0;0;NA;88253;0;2020-06-14;124
2020-06-13;"Trnavský kraj";0;0;0;0;NA;88253;0;2020-06-13;124
2020-06-12;"Trnavský kraj";0;0;0;0;NA;88253;0;2020-06-12;124
2020-06-11;"Trnavský kraj";0;0;0;0;NA;88253;0;2020-06-11;124
2020-06-10;"Trnavský kraj";0;0;0;0;NA;88253;0;2020-06-10;124
2020-06-09;"Trnavský kraj";0;0;0;0;NA;88253;0;2020-06-09;124
2020-06-08;"Trnavský kraj";0;0;0;0;NA;88253;0;2020-06-08;124
2020-06-07;"Trnavský kraj";0;0;0;0;NA;88253;0;2020-06-07;124
2020-06-05;"Trnavský kraj";0;0;0;0;NA;88253;0;2020-06-05;124
2020-06-03;"Trnavský kraj";0;0;0;0;NA;88253;0;2020-06-03;124
2020-06-02;"Trnavský kraj";0;0;0;0;NA;88253;0;2020-06-02;124
2020-05-31;"Trnavský kraj";0;0;0;0;NA;88253;0;2020-05-31;124
2020-05-29;"Trnavský kraj";0;0;0;0;NA;88253;0;2020-05-29;124
2020-05-27;"Trnavský kraj";0;0;0;0;NA;88253;0;2020-05-27;124
2020-05-26;"Trnavský kraj";0;0;0;0;NA;88253;0;2020-05-26;124
2020-05-25;"Trnavský kraj";1;0;0;0;NA;88253;1;2020-05-25;124
2020-05-24;"Trnavský kraj";0;0;0;0;NA;88253;0;2020-05-24;123
2020-05-23;"Trnavský kraj";2;0;0;0;NA;88253;2;2020-05-23;123
2020-05-22;"Trnavský kraj";0;0;0;0;NA;88253;0;2020-05-22;121
2020-05-21;"Trnavský kraj";0;0;0;0;NA;88253;0;2020-05-21;121
2020-05-20;"Trnavský kraj";2;0;0;0;NA;88253;2;2020-05-20;121
2020-05-19;"Trnavský kraj";0;0;0;0;NA;88253;0;2020-05-19;119
2020-05-17;"Trnavský kraj";0;0;0;0;NA;88253;0;2020-05-17;119
2020-05-16;"Trnavský kraj";0;0;0;0;NA;88253;0;2020-05-16;119
2020-05-15;"Trnavský kraj";1;0;0;0;NA;88253;1;2020-05-15;119
2020-05-14;"Trnavský kraj";0;0;0;0;NA;88253;0;2020-05-14;118
2020-05-13;"Trnavský kraj";0;0;0;0;NA;88253;0;2020-05-13;118
2020-05-12;"Trnavský kraj";0;0;0;0;NA;88253;0;2020-05-12;118
2020-05-11;"Trnavský kraj";2;0;0;0;NA;88253;2;2020-05-11;118
2020-05-09;"Trnavský kraj";0;0;0;0;NA;88253;0;2020-05-09;116
2020-05-07;"Trnavský kraj";0;0;0;0;NA;88253;0;2020-05-07;116
2020-05-06;"Trnavský kraj";0;0;0;0;NA;88253;0;2020-05-06;116
2020-05-05;"Trnavský kraj";0;0;0;0;NA;88253;0;2020-05-05;116
2020-05-04;"Trnavský kraj";0;0;0;0;NA;88253;0;2020-05-04;116
2020-05-03;"Trnavský kraj";0;0;0;0;NA;88253;0;2020-05-03;116
2020-05-02;"Trnavský kraj";0;0;0;0;NA;88253;0;2020-05-02;116
2020-05-01;"Trnavský kraj";0;0;0;0;NA;88253;0;2020-05-01;116
2020-04-30;"Trnavský kraj";0;0;0;0;NA;88253;0;2020-04-30;116
2020-04-29;"Trnavský kraj";0;0;0;0;NA;88253;0;2020-04-29;116
2020-04-28;"Trnavský kraj";1;0;0;0;NA;88253;1;2020-04-28;116
2020-04-27;"Trnavský kraj";0;0;0;0;NA;88253;0;2020-04-27;115
2020-04-26;"Trnavský kraj";0;0;0;0;NA;88253;0;2020-04-26;115
2020-04-25;"Trnavský kraj";2;0;0;0;NA;88253;2;2020-04-25;115
2020-04-24;"Trnavský kraj";4;0;0;0;NA;88253;4;2020-04-24;113
2020-04-23;"Trnavský kraj";5;0;0;0;NA;88253;5;2020-04-23;109
2020-04-22;"Trnavský kraj";10;0;0;0;NA;88253;10;2020-04-22;104
2020-04-21;"Trnavský kraj";5;0;0;0;NA;88253;5;2020-04-21;94
2020-04-20;"Trnavský kraj";0;0;0;0;NA;88253;0;2020-04-20;89
2020-04-19;"Trnavský kraj";1;0;0;0;NA;88253;1;2020-04-19;89
2020-04-18;"Trnavský kraj";4;0;0;0;NA;88253;4;2020-04-18;88
2020-04-17;"Trnavský kraj";7;0;0;0;NA;88253;7;2020-04-17;84
2020-04-16;"Trnavský kraj";5;0;0;0;NA;88253;5;2020-04-16;77
2020-04-15;"Trnavský kraj";5;0;0;0;NA;88253;5;2020-04-15;72
2020-04-14;"Trnavský kraj";1;0;0;0;NA;88253;1;2020-04-14;67
2020-04-13;"Trnavský kraj";0;0;0;0;NA;88253;0;2020-04-13;66
2020-04-12;"Trnavský kraj";0;0;0;0;NA;88253;0;2020-04-12;66
2020-04-11;"Trnavský kraj";0;0;0;0;NA;88253;0;2020-04-11;66
2020-04-10;"Trnavský kraj";2;0;0;0;NA;88253;2;2020-04-10;66
2020-04-09;"Trnavský kraj";3;0;0;0;NA;88253;3;2020-04-09;64
2020-04-08;"Trnavský kraj";4;0;0;0;NA;88253;4;2020-04-08;61
2020-04-07;"Trnavský kraj";6;0;0;0;NA;88253;6;2020-04-07;57
2020-04-06;"Trnavský kraj";6;0;0;0;NA;88253;6;2020-04-06;51
2020-04-05;"Trnavský kraj";1;0;0;0;NA;88253;1;2020-04-05;45
2020-04-04;"Trnavský kraj";1;0;0;0;NA;88253;1;2020-04-04;44
2020-04-03;"Trnavský kraj";3;0;0;0;NA;88253;3;2020-04-03;43
2020-04-02;"Trnavský kraj";4;0;0;0;NA;88253;4;2020-04-02;40
2020-04-01;"Trnavský kraj";0;0;0;0;NA;88253;0;2020-04-01;36
2020-03-31;"Trnavský kraj";3;0;0;0;NA;88253;3;2020-03-31;36
2020-03-30;"Trnavský kraj";4;0;0;0;NA;88253;4;2020-03-30;33
2020-03-29;"Trnavský kraj";1;0;0;0;NA;88253;1;2020-03-29;29
2020-03-28;"Trnavský kraj";3;0;0;0;NA;88253;3;2020-03-28;28
2020-03-27;"Trnavský kraj";5;0;0;0;NA;88253;5;2020-03-27;25
2020-03-26;"Trnavský kraj";5;0;0;0;NA;88253;5;2020-03-26;20
2020-03-25;"Trnavský kraj";1;0;0;0;NA;88253;1;2020-03-25;15
2020-03-24;"Trnavský kraj";0;0;0;0;NA;88253;0;2020-03-24;14
2020-03-23;"Trnavský kraj";2;0;0;0;NA;88253;2;2020-03-23;14
2020-03-22;"Trnavský kraj";1;0;0;0;NA;88253;1;2020-03-22;12
2020-03-21;"Trnavský kraj";5;0;0;0;NA;88253;5;2020-03-21;11
2020-03-20;"Trnavský kraj";0;0;0;0;NA;88253;0;2020-03-20;6
2020-03-19;"Trnavský kraj";0;0;0;0;NA;88253;0;2020-03-19;6
2020-03-18;"Trnavský kraj";0;0;0;0;NA;88253;0;2020-03-18;6
2020-03-17;"Trnavský kraj";3;0;0;0;NA;88253;3;2020-03-17;6
2020-03-16;"Trnavský kraj";1;0;0;0;NA;88253;1;2020-03-16;3
2020-03-15;"Trnavský kraj";0;0;0;0;NA;88253;0;2020-03-15;2
2020-03-14;"Trnavský kraj";0;0;0;0;NA;88253;0;2020-03-14;2
2020-03-13;"Trnavský kraj";1;0;0;0;NA;88253;1;2020-03-13;2
2020-03-12;"Trnavský kraj";1;0;0;0;NA;88253;1;2020-03-12;1
2020-03-11;"Trnavský kraj";0;0;0;0;NA;88253;0;2020-03-11;0
2020-03-09;"Trnavský kraj";0;0;0;0;NA;88253;0;2020-03-09;0
2020-03-08;"Trnavský kraj";0;0;0;0;NA;88253;0;2020-03-08;0
2020-03-07;"Trnavský kraj";0;0;0;0;NA;88253;0;2020-03-07;0
2020-03-06;"Trnavský kraj";0;0;0;0;NA;88253;0;2020-03-06;0
2021-05-30;"Žilinský kraj";21;8908;35;8943;57607;103171;56;2021-05-30;103171
2021-05-29;"Žilinský kraj";13;11258;23;11281;NA;103171;36;2021-05-29;103115
2021-05-28;"Žilinský kraj";28;12837;30;12867;NA;103171;58;2021-05-28;103079
2021-05-27;"Žilinský kraj";17;8195;39;8234;NA;103171;56;2021-05-27;103021
2021-05-26;"Žilinský kraj";20;8301;25;8326;NA;103171;45;2021-05-26;102965
2021-05-25;"Žilinský kraj";21;9872;38;9910;NA;103171;59;2021-05-25;102920
2021-05-24;"Žilinský kraj";36;11727;57;11784;NA;103171;93;2021-05-24;102861
2021-05-23;"Žilinský kraj";4;10632;56;10688;NA;103171;60;2021-05-23;102768
2021-05-22;"Žilinský kraj";21;12018;28;12046;NA;103171;49;2021-05-22;102708
2021-05-21;"Žilinský kraj";28;15471;50;15521;NA;103171;78;2021-05-21;102659
2021-05-20;"Žilinský kraj";30;9476;30;9506;NA;103171;60;2021-05-20;102581
2021-05-19;"Žilinský kraj";46;8627;41;8668;NA;103171;87;2021-05-19;102521
2021-05-18;"Žilinský kraj";52;10461;44;10505;NA;103171;96;2021-05-18;102434
2021-05-17;"Žilinský kraj";51;12627;84;12711;NA;103171;135;2021-05-17;102338
2021-05-16;"Žilinský kraj";13;13851;42;13893;NA;103171;55;2021-05-16;102203
2021-05-15;"Žilinský kraj";30;18216;35;18251;NA;103171;65;2021-05-15;102148
2021-05-14;"Žilinský kraj";34;20945;82;21027;NA;103171;116;2021-05-14;102083
2021-05-13;"Žilinský kraj";64;11838;51;11889;NA;103171;115;2021-05-13;101967
2021-05-12;"Žilinský kraj";57;10198;50;10248;NA;103171;107;2021-05-12;101852
2021-05-11;"Žilinský kraj";70;11840;51;11891;NA;103171;121;2021-05-11;101745
2021-05-10;"Žilinský kraj";69;15899;72;15971;NA;103171;141;2021-05-10;101624
2021-05-09;"Žilinský kraj";58;20298;77;20375;NA;103171;135;2021-05-09;101483
2021-05-08;"Žilinský kraj";0;23997;63;24060;NA;103171;63;2021-05-08;101348
2021-05-07;"Žilinský kraj";65;26190;87;26277;NA;103171;152;2021-05-07;101285
2021-05-06;"Žilinský kraj";67;16529;72;16601;NA;103171;139;2021-05-06;101133
2021-05-05;"Žilinský kraj";71;13032;73;13105;NA;103171;144;2021-05-05;100994
2021-05-04;"Žilinský kraj";81;16615;80;16695;NA;103171;161;2021-05-04;100850
2021-05-03;"Žilinský kraj";97;20275;109;20384;NA;103171;206;2021-05-03;100689
2021-05-02;"Žilinský kraj";8;29127;66;29193;NA;103171;74;2021-05-02;100483
2021-05-01;"Žilinský kraj";65;54649;103;54752;NA;103171;168;2021-05-01;100409
2021-04-30;"Žilinský kraj";84;0;0;0;NA;103171;84;2021-04-30;100241
2021-04-29;"Žilinský kraj";77;0;0;0;NA;103171;77;2021-04-29;100157
2021-04-28;"Žilinský kraj";76;0;0;0;NA;103171;76;2021-04-28;100080
2021-04-27;"Žilinský kraj";97;0;0;0;NA;103171;97;2021-04-27;100004
2021-04-26;"Žilinský kraj";114;0;0;0;NA;103171;114;2021-04-26;99907
2021-04-25;"Žilinský kraj";38;0;0;0;NA;103171;38;2021-04-25;99793
2021-04-24;"Žilinský kraj";93;0;0;0;NA;103171;93;2021-04-24;99755
2021-04-23;"Žilinský kraj";144;0;0;0;NA;103171;144;2021-04-23;99662
2021-04-22;"Žilinský kraj";110;0;0;0;NA;103171;110;2021-04-22;99518
2021-04-21;"Žilinský kraj";118;0;0;0;NA;103171;118;2021-04-21;99408
2021-04-20;"Žilinský kraj";128;0;0;0;NA;103171;128;2021-04-20;99290
2021-04-19;"Žilinský kraj";164;0;0;0;NA;103171;164;2021-04-19;99162
2021-04-18;"Žilinský kraj";18;0;0;0;NA;103171;18;2021-04-18;98998
2021-04-17;"Žilinský kraj";108;0;0;0;NA;103171;108;2021-04-17;98980
2021-04-16;"Žilinský kraj";185;0;0;0;NA;103171;185;2021-04-16;98872
2021-04-15;"Žilinský kraj";108;0;0;0;NA;103171;108;2021-04-15;98687
2021-04-14;"Žilinský kraj";135;0;0;0;NA;103171;135;2021-04-14;98579
2021-04-13;"Žilinský kraj";171;0;0;0;NA;103171;171;2021-04-13;98444
2021-04-12;"Žilinský kraj";266;0;0;0;NA;103171;266;2021-04-12;98273
2021-04-11;"Žilinský kraj";19;0;0;0;NA;103171;19;2021-04-11;98007
2021-04-10;"Žilinský kraj";111;0;0;0;NA;103171;111;2021-04-10;97988
2021-04-09;"Žilinský kraj";195;0;0;0;NA;103171;195;2021-04-09;97877
2021-04-08;"Žilinský kraj";179;0;0;0;NA;103171;179;2021-04-08;97682
2021-04-07;"Žilinský kraj";309;0;0;0;NA;103171;309;2021-04-07;97503
2021-04-06;"Žilinský kraj";308;0;0;0;NA;103171;308;2021-04-06;97194
2021-04-05;"Žilinský kraj";17;0;0;0;NA;103171;17;2021-04-05;96886
2021-04-04;"Žilinský kraj";17;0;0;0;NA;103171;17;2021-04-04;96869
2021-04-03;"Žilinský kraj";180;0;0;0;NA;103171;180;2021-04-03;96852
2021-04-02;"Žilinský kraj";73;0;0;0;NA;103171;73;2021-04-02;96672
2021-04-01;"Žilinský kraj";334;0;0;0;NA;103171;334;2021-04-01;96599
2021-03-31;"Žilinský kraj";170;31632;247;31879;NA;103171;417;2021-03-31;96265
2021-03-30;"Žilinský kraj";406;26323;243;26566;NA;103171;649;2021-03-30;95848
2021-03-29;"Žilinský kraj";297;28022;268;28290;NA;103171;565;2021-03-29;95199
2021-03-28;"Žilinský kraj";21;36206;239;36445;NA;103171;260;2021-03-28;94634
2021-03-27;"Žilinský kraj";151;89107;353;89460;NA;103171;504;2021-03-27;94374
2021-03-26;"Žilinský kraj";312;52263;333;52596;NA;103171;645;2021-03-26;93870
2021-03-25;"Žilinský kraj";281;27620;214;27834;NA;103171;495;2021-03-25;93225
2021-03-24;"Žilinský kraj";280;21268;260;21528;NA;103171;540;2021-03-24;92730
2021-03-23;"Žilinský kraj";418;23187;278;23465;NA;103171;696;2021-03-23;92190
2021-03-22;"Žilinský kraj";293;29289;314;29603;NA;103171;607;2021-03-22;91494
2021-03-21;"Žilinský kraj";32;33705;227;33932;NA;103171;259;2021-03-21;90887
2021-03-20;"Žilinský kraj";165;93015;497;93512;NA;103171;662;2021-03-20;90628
2021-03-19;"Žilinský kraj";357;51982;413;52395;NA;103171;770;2021-03-19;89966
2021-03-18;"Žilinský kraj";329;28451;294;28745;NA;103171;623;2021-03-18;89196
2021-03-17;"Žilinský kraj";395;21916;269;22185;NA;103171;664;2021-03-17;88573
2021-03-16;"Žilinský kraj";514;24341;317;24658;NA;103171;831;2021-03-16;87909
2021-03-15;"Žilinský kraj";341;29607;419;30026;NA;103171;760;2021-03-15;87078
2021-03-14;"Žilinský kraj";87;34121;267;34388;NA;103171;354;2021-03-14;86318
2021-03-13;"Žilinský kraj";113;93756;584;94340;NA;103171;697;2021-03-13;85964
2021-03-12;"Žilinský kraj";520;52109;411;52520;NA;103171;931;2021-03-12;85267
2021-03-11;"Žilinský kraj";399;28189;302;28491;NA;103171;701;2021-03-11;84336
2021-03-10;"Žilinský kraj";368;22414;378;22792;NA;103171;746;2021-03-10;83635
2021-03-09;"Žilinský kraj";537;24857;316;25173;NA;103171;853;2021-03-09;82889
2021-03-08;"Žilinský kraj";387;30839;458;31297;NA;103171;845;2021-03-08;82036
2021-03-07;"Žilinský kraj";48;33469;290;33759;NA;103171;338;2021-03-07;81191
2021-03-06;"Žilinský kraj";173;92410;589;92999;NA;103171;762;2021-03-06;80853
2021-03-05;"Žilinský kraj";369;51748;483;52231;NA;103171;852;2021-03-05;80091
2021-03-04;"Žilinský kraj";467;30036;377;30413;NA;103171;844;2021-03-04;79239
2021-03-03;"Žilinský kraj";448;26261;394;26655;NA;103171;842;2021-03-03;78395
2021-03-02;"Žilinský kraj";551;25669;378;26047;NA;103171;929;2021-03-02;77553
2021-03-01;"Žilinský kraj";375;30493;441;30934;NA;103171;816;2021-03-01;76624
2021-02-28;"Žilinský kraj";61;34802;327;35129;NA;103171;388;2021-02-28;75808
2021-02-27;"Žilinský kraj";159;83781;639;84420;NA;103171;798;2021-02-27;75420
2021-02-26;"Žilinský kraj";459;47494;508;48002;NA;103171;967;2021-02-26;74622
2021-02-25;"Žilinský kraj";347;30879;393;31272;NA;103171;740;2021-02-25;73655
2021-02-24;"Žilinský kraj";339;18745;395;19140;NA;103171;734;2021-02-24;72915
2021-02-23;"Žilinský kraj";437;22418;418;22836;NA;103171;855;2021-02-23;72181
2021-02-22;"Žilinský kraj";345;29288;438;29726;NA;103171;783;2021-02-22;71326
2021-02-21;"Žilinský kraj";36;28686;322;29008;NA;103171;358;2021-02-21;70543
2021-02-20;"Žilinský kraj";152;88723;667;89390;NA;103171;819;2021-02-20;70185
2021-02-19;"Žilinský kraj";337;44806;415;45221;NA;103171;752;2021-02-19;69366
2021-02-18;"Žilinský kraj";263;24679;339;25018;NA;103171;602;2021-02-18;68614
2021-02-17;"Žilinský kraj";269;17932;355;18287;NA;103171;624;2021-02-17;68012
2021-02-16;"Žilinský kraj";321;24298;325;24623;NA;103171;646;2021-02-16;67388
2021-02-15;"Žilinský kraj";230;30420;311;30731;NA;103171;541;2021-02-15;66742
2021-02-14;"Žilinský kraj";30;28574;231;28805;NA;103171;261;2021-02-14;66201
2021-02-13;"Žilinský kraj";91;69659;454;70113;NA;103171;545;2021-02-13;65940
2021-02-12;"Žilinský kraj";242;42689;335;43024;NA;103171;577;2021-02-12;65395
2021-02-11;"Žilinský kraj";228;23521;300;23821;NA;103171;528;2021-02-11;64818
2021-02-10;"Žilinský kraj";259;17875;267;18142;NA;103171;526;2021-02-10;64290
2021-02-09;"Žilinský kraj";377;24784;274;25058;NA;103171;651;2021-02-09;63764
2021-02-08;"Žilinský kraj";160;41375;390;41765;NA;103171;550;2021-02-08;63113
2021-02-07;"Žilinský kraj";24;46446;252;46698;NA;103171;276;2021-02-07;62563
2021-02-06;"Žilinský kraj";71;72880;367;73247;NA;103171;438;2021-02-06;62287
2021-02-05;"Žilinský kraj";248;31868;323;32191;NA;103171;571;2021-02-05;61849
2021-02-04;"Žilinský kraj";238;13242;258;13500;NA;103171;496;2021-02-04;61278
2021-02-03;"Žilinský kraj";194;9187;255;9442;NA;103171;449;2021-02-03;60782
2021-02-02;"Žilinský kraj";216;9280;272;9552;NA;103171;488;2021-02-02;60333
2021-02-01;"Žilinský kraj";220;19688;370;20058;NA;103171;590;2021-02-01;59845
2021-01-31;"Žilinský kraj";11;2652;27;2679;NA;103171;38;2021-01-31;59255
2021-01-30;"Žilinský kraj";85;18447;187;18634;NA;103171;272;2021-01-30;59217
2021-01-29;"Žilinský kraj";209;22892;304;23196;NA;103171;513;2021-01-29;58945
2021-01-28;"Žilinský kraj";240;5623;174;5797;NA;103171;414;2021-01-28;58432
2021-01-27;"Žilinský kraj";256;7065;121;7186;NA;103171;377;2021-01-27;58018
2021-01-26;"Žilinský kraj";245;49639;346;49985;NA;103171;591;2021-01-26;57641
2021-01-25;"Žilinský kraj";159;21147;150;21297;NA;103171;309;2021-01-25;57050
2021-01-24;"Žilinský kraj";22;67309;305;67614;NA;103171;327;2021-01-24;56741
2021-01-23;"Žilinský kraj";91;91232;408;91640;NA;103171;499;2021-01-23;56414
2021-01-22;"Žilinský kraj";163;31997;239;32236;NA;103171;402;2021-01-22;55915
2021-01-21;"Žilinský kraj";116;19874;181;20055;NA;103171;297;2021-01-21;55513
2021-01-20;"Žilinský kraj";236;17501;168;17669;NA;103171;404;2021-01-20;55216
2021-01-19;"Žilinský kraj";245;15578;283;15861;NA;103171;528;2021-01-19;54812
2021-01-18;"Žilinský kraj";236;12506;327;12833;NA;103171;563;2021-01-18;54284
2021-01-17;"Žilinský kraj";95;147;8;155;NA;103171;103;2021-01-17;53721
2021-01-16;"Žilinský kraj";14;758;35;793;NA;103171;49;2021-01-16;53618
2021-01-15;"Žilinský kraj";248;7244;205;7449;NA;103171;453;2021-01-15;53569
2021-01-14;"Žilinský kraj";166;5572;248;5820;NA;103171;414;2021-01-14;53116
2021-01-13;"Žilinský kraj";247;11316;555;11871;NA;103171;802;2021-01-13;52702
2021-01-12;"Žilinský kraj";376;8754;413;9167;NA;103171;789;2021-01-12;51900
2021-01-11;"Žilinský kraj";351;10385;513;10898;NA;103171;864;2021-01-11;51111
2021-01-10;"Žilinský kraj";38;229;6;235;NA;103171;44;2021-01-10;50247
2021-01-09;"Žilinský kraj";192;1983;85;2068;NA;103171;277;2021-01-09;50203
2021-01-08;"Žilinský kraj";413;9245;497;9742;NA;103171;910;2021-01-08;49926
2021-01-07;"Žilinský kraj";438;23485;1881;25366;NA;103171;2319;2021-01-07;49016
2021-01-06;"Žilinský kraj";145;1412;96;1508;NA;103171;241;2021-01-06;46697
2021-01-05;"Žilinský kraj";717;10702;845;11547;NA;103171;1562;2021-01-05;46456
2021-01-04;"Žilinský kraj";479;9739;1012;10751;NA;103171;1491;2021-01-04;44894
2021-01-03;"Žilinský kraj";13;1006;107;1113;NA;103171;120;2021-01-03;43403
2021-01-02;"Žilinský kraj";98;789;91;880;NA;103171;189;2021-01-02;43283
2021-01-01;"Žilinský kraj";118;615;37;652;NA;103171;155;2021-01-01;43094
2020-12-31;"Žilinský kraj";395;10008;809;10817;NA;103171;1204;2020-12-31;42939
2020-12-30;"Žilinský kraj";1038;12030;849;12879;NA;103171;1887;2020-12-30;41735
2020-12-29;"Žilinský kraj";256;10584;1041;11625;NA;103171;1297;2020-12-29;39848
2020-12-28;"Žilinský kraj";406;11177;1048;12225;NA;103171;1454;2020-12-28;38551
2020-12-27;"Žilinský kraj";40;684;94;778;NA;103171;134;2020-12-27;37097
2020-12-26;"Žilinský kraj";135;593;48;641;NA;103171;183;2020-12-26;36963
2020-12-25;"Žilinský kraj";66;83;9;92;NA;103171;75;2020-12-25;36780
2020-12-24;"Žilinský kraj";643;1060;80;1140;NA;103171;723;2020-12-24;36705
2020-12-23;"Žilinský kraj";228;17281;1031;18312;NA;103171;1259;2020-12-23;35982
2020-12-22;"Žilinský kraj";519;13746;1031;14777;NA;103171;1550;2020-12-22;34723
2020-12-21;"Žilinský kraj";444;12608;1096;13704;NA;103171;1540;2020-12-21;33173
2020-12-20;"Žilinský kraj";36;598;80;678;NA;103171;116;2020-12-20;31633
2020-12-19;"Žilinský kraj";208;2076;145;2221;NA;103171;353;2020-12-19;31517
2020-12-18;"Žilinský kraj";333;6925;400;7325;NA;103171;733;2020-12-18;31164
2020-12-17;"Žilinský kraj";500;4243;279;4522;NA;103171;779;2020-12-17;30431
2020-12-16;"Žilinský kraj";333;3999;280;4279;NA;103171;613;2020-12-16;29652
2020-12-15;"Žilinský kraj";528;4139;378;4517;NA;103171;906;2020-12-15;29039
2020-12-14;"Žilinský kraj";321;4300;355;4655;NA;103171;676;2020-12-14;28133
2020-12-13;"Žilinský kraj";26;494;66;560;NA;103171;92;2020-12-13;27457
2020-12-12;"Žilinský kraj";95;1116;61;1177;NA;103171;156;2020-12-12;27365
2020-12-11;"Žilinský kraj";455;4507;269;4776;NA;103171;724;2020-12-11;27209
2020-12-10;"Žilinský kraj";166;9341;838;10179;NA;103171;1004;2020-12-10;26485
2020-12-09;"Žilinský kraj";392;2200;131;2331;NA;103171;523;2020-12-09;25481
2020-12-08;"Žilinský kraj";331;3248;123;3371;NA;103171;454;2020-12-08;24958
2020-12-07;"Žilinský kraj";348;2254;127;2381;NA;103171;475;2020-12-07;24504
2020-12-06;"Žilinský kraj";15;128;6;134;NA;103171;21;2020-12-06;24029
2020-12-05;"Žilinský kraj";98;1500;53;1553;NA;103171;151;2020-12-05;24008
2020-12-04;"Žilinský kraj";228;2891;122;3013;NA;103171;350;2020-12-04;23857
2020-12-03;"Žilinský kraj";237;1424;117;1541;NA;103171;354;2020-12-03;23507
2020-12-02;"Žilinský kraj";181;1396;69;1465;NA;103171;250;2020-12-02;23153
2020-12-01;"Žilinský kraj";209;6239;284;6523;NA;103171;493;2020-12-01;22903
2020-11-30;"Žilinský kraj";203;5326;305;5631;NA;103171;508;2020-11-30;22410
2020-11-29;"Žilinský kraj";18;81;7;88;NA;103171;25;2020-11-29;21902
2020-11-28;"Žilinský kraj";99;349;15;364;NA;103171;114;2020-11-28;21877
2020-11-27;"Žilinský kraj";218;904;46;950;NA;103171;264;2020-11-27;21763
2020-11-26;"Žilinský kraj";190;1041;54;1095;NA;103171;244;2020-11-26;21499
2020-11-25;"Žilinský kraj";225;1217;49;1266;NA;103171;274;2020-11-25;21255
2020-11-24;"Žilinský kraj";213;2139;67;2206;NA;103171;280;2020-11-24;20981
2020-11-23;"Žilinský kraj";170;759;44;803;NA;103171;214;2020-11-23;20701
2020-11-22;"Žilinský kraj";11;67;2;69;NA;103171;13;2020-11-22;20487
2020-11-21;"Žilinský kraj";61;505;20;525;NA;103171;81;2020-11-21;20474
2020-11-20;"Žilinský kraj";251;1074;45;1119;NA;103171;296;2020-11-20;20393
2020-11-19;"Žilinský kraj";252;752;61;813;NA;103171;313;2020-11-19;20097
2020-11-18;"Žilinský kraj";346;348;15;363;NA;103171;361;2020-11-18;19784
2020-11-17;"Žilinský kraj";123;490;15;505;NA;103171;138;2020-11-17;19423
2020-11-16;"Žilinský kraj";227;247;15;262;NA;103171;242;2020-11-16;19285
2020-11-15;"Žilinský kraj";63;13;0;13;NA;103171;63;2020-11-15;19043
2020-11-14;"Žilinský kraj";189;1038;11;1049;NA;103171;200;2020-11-14;18980
2020-11-13;"Žilinský kraj";181;125;9;134;NA;103171;190;2020-11-13;18780
2020-11-12;"Žilinský kraj";334;79;2;81;NA;103171;336;2020-11-12;18590
2020-11-11;"Žilinský kraj";489;147;10;157;NA;103171;499;2020-11-11;18254
2020-11-10;"Žilinský kraj";374;519;9;528;NA;103171;383;2020-11-10;17755
2020-11-09;"Žilinský kraj";143;2335;30;2365;NA;103171;173;2020-11-09;17372
2020-11-08;"Žilinský kraj";59;2538;37;2575;NA;103171;96;2020-11-08;17199
2020-11-07;"Žilinský kraj";312;8175;88;8263;NA;103171;400;2020-11-07;17103
2020-11-06;"Žilinský kraj";503;4090;38;4128;NA;103171;541;2020-11-06;16703
2020-11-05;"Žilinský kraj";473;64;4;68;NA;103171;477;2020-11-05;16162
2020-11-04;"Žilinský kraj";423;178;10;188;NA;103171;433;2020-11-04;15685
2020-11-03;"Žilinský kraj";688;889;16;905;NA;103171;704;2020-11-03;15252
2020-11-02;"Žilinský kraj";472;1043;39;1082;NA;103171;511;2020-11-02;14548
2020-11-01;"Žilinský kraj";349;5096;130;5226;NA;103171;479;2020-11-01;14037
2020-10-31;"Žilinský kraj";661;7963;203;8166;NA;103171;864;2020-10-31;13558
2020-10-30;"Žilinský kraj";529;2575;61;2636;NA;103171;590;2020-10-30;12694
2020-10-29;"Žilinský kraj";740;503;17;520;NA;103171;757;2020-10-29;12104
2020-10-28;"Žilinský kraj";635;105;11;116;NA;103171;646;2020-10-28;11347
2020-10-27;"Žilinský kraj";355;154;24;178;NA;103171;379;2020-10-27;10701
2020-10-26;"Žilinský kraj";148;117;28;145;NA;103171;176;2020-10-26;10322
2020-10-25;"Žilinský kraj";436;0;0;0;NA;103171;436;2020-10-25;10146
2020-10-24;"Žilinský kraj";803;0;0;0;NA;103171;803;2020-10-24;9710
2020-10-23;"Žilinský kraj";659;102;13;115;NA;103171;672;2020-10-23;8907
2020-10-22;"Žilinský kraj";525;33;3;36;NA;103171;528;2020-10-22;8235
2020-10-21;"Žilinský kraj";478;74;14;88;NA;103171;492;2020-10-21;7707
2020-10-20;"Žilinský kraj";524;127;8;135;NA;103171;532;2020-10-20;7215
2020-10-19;"Žilinský kraj";70;80;12;92;NA;103171;82;2020-10-19;6683
2020-10-18;"Žilinský kraj";159;0;0;0;NA;103171;159;2020-10-18;6601
2020-10-17;"Žilinský kraj";509;0;0;0;NA;103171;509;2020-10-17;6442
2020-10-16;"Žilinský kraj";603;51;9;60;NA;103171;612;2020-10-16;5933
2020-10-15;"Žilinský kraj";679;61;3;64;NA;103171;682;2020-10-15;5321
2020-10-14;"Žilinský kraj";523;269;6;275;NA;103171;529;2020-10-14;4639
2020-10-13;"Žilinský kraj";367;458;40;498;NA;103171;407;2020-10-13;4110
2020-10-12;"Žilinský kraj";62;0;0;0;NA;103171;62;2020-10-12;3703
2020-10-11;"Žilinský kraj";50;0;0;0;NA;103171;50;2020-10-11;3641
2020-10-10;"Žilinský kraj";213;0;0;0;NA;103171;213;2020-10-10;3591
2020-10-09;"Žilinský kraj";543;0;0;0;NA;103171;543;2020-10-09;3378
2020-10-08;"Žilinský kraj";238;0;0;0;NA;103171;238;2020-10-08;2835
2020-10-07;"Žilinský kraj";168;0;0;0;NA;103171;168;2020-10-07;2597
2020-10-06;"Žilinský kraj";233;0;0;0;NA;103171;233;2020-10-06;2429
2020-10-05;"Žilinský kraj";33;0;0;0;NA;103171;33;2020-10-05;2196
2020-10-04;"Žilinský kraj";35;0;0;0;NA;103171;35;2020-10-04;2163
2020-10-03;"Žilinský kraj";155;0;0;0;NA;103171;155;2020-10-03;2128
2020-10-02;"Žilinský kraj";105;0;0;0;NA;103171;105;2020-10-02;1973
2020-10-01;"Žilinský kraj";147;0;0;0;NA;103171;147;2020-10-01;1868
2020-09-30;"Žilinský kraj";163;0;0;0;NA;103171;163;2020-09-30;1721
2020-09-29;"Žilinský kraj";105;0;0;0;NA;103171;105;2020-09-29;1558
2020-09-28;"Žilinský kraj";34;0;0;0;NA;103171;34;2020-09-28;1453
2020-09-27;"Žilinský kraj";108;0;0;0;NA;103171;108;2020-09-27;1419
2020-09-26;"Žilinský kraj";96;0;0;0;NA;103171;96;2020-09-26;1311
2020-09-25;"Žilinský kraj";69;0;0;0;NA;103171;69;2020-09-25;1215
2020-09-24;"Žilinský kraj";100;0;0;0;NA;103171;100;2020-09-24;1146
2020-09-23;"Žilinský kraj";65;0;0;0;NA;103171;65;2020-09-23;1046
2020-09-22;"Žilinský kraj";65;0;0;0;NA;103171;65;2020-09-22;981
2020-09-21;"Žilinský kraj";47;0;0;0;NA;103171;47;2020-09-21;916
2020-09-20;"Žilinský kraj";4;0;0;0;NA;103171;4;2020-09-20;869
2020-09-19;"Žilinský kraj";6;0;0;0;NA;103171;6;2020-09-19;865
2020-09-18;"Žilinský kraj";82;0;0;0;NA;103171;82;2020-09-18;859
2020-09-17;"Žilinský kraj";30;0;0;0;NA;103171;30;2020-09-17;777
2020-09-16;"Žilinský kraj";34;0;0;0;NA;103171;34;2020-09-16;747
2020-09-15;"Žilinský kraj";12;0;0;0;NA;103171;12;2020-09-15;713
2020-09-14;"Žilinský kraj";39;0;0;0;NA;103171;39;2020-09-14;701
2020-09-13;"Žilinský kraj";6;0;0;0;NA;103171;6;2020-09-13;662
2020-09-12;"Žilinský kraj";4;0;0;0;NA;103171;4;2020-09-12;656
2020-09-11;"Žilinský kraj";31;0;0;0;NA;103171;31;2020-09-11;652
2020-09-10;"Žilinský kraj";31;0;0;0;NA;103171;31;2020-09-10;621
2020-09-09;"Žilinský kraj";23;0;0;0;NA;103171;23;2020-09-09;590
2020-09-08;"Žilinský kraj";25;0;0;0;NA;103171;25;2020-09-08;567
2020-09-07;"Žilinský kraj";11;0;0;0;NA;103171;11;2020-09-07;542
2020-09-06;"Žilinský kraj";0;0;0;0;NA;103171;0;2020-09-06;531
2020-09-05;"Žilinský kraj";2;0;0;0;NA;103171;2;2020-09-05;531
2020-09-04;"Žilinský kraj";33;0;0;0;NA;103171;33;2020-09-04;529
2020-09-03;"Žilinský kraj";18;0;0;0;NA;103171;18;2020-09-03;496
2020-09-02;"Žilinský kraj";16;0;0;0;NA;103171;16;2020-09-02;478
2020-09-01;"Žilinský kraj";4;0;0;0;NA;103171;4;2020-09-01;462
2020-08-31;"Žilinský kraj";5;0;0;0;NA;103171;5;2020-08-31;458
2020-08-30;"Žilinský kraj";3;0;0;0;NA;103171;3;2020-08-30;453
2020-08-29;"Žilinský kraj";5;0;0;0;NA;103171;5;2020-08-29;450
2020-08-28;"Žilinský kraj";13;0;0;0;NA;103171;13;2020-08-28;445
2020-08-27;"Žilinský kraj";18;0;0;0;NA;103171;18;2020-08-27;432
2020-08-26;"Žilinský kraj";8;0;0;0;NA;103171;8;2020-08-26;414
2020-08-25;"Žilinský kraj";2;0;0;0;NA;103171;2;2020-08-25;406
2020-08-24;"Žilinský kraj";5;0;0;0;NA;103171;5;2020-08-24;404
2020-08-23;"Žilinský kraj";0;0;0;0;NA;103171;0;2020-08-23;399
2020-08-22;"Žilinský kraj";0;0;0;0;NA;103171;0;2020-08-22;399
2020-08-21;"Žilinský kraj";10;0;0;0;NA;103171;10;2020-08-21;399
2020-08-20;"Žilinský kraj";13;0;0;0;NA;103171;13;2020-08-20;389
2020-08-19;"Žilinský kraj";7;0;0;0;NA;103171;7;2020-08-19;376
2020-08-18;"Žilinský kraj";9;0;0;0;NA;103171;9;2020-08-18;369
2020-08-17;"Žilinský kraj";1;0;0;0;NA;103171;1;2020-08-17;360
2020-08-16;"Žilinský kraj";0;0;0;0;NA;103171;0;2020-08-16;359
2020-08-15;"Žilinský kraj";0;0;0;0;NA;103171;0;2020-08-15;359
2020-08-14;"Žilinský kraj";4;0;0;0;NA;103171;4;2020-08-14;359
2020-08-13;"Žilinský kraj";2;0;0;0;NA;103171;2;2020-08-13;355
2020-08-12;"Žilinský kraj";0;0;0;0;NA;103171;0;2020-08-12;353
2020-08-11;"Žilinský kraj";4;0;0;0;NA;103171;4;2020-08-11;353
2020-08-10;"Žilinský kraj";1;0;0;0;NA;103171;1;2020-08-10;349
2020-08-09;"Žilinský kraj";0;0;0;0;NA;103171;0;2020-08-09;348
2020-08-08;"Žilinský kraj";3;0;0;0;NA;103171;3;2020-08-08;348
2020-08-07;"Žilinský kraj";8;0;0;0;NA;103171;8;2020-08-07;345
2020-08-06;"Žilinský kraj";1;0;0;0;NA;103171;1;2020-08-06;337
2020-08-05;"Žilinský kraj";1;0;0;0;NA;103171;1;2020-08-05;336
2020-08-04;"Žilinský kraj";2;0;0;0;NA;103171;2;2020-08-04;335
2020-08-03;"Žilinský kraj";0;0;0;0;NA;103171;0;2020-08-03;333
2020-08-02;"Žilinský kraj";1;0;0;0;NA;103171;1;2020-08-02;333
2020-08-01;"Žilinský kraj";0;0;0;0;NA;103171;0;2020-08-01;332
2020-07-31;"Žilinský kraj";4;0;0;0;NA;103171;4;2020-07-31;332
2020-07-30;"Žilinský kraj";2;0;0;0;NA;103171;2;2020-07-30;328
2020-07-29;"Žilinský kraj";2;0;0;0;NA;103171;2;2020-07-29;326
2020-07-28;"Žilinský kraj";4;0;0;0;NA;103171;4;2020-07-28;324
2020-07-27;"Žilinský kraj";6;0;0;0;NA;103171;6;2020-07-27;320
2020-07-26;"Žilinský kraj";0;0;0;0;NA;103171;0;2020-07-26;314
2020-07-25;"Žilinský kraj";0;0;0;0;NA;103171;0;2020-07-25;314
2020-07-24;"Žilinský kraj";2;0;0;0;NA;103171;2;2020-07-24;314
2020-07-23;"Žilinský kraj";0;0;0;0;NA;103171;0;2020-07-23;312
2020-07-22;"Žilinský kraj";1;0;0;0;NA;103171;1;2020-07-22;312
2020-07-21;"Žilinský kraj";2;0;0;0;NA;103171;2;2020-07-21;311
2020-07-20;"Žilinský kraj";3;0;0;0;NA;103171;3;2020-07-20;309
2020-07-19;"Žilinský kraj";0;0;0;0;NA;103171;0;2020-07-19;306
2020-07-18;"Žilinský kraj";0;0;0;0;NA;103171;0;2020-07-18;306
2020-07-17;"Žilinský kraj";2;0;0;0;NA;103171;2;2020-07-17;306
2020-07-16;"Žilinský kraj";2;0;0;0;NA;103171;2;2020-07-16;304
2020-07-15;"Žilinský kraj";2;0;0;0;NA;103171;2;2020-07-15;302
2020-07-14;"Žilinský kraj";1;0;0;0;NA;103171;1;2020-07-14;300
2020-07-13;"Žilinský kraj";0;0;0;0;NA;103171;0;2020-07-13;299
2020-07-12;"Žilinský kraj";0;0;0;0;NA;103171;0;2020-07-12;299
2020-07-11;"Žilinský kraj";2;0;0;0;NA;103171;2;2020-07-11;299
2020-07-10;"Žilinský kraj";3;0;0;0;NA;103171;3;2020-07-10;297
2020-07-09;"Žilinský kraj";2;0;0;0;NA;103171;2;2020-07-09;294
2020-07-08;"Žilinský kraj";10;0;0;0;NA;103171;10;2020-07-08;292
2020-07-07;"Žilinský kraj";7;0;0;0;NA;103171;7;2020-07-07;282
2020-07-06;"Žilinský kraj";0;0;0;0;NA;103171;0;2020-07-06;275
2020-07-05;"Žilinský kraj";0;0;0;0;NA;103171;0;2020-07-05;275
2020-07-04;"Žilinský kraj";10;0;0;0;NA;103171;10;2020-07-04;275
2020-07-03;"Žilinský kraj";18;0;0;0;NA;103171;18;2020-07-03;265
2020-07-02;"Žilinský kraj";7;0;0;0;NA;103171;7;2020-07-02;247
2020-07-01;"Žilinský kraj";0;0;0;0;NA;103171;0;2020-07-01;240
2020-06-30;"Žilinský kraj";4;0;0;0;NA;103171;4;2020-06-30;240
2020-06-29;"Žilinský kraj";0;0;0;0;NA;103171;0;2020-06-29;236
2020-06-28;"Žilinský kraj";1;0;0;0;NA;103171;1;2020-06-28;236
2020-06-27;"Žilinský kraj";3;0;0;0;NA;103171;3;2020-06-27;235
2020-06-26;"Žilinský kraj";5;0;0;0;NA;103171;5;2020-06-26;232
2020-06-25;"Žilinský kraj";7;0;0;0;NA;103171;7;2020-06-25;227
2020-06-24;"Žilinský kraj";11;0;0;0;NA;103171;11;2020-06-24;220
2020-06-23;"Žilinský kraj";9;0;0;0;NA;103171;9;2020-06-23;209
2020-06-22;"Žilinský kraj";0;0;0;0;NA;103171;0;2020-06-22;200
2020-06-21;"Žilinský kraj";1;0;0;0;NA;103171;1;2020-06-21;200
2020-06-20;"Žilinský kraj";1;0;0;0;NA;103171;1;2020-06-20;199
2020-06-19;"Žilinský kraj";4;0;0;0;NA;103171;4;2020-06-19;198
2020-06-18;"Žilinský kraj";1;0;0;0;NA;103171;1;2020-06-18;194
2020-06-17;"Žilinský kraj";0;0;0;0;NA;103171;0;2020-06-17;193
2020-06-16;"Žilinský kraj";1;0;0;0;NA;103171;1;2020-06-16;193
2020-06-14;"Žilinský kraj";0;0;0;0;NA;103171;0;2020-06-14;192
2020-06-13;"Žilinský kraj";0;0;0;0;NA;103171;0;2020-06-13;192
2020-06-12;"Žilinský kraj";0;0;0;0;NA;103171;0;2020-06-12;192
2020-06-11;"Žilinský kraj";0;0;0;0;NA;103171;0;2020-06-11;192
2020-06-10;"Žilinský kraj";0;0;0;0;NA;103171;0;2020-06-10;192
2020-06-09;"Žilinský kraj";1;0;0;0;NA;103171;1;2020-06-09;192
2020-06-08;"Žilinský kraj";0;0;0;0;NA;103171;0;2020-06-08;191
2020-06-07;"Žilinský kraj";0;0;0;0;NA;103171;0;2020-06-07;191
2020-06-05;"Žilinský kraj";0;0;0;0;NA;103171;0;2020-06-05;191
2020-06-03;"Žilinský kraj";0;0;0;0;NA;103171;0;2020-06-03;191
2020-06-02;"Žilinský kraj";0;0;0;0;NA;103171;0;2020-06-02;191
2020-05-31;"Žilinský kraj";0;0;0;0;NA;103171;0;2020-05-31;191
2020-05-29;"Žilinský kraj";0;0;0;0;NA;103171;0;2020-05-29;191
2020-05-27;"Žilinský kraj";1;0;0;0;NA;103171;1;2020-05-27;191
2020-05-26;"Žilinský kraj";1;0;0;0;NA;103171;1;2020-05-26;190
2020-05-25;"Žilinský kraj";0;0;0;0;NA;103171;0;2020-05-25;189
2020-05-24;"Žilinský kraj";0;0;0;0;NA;103171;0;2020-05-24;189
2020-05-23;"Žilinský kraj";0;0;0;0;NA;103171;0;2020-05-23;189
2020-05-22;"Žilinský kraj";0;0;0;0;NA;103171;0;2020-05-22;189
2020-05-21;"Žilinský kraj";0;0;0;0;NA;103171;0;2020-05-21;189
2020-05-20;"Žilinský kraj";0;0;0;0;NA;103171;0;2020-05-20;189
2020-05-19;"Žilinský kraj";1;0;0;0;NA;103171;1;2020-05-19;189
2020-05-17;"Žilinský kraj";0;0;0;0;NA;103171;0;2020-05-17;188
2020-05-16;"Žilinský kraj";0;0;0;0;NA;103171;0;2020-05-16;188
2020-05-15;"Žilinský kraj";0;0;0;0;NA;103171;0;2020-05-15;188
2020-05-14;"Žilinský kraj";0;0;0;0;NA;103171;0;2020-05-14;188
2020-05-13;"Žilinský kraj";0;0;0;0;NA;103171;0;2020-05-13;188
2020-05-12;"Žilinský kraj";0;0;0;0;NA;103171;0;2020-05-12;188
2020-05-11;"Žilinský kraj";0;0;0;0;NA;103171;0;2020-05-11;188
2020-05-09;"Žilinský kraj";0;0;0;0;NA;103171;0;2020-05-09;188
2020-05-07;"Žilinský kraj";0;0;0;0;NA;103171;0;2020-05-07;188
2020-05-06;"Žilinský kraj";2;0;0;0;NA;103171;2;2020-05-06;188
2020-05-05;"Žilinský kraj";3;0;0;0;NA;103171;3;2020-05-05;186
2020-05-04;"Žilinský kraj";3;0;0;0;NA;103171;3;2020-05-04;183
2020-05-03;"Žilinský kraj";1;0;0;0;NA;103171;1;2020-05-03;180
2020-05-02;"Žilinský kraj";0;0;0;0;NA;103171;0;2020-05-02;179
2020-05-01;"Žilinský kraj";1;0;0;0;NA;103171;1;2020-05-01;179
2020-04-30;"Žilinský kraj";0;0;0;0;NA;103171;0;2020-04-30;178
2020-04-29;"Žilinský kraj";0;0;0;0;NA;103171;0;2020-04-29;178
2020-04-28;"Žilinský kraj";0;0;0;0;NA;103171;0;2020-04-28;178
2020-04-27;"Žilinský kraj";0;0;0;0;NA;103171;0;2020-04-27;178
2020-04-26;"Žilinský kraj";0;0;0;0;NA;103171;0;2020-04-26;178
2020-04-25;"Žilinský kraj";2;0;0;0;NA;103171;2;2020-04-25;178
2020-04-24;"Žilinský kraj";1;0;0;0;NA;103171;1;2020-04-24;176
2020-04-23;"Žilinský kraj";2;0;0;0;NA;103171;2;2020-04-23;175
2020-04-22;"Žilinský kraj";9;0;0;0;NA;103171;9;2020-04-22;173
2020-04-21;"Žilinský kraj";1;0;0;0;NA;103171;1;2020-04-21;164
2020-04-20;"Žilinský kraj";4;0;0;0;NA;103171;4;2020-04-20;163
2020-04-19;"Žilinský kraj";0;0;0;0;NA;103171;0;2020-04-19;159
2020-04-18;"Žilinský kraj";49;0;0;0;NA;103171;49;2020-04-18;159
2020-04-17;"Žilinský kraj";3;0;0;0;NA;103171;3;2020-04-17;110
2020-04-16;"Žilinský kraj";4;0;0;0;NA;103171;4;2020-04-16;107
2020-04-15;"Žilinský kraj";7;0;0;0;NA;103171;7;2020-04-15;103
2020-04-14;"Žilinský kraj";1;0;0;0;NA;103171;1;2020-04-14;96
2020-04-13;"Žilinský kraj";2;0;0;0;NA;103171;2;2020-04-13;95
2020-04-12;"Žilinský kraj";5;0;0;0;NA;103171;5;2020-04-12;93
2020-04-11;"Žilinský kraj";2;0;0;0;NA;103171;2;2020-04-11;88
2020-04-10;"Žilinský kraj";1;0;0;0;NA;103171;1;2020-04-10;86
2020-04-09;"Žilinský kraj";1;0;0;0;NA;103171;1;2020-04-09;85
2020-04-08;"Žilinský kraj";3;0;0;0;NA;103171;3;2020-04-08;84
2020-04-07;"Žilinský kraj";5;0;0;0;NA;103171;5;2020-04-07;81
2020-04-06;"Žilinský kraj";6;0;0;0;NA;103171;6;2020-04-06;76
2020-04-05;"Žilinský kraj";8;0;0;0;NA;103171;8;2020-04-05;70
2020-04-04;"Žilinský kraj";0;0;0;0;NA;103171;0;2020-04-04;62
2020-04-03;"Žilinský kraj";3;0;0;0;NA;103171;3;2020-04-03;62
2020-04-02;"Žilinský kraj";5;0;0;0;NA;103171;5;2020-04-02;59
2020-04-01;"Žilinský kraj";4;0;0;0;NA;103171;4;2020-04-01;54
2020-03-31;"Žilinský kraj";1;0;0;0;NA;103171;1;2020-03-31;50
2020-03-30;"Žilinský kraj";3;0;0;0;NA;103171;3;2020-03-30;49
2020-03-29;"Žilinský kraj";0;0;0;0;NA;103171;0;2020-03-29;46
2020-03-28;"Žilinský kraj";1;0;0;0;NA;103171;1;2020-03-28;46
2020-03-27;"Žilinský kraj";9;0;0;0;NA;103171;9;2020-03-27;45
2020-03-26;"Žilinský kraj";4;0;0;0;NA;103171;4;2020-03-26;36
2020-03-25;"Žilinský kraj";1;0;0;0;NA;103171;1;2020-03-25;32
2020-03-24;"Žilinský kraj";2;0;0;0;NA;103171;2;2020-03-24;31
2020-03-23;"Žilinský kraj";3;0;0;0;NA;103171;3;2020-03-23;29
2020-03-22;"Žilinský kraj";1;0;0;0;NA;103171;1;2020-03-22;26
2020-03-21;"Žilinský kraj";2;0;0;0;NA;103171;2;2020-03-21;25
2020-03-20;"Žilinský kraj";4;0;0;0;NA;103171;4;2020-03-20;23
2020-03-19;"Žilinský kraj";2;0;0;0;NA;103171;2;2020-03-19;19
2020-03-18;"Žilinský kraj";1;0;0;0;NA;103171;1;2020-03-18;17
2020-03-17;"Žilinský kraj";5;0;0;0;NA;103171;5;2020-03-17;16
2020-03-16;"Žilinský kraj";1;0;0;0;NA;103171;1;2020-03-16;11
2020-03-15;"Žilinský kraj";2;0;0;0;NA;103171;2;2020-03-15;10
2020-03-14;"Žilinský kraj";1;0;0;0;NA;103171;1;2020-03-14;8
2020-03-13;"Žilinský kraj";5;0;0;0;NA;103171;5;2020-03-13;7
2020-03-12;"Žilinský kraj";1;0;0;0;NA;103171;1;2020-03-12;2
2020-03-11;"Žilinský kraj";0;0;0;0;NA;103171;0;2020-03-11;1
2020-03-09;"Žilinský kraj";1;0;0;0;NA;103171;1;2020-03-09;1
2020-03-08;"Žilinský kraj";0;0;0;0;NA;103171;0;2020-03-08;0
2020-03-07;"Žilinský kraj";0;0;0;0;NA;103171;0;2020-03-07;0
2020-03-06;"Žilinský kraj";0;0;0;0;NA;103171;0;2020-03-06;0
