"Datum";"Region";"PCR_Pos";"Ag_Neg";"Ag_Pos";"Total";"Pocet.potvrdenych";"Potvrdenych";"newcases";"date";"positive"
2021-06-22;"Banskobystrický kraj";7;3114;0;3114;0;45674;7;2021-06-22;45674
2021-06-21;"Banskobystrický kraj";6;4984;6;4990;NA;45674;12;2021-06-21;45667
2021-06-20;"Banskobystrický kraj";0;4339;6;4345;NA;45674;6;2021-06-20;45655
2021-06-19;"Banskobystrický kraj";0;5072;4;5076;NA;45674;4;2021-06-19;45649
2021-06-18;"Banskobystrický kraj";4;7457;1;7458;NA;45674;5;2021-06-18;45645
2021-06-17;"Banskobystrický kraj";2;5067;3;5070;NA;45674;5;2021-06-17;45640
2021-06-16;"Banskobystrický kraj";10;5769;5;5774;NA;45674;15;2021-06-16;45635
2021-06-15;"Banskobystrický kraj";9;5550;6;5556;NA;45674;15;2021-06-15;45620
2021-06-14;"Banskobystrický kraj";8;6805;7;6812;NA;45674;15;2021-06-14;45605
2021-06-13;"Banskobystrický kraj";0;6181;7;6188;NA;45674;7;2021-06-13;45590
2021-06-12;"Banskobystrický kraj";3;6168;5;6173;NA;45674;8;2021-06-12;45583
2021-06-11;"Banskobystrický kraj";5;9399;13;9412;NA;45674;18;2021-06-11;45575
2021-06-10;"Banskobystrický kraj";10;5545;7;5552;NA;45674;17;2021-06-10;45557
2021-06-09;"Banskobystrický kraj";9;5536;2;5538;NA;45674;11;2021-06-09;45540
2021-06-08;"Banskobystrický kraj";15;5594;10;5604;NA;45674;25;2021-06-08;45529
2021-06-07;"Banskobystrický kraj";4;7367;19;7386;NA;45674;23;2021-06-07;45504
2021-06-06;"Banskobystrický kraj";1;7246;11;7257;NA;45674;12;2021-06-06;45481
2021-06-05;"Banskobystrický kraj";15;7290;8;7298;NA;45674;23;2021-06-05;45469
2021-06-04;"Banskobystrický kraj";2;8707;12;8719;NA;45674;14;2021-06-04;45446
2021-06-03;"Banskobystrický kraj";8;6293;21;6314;NA;45674;29;2021-06-03;45432
2021-06-02;"Banskobystrický kraj";7;6597;5;6602;NA;45674;12;2021-06-02;45403
2021-06-01;"Banskobystrický kraj";12;7081;14;7095;NA;45674;26;2021-06-01;45391
2021-05-31;"Banskobystrický kraj";4;9298;28;9326;NA;45674;32;2021-05-31;45365
2021-05-30;"Banskobystrický kraj";3;8698;18;8716;NA;45674;21;2021-05-30;45333
2021-05-29;"Banskobystrický kraj";11;9209;13;9222;NA;45674;24;2021-05-29;45312
2021-05-28;"Banskobystrický kraj";13;11510;23;11533;NA;45674;36;2021-05-28;45288
2021-05-27;"Banskobystrický kraj";7;8760;12;8772;NA;45674;19;2021-05-27;45252
2021-05-26;"Banskobystrický kraj";18;7623;16;7639;NA;45674;34;2021-05-26;45233
2021-05-25;"Banskobystrický kraj";27;8883;30;8913;NA;45674;57;2021-05-25;45199
2021-05-24;"Banskobystrický kraj";9;12469;44;12513;NA;45674;53;2021-05-24;45142
2021-05-23;"Banskobystrický kraj";0;9522;25;9547;NA;45674;25;2021-05-23;45089
2021-05-22;"Banskobystrický kraj";20;9368;26;9394;NA;45674;46;2021-05-22;45064
2021-05-21;"Banskobystrický kraj";22;12364;21;12385;NA;45674;43;2021-05-21;45018
2021-05-20;"Banskobystrický kraj";14;8561;24;8585;NA;45674;38;2021-05-20;44975
2021-05-19;"Banskobystrický kraj";42;8344;18;8362;NA;45674;60;2021-05-19;44937
2021-05-18;"Banskobystrický kraj";27;9341;25;9366;NA;45674;52;2021-05-18;44877
2021-05-17;"Banskobystrický kraj";11;13179;29;13208;NA;45674;40;2021-05-17;44825
2021-05-16;"Banskobystrický kraj";15;13730;24;13754;NA;45674;39;2021-05-16;44785
2021-05-15;"Banskobystrický kraj";11;15020;29;15049;NA;45674;40;2021-05-15;44746
2021-05-14;"Banskobystrický kraj";35;18116;43;18159;NA;45674;78;2021-05-14;44706
2021-05-13;"Banskobystrický kraj";37;10605;40;10645;NA;45674;77;2021-05-13;44628
2021-05-12;"Banskobystrický kraj";31;10835;45;10880;NA;45674;76;2021-05-12;44551
2021-05-11;"Banskobystrický kraj";42;11227;48;11275;NA;45674;90;2021-05-11;44475
2021-05-10;"Banskobystrický kraj";28;17297;63;17360;NA;45674;91;2021-05-10;44385
2021-05-09;"Banskobystrický kraj";25;21333;66;21399;NA;45674;91;2021-05-09;44294
2021-05-08;"Banskobystrický kraj";11;13686;23;13709;NA;45674;34;2021-05-08;44203
2021-05-07;"Banskobystrický kraj";41;21278;74;21352;NA;45674;115;2021-05-07;44169
2021-05-06;"Banskobystrický kraj";36;12251;70;12321;NA;45674;106;2021-05-06;44054
2021-05-05;"Banskobystrický kraj";34;12592;63;12655;NA;45674;97;2021-05-05;43948
2021-05-04;"Banskobystrický kraj";83;13888;47;13935;NA;45674;130;2021-05-04;43851
2021-05-03;"Banskobystrický kraj";30;20872;80;20952;NA;45674;110;2021-05-03;43721
2021-05-02;"Banskobystrický kraj";6;32623;60;32683;NA;45674;66;2021-05-02;43611
2021-05-01;"Banskobystrický kraj";54;36770;67;36837;NA;45674;121;2021-05-01;43545
2021-04-30;"Banskobystrický kraj";38;34953;86;35039;NA;45674;124;2021-04-30;43424
2021-04-29;"Banskobystrický kraj";55;16839;68;16907;NA;45674;123;2021-04-29;43300
2021-04-28;"Banskobystrický kraj";66;17959;67;18026;NA;45674;133;2021-04-28;43177
2021-04-27;"Banskobystrický kraj";70;19152;73;19225;NA;45674;143;2021-04-27;43044
2021-04-26;"Banskobystrický kraj";34;28514;101;28615;NA;45674;135;2021-04-26;42901
2021-04-25;"Banskobystrický kraj";14;40204;106;40310;NA;45674;120;2021-04-25;42766
2021-04-24;"Banskobystrický kraj";40;51625;98;51723;NA;45674;138;2021-04-24;42646
2021-04-23;"Banskobystrický kraj";78;37724;88;37812;NA;45674;166;2021-04-23;42508
2021-04-22;"Banskobystrický kraj";51;17412;57;17469;NA;45674;108;2021-04-22;42342
2021-04-21;"Banskobystrický kraj";76;19192;94;19286;NA;45674;170;2021-04-21;42234
2021-04-20;"Banskobystrický kraj";116;21233;98;21331;NA;45674;214;2021-04-20;42064
2021-04-19;"Banskobystrický kraj";48;31407;105;31512;NA;45674;153;2021-04-19;41850
2021-04-18;"Banskobystrický kraj";16;42953;90;43043;NA;45674;106;2021-04-18;41697
2021-04-17;"Banskobystrický kraj";42;64939;92;65031;NA;45674;134;2021-04-17;41591
2021-04-16;"Banskobystrický kraj";72;37303;100;37403;NA;45674;172;2021-04-16;41457
2021-04-15;"Banskobystrický kraj";67;20117;83;20200;NA;45674;150;2021-04-15;41285
2021-04-14;"Banskobystrický kraj";69;21257;86;21343;NA;45674;155;2021-04-14;41135
2021-04-13;"Banskobystrický kraj";130;23076;77;23153;NA;45674;207;2021-04-13;40980
2021-04-12;"Banskobystrický kraj";60;32247;130;32377;NA;45674;190;2021-04-12;40773
2021-04-11;"Banskobystrický kraj";0;41367;88;41455;NA;45674;88;2021-04-11;40583
2021-04-10;"Banskobystrický kraj";56;64628;141;64769;NA;45674;197;2021-04-10;40495
2021-04-09;"Banskobystrický kraj";106;31566;118;31684;NA;45674;224;2021-04-09;40298
2021-04-08;"Banskobystrický kraj";132;18406;110;18516;NA;45674;242;2021-04-08;40074
2021-04-07;"Banskobystrický kraj";226;25117;94;25211;NA;45674;320;2021-04-07;39832
2021-04-06;"Banskobystrický kraj";93;42487;187;42674;NA;45674;280;2021-04-06;39512
2021-04-05;"Banskobystrický kraj";15;11797;87;11884;NA;45674;102;2021-04-05;39232
2021-04-04;"Banskobystrický kraj";24;19683;79;19762;NA;45674;103;2021-04-04;39130
2021-04-03;"Banskobystrický kraj";5;72553;211;72764;NA;45674;216;2021-04-03;39027
2021-04-02;"Banskobystrický kraj";71;13455;66;13521;NA;45674;137;2021-04-02;38811
2021-04-01;"Banskobystrický kraj";171;38877;200;39077;NA;45674;371;2021-04-01;38674
2021-03-31;"Banskobystrický kraj";147;25543;161;25704;NA;45674;308;2021-03-31;38303
2021-03-30;"Banskobystrický kraj";167;21439;159;21598;NA;45674;326;2021-03-30;37995
2021-03-29;"Banskobystrický kraj";119;29491;218;29709;NA;45674;337;2021-03-29;37669
2021-03-28;"Banskobystrický kraj";25;40610;189;40799;NA;45674;214;2021-03-28;37332
2021-03-27;"Banskobystrický kraj";85;64324;260;64584;NA;45674;345;2021-03-27;37118
2021-03-26;"Banskobystrický kraj";122;43657;240;43897;NA;45674;362;2021-03-26;36773
2021-03-25;"Banskobystrický kraj";120;21589;240;21829;NA;45674;360;2021-03-25;36411
2021-03-24;"Banskobystrický kraj";200;19319;227;19546;NA;45674;427;2021-03-24;36051
2021-03-23;"Banskobystrický kraj";241;21538;257;21795;NA;45674;498;2021-03-23;35624
2021-03-22;"Banskobystrický kraj";65;30478;274;30752;NA;45674;339;2021-03-22;35126
2021-03-21;"Banskobystrický kraj";31;40039;280;40319;NA;45674;311;2021-03-21;34787
2021-03-20;"Banskobystrický kraj";119;67926;383;68309;NA;45674;502;2021-03-20;34476
2021-03-19;"Banskobystrický kraj";240;44041;307;44348;NA;45674;547;2021-03-19;33974
2021-03-18;"Banskobystrický kraj";160;22467;273;22740;NA;45674;433;2021-03-18;33427
2021-03-17;"Banskobystrický kraj";262;21573;245;21818;NA;45674;507;2021-03-17;32994
2021-03-16;"Banskobystrický kraj";340;23365;224;23589;NA;45674;564;2021-03-16;32487
2021-03-15;"Banskobystrický kraj";95;31293;364;31657;NA;45674;459;2021-03-15;31923
2021-03-14;"Banskobystrický kraj";39;40650;229;40879;NA;45674;268;2021-03-14;31464
2021-03-13;"Banskobystrický kraj";209;67167;391;67558;NA;45674;600;2021-03-13;31196
2021-03-12;"Banskobystrický kraj";206;41439;330;41769;NA;45674;536;2021-03-12;30596
2021-03-11;"Banskobystrický kraj";228;21337;272;21609;NA;45674;500;2021-03-11;30060
2021-03-10;"Banskobystrický kraj";260;20381;238;20619;NA;45674;498;2021-03-10;29560
2021-03-09;"Banskobystrický kraj";352;21790;284;22074;NA;45674;636;2021-03-09;29062
2021-03-08;"Banskobystrický kraj";191;31488;427;31915;NA;45674;618;2021-03-08;28426
2021-03-07;"Banskobystrický kraj";60;39083;295;39378;NA;45674;355;2021-03-07;27808
2021-03-06;"Banskobystrický kraj";164;70562;410;70972;NA;45674;574;2021-03-06;27453
2021-03-05;"Banskobystrický kraj";221;42137;388;42525;NA;45674;609;2021-03-05;26879
2021-03-04;"Banskobystrický kraj";226;22007;334;22341;NA;45674;560;2021-03-04;26270
2021-03-03;"Banskobystrický kraj";317;21949;331;22280;NA;45674;648;2021-03-03;25710
2021-03-02;"Banskobystrický kraj";291;23152;354;23506;NA;45674;645;2021-03-02;25062
2021-03-01;"Banskobystrický kraj";151;31773;434;32207;NA;45674;585;2021-03-01;24417
2021-02-28;"Banskobystrický kraj";45;38663;336;38999;NA;45674;381;2021-02-28;23832
2021-02-27;"Banskobystrický kraj";289;66667;529;67196;NA;45674;818;2021-02-27;23451
2021-02-26;"Banskobystrický kraj";326;39489;468;39957;NA;45674;794;2021-02-26;22633
2021-02-25;"Banskobystrický kraj";375;18081;366;18447;NA;45674;741;2021-02-25;21839
2021-02-24;"Banskobystrický kraj";332;16735;373;17108;NA;45674;705;2021-02-24;21098
2021-02-23;"Banskobystrický kraj";462;19930;439;20369;NA;45674;901;2021-02-23;20393
2021-02-22;"Banskobystrický kraj";67;28643;598;29241;NA;45674;665;2021-02-22;19492
2021-02-21;"Banskobystrický kraj";68;37464;437;37901;NA;45674;505;2021-02-21;18827
2021-02-20;"Banskobystrický kraj";280;68851;598;69449;NA;45674;878;2021-02-20;18322
2021-02-19;"Banskobystrický kraj";420;39882;511;40393;NA;45674;931;2021-02-19;17444
2021-02-18;"Banskobystrický kraj";241;18618;396;19014;NA;45674;637;2021-02-18;16513
2021-02-17;"Banskobystrický kraj";415;16737;389;17126;NA;45674;804;2021-02-17;15876
2021-02-16;"Banskobystrický kraj";338;19727;368;20095;NA;45674;706;2021-02-16;15072
2021-02-15;"Banskobystrický kraj";118;35835;591;36426;NA;45674;709;2021-02-15;14366
2021-02-14;"Banskobystrický kraj";60;31894;386;32280;NA;45674;446;2021-02-14;13657
2021-02-13;"Banskobystrický kraj";202;53889;492;54381;NA;45674;694;2021-02-13;13211
2021-02-12;"Banskobystrický kraj";312;37270;533;37803;NA;45674;845;2021-02-12;12517
2021-02-11;"Banskobystrický kraj";305;21200;386;21586;NA;45674;691;2021-02-11;11672
2021-02-10;"Banskobystrický kraj";333;14790;344;15134;NA;45674;677;2021-02-10;10981
2021-02-09;"Banskobystrický kraj";329;18504;362;18866;NA;45674;691;2021-02-09;10304
2021-02-08;"Banskobystrický kraj";103;47054;672;47726;NA;45674;775;2021-02-08;9613
2021-02-07;"Banskobystrický kraj";70;37363;333;37696;NA;45674;403;2021-02-07;8838
2021-02-06;"Banskobystrický kraj";178;69388;570;69958;NA;45674;748;2021-02-06;8435
2021-02-05;"Banskobystrický kraj";282;24577;363;24940;NA;45674;645;2021-02-05;7687
2021-02-04;"Banskobystrický kraj";240;14367;430;14797;NA;45674;670;2021-02-04;7042
2021-02-03;"Banskobystrický kraj";350;9429;255;9684;NA;45674;605;2021-02-03;6372
2021-02-02;"Banskobystrický kraj";277;15740;334;16074;NA;45674;611;2021-02-02;5767
2021-02-01;"Banskobystrický kraj";75;24723;496;25219;NA;45674;571;2021-02-01;5156
2021-01-31;"Banskobystrický kraj";34;19983;201;20184;NA;45674;235;2021-01-31;4585
2021-01-30;"Banskobystrický kraj";163;63896;525;64421;NA;45674;688;2021-01-30;4350
2021-01-29;"Banskobystrický kraj";196;17360;269;17629;NA;45674;465;2021-01-29;3662
2021-01-28;"Banskobystrický kraj";218;14229;372;14601;NA;45674;590;2021-01-28;3197
2021-01-27;"Banskobystrický kraj";191;8128;200;8328;NA;45674;391;2021-01-27;2607
2021-01-26;"Banskobystrický kraj";238;19798;283;20081;NA;45674;521;2021-01-26;2216
2021-01-25;"Banskobystrický kraj";82;33666;412;34078;NA;45674;494;2021-01-25;1695
2021-01-24;"Banskobystrický kraj";38;35587;278;35865;NA;45674;316;2021-01-24;1201
2021-01-23;"Banskobystrický kraj";142;89033;524;89557;NA;45674;666;2021-01-23;885
2021-01-22;"Banskobystrický kraj";175;26393;359;26752;NA;45674;534;2021-01-22;219
2021-01-21;"Banskobystrický kraj";194;17308;285;17593;NA;45674;479;2021-01-21;-315
2021-01-20;"Banskobystrický kraj";231;9150;188;9338;NA;45674;419;2021-01-20;-794
2021-01-19;"Banskobystrický kraj";213;10708;311;11019;NA;45674;524;2021-01-19;-1213
2021-01-18;"Banskobystrický kraj";94;7415;402;7817;NA;45674;496;2021-01-18;-1737
2021-01-17;"Banskobystrický kraj";110;8154;77;8231;NA;45674;187;2021-01-17;-2233
2021-01-16;"Banskobystrický kraj";58;2274;57;2331;NA;45674;115;2021-01-16;-2420
2021-01-15;"Banskobystrický kraj";164;7673;217;7890;NA;45674;381;2021-01-15;-2535
2021-01-14;"Banskobystrický kraj";220;5760;325;6085;NA;45674;545;2021-01-14;-2916
2021-01-13;"Banskobystrický kraj";235;5974;217;6191;NA;45674;452;2021-01-13;-3461
2021-01-12;"Banskobystrický kraj";194;6808;299;7107;NA;45674;493;2021-01-12;-3913
2021-01-11;"Banskobystrický kraj";76;8231;481;8712;NA;45674;557;2021-01-11;-4406
2021-01-10;"Banskobystrický kraj";110;433;4;437;NA;45674;114;2021-01-10;-4963
2021-01-09;"Banskobystrický kraj";297;2378;81;2459;NA;45674;378;2021-01-09;-5077
2021-01-08;"Banskobystrický kraj";435;9802;443;10245;NA;45674;878;2021-01-08;-5455
2021-01-07;"Banskobystrický kraj";127;6322;366;6688;NA;45674;493;2021-01-07;-6333
2021-01-06;"Banskobystrický kraj";305;3374;185;3559;NA;45674;490;2021-01-06;-6826
2021-01-05;"Banskobystrický kraj";372;7349;533;7882;NA;45674;905;2021-01-05;-7316
2021-01-04;"Banskobystrický kraj";130;7083;700;7783;NA;45674;830;2021-01-04;-8221
2021-01-03;"Banskobystrický kraj";199;320;19;339;NA;45674;218;2021-01-03;-9051
2021-01-02;"Banskobystrický kraj";123;702;85;787;NA;45674;208;2021-01-02;-9269
2021-01-01;"Banskobystrický kraj";220;1958;132;2090;NA;45674;352;2021-01-01;-9477
2020-12-31;"Banskobystrický kraj";499;7379;633;8012;NA;45674;1132;2020-12-31;-9829
2020-12-30;"Banskobystrický kraj";593;7670;557;8227;NA;45674;1150;2020-12-30;-10961
2020-12-29;"Banskobystrický kraj";240;7955;664;8619;NA;45674;904;2020-12-29;-12111
2020-12-28;"Banskobystrický kraj";131;6098;711;6809;NA;45674;842;2020-12-28;-13015
2020-12-27;"Banskobystrický kraj";116;541;25;566;NA;45674;141;2020-12-27;-13857
2020-12-26;"Banskobystrický kraj";61;295;35;330;NA;45674;96;2020-12-26;-13998
2020-12-25;"Banskobystrický kraj";65;313;10;323;NA;45674;75;2020-12-25;-14094
2020-12-24;"Banskobystrický kraj";452;3685;135;3820;NA;45674;587;2020-12-24;-14169
2020-12-23;"Banskobystrický kraj";368;10116;507;10623;NA;45674;875;2020-12-23;-14756
2020-12-22;"Banskobystrický kraj";307;8449;624;9073;NA;45674;931;2020-12-22;-15631
2020-12-21;"Banskobystrický kraj";286;4896;448;5344;NA;45674;734;2020-12-21;-16562
2020-12-20;"Banskobystrický kraj";155;249;14;263;NA;45674;169;2020-12-20;-17296
2020-12-19;"Banskobystrický kraj";170;3084;138;3222;NA;45674;308;2020-12-19;-17465
2020-12-18;"Banskobystrický kraj";432;5965;324;6289;NA;45674;756;2020-12-18;-17773
2020-12-17;"Banskobystrický kraj";468;8703;656;9359;NA;45674;1124;2020-12-17;-18529
2020-12-16;"Banskobystrický kraj";379;10202;560;10762;NA;45674;939;2020-12-16;-19653
2020-12-15;"Banskobystrický kraj";336;5425;433;5858;NA;45674;769;2020-12-15;-20592
2020-12-14;"Banskobystrický kraj";148;3897;259;4156;NA;45674;407;2020-12-14;-21361
2020-12-13;"Banskobystrický kraj";122;142;1;143;NA;45674;123;2020-12-13;-21768
2020-12-12;"Banskobystrický kraj";137;2714;138;2852;NA;45674;275;2020-12-12;-21891
2020-12-11;"Banskobystrický kraj";468;6587;374;6961;NA;45674;842;2020-12-11;-22166
2020-12-10;"Banskobystrický kraj";280;5204;355;5559;NA;45674;635;2020-12-10;-23008
2020-12-09;"Banskobystrický kraj";323;3850;213;4063;NA;45674;536;2020-12-09;-23643
2020-12-08;"Banskobystrický kraj";256;3787;276;4063;NA;45674;532;2020-12-08;-24179
2020-12-07;"Banskobystrický kraj";175;2380;156;2536;NA;45674;331;2020-12-07;-24711
2020-12-06;"Banskobystrický kraj";121;507;11;518;NA;45674;132;2020-12-06;-25042
2020-12-05;"Banskobystrický kraj";109;1099;34;1133;NA;45674;143;2020-12-05;-25174
2020-12-04;"Banskobystrický kraj";339;3828;174;4002;NA;45674;513;2020-12-04;-25317
2020-12-03;"Banskobystrický kraj";240;3193;234;3427;NA;45674;474;2020-12-03;-25830
2020-12-02;"Banskobystrický kraj";217;4442;186;4628;NA;45674;403;2020-12-02;-26304
2020-12-01;"Banskobystrický kraj";215;2702;134;2836;NA;45674;349;2020-12-01;-26707
2020-11-30;"Banskobystrický kraj";74;4559;257;4816;NA;45674;331;2020-11-30;-27056
2020-11-29;"Banskobystrický kraj";19;208;7;215;NA;45674;26;2020-11-29;-27387
2020-11-28;"Banskobystrický kraj";81;1408;55;1463;NA;45674;136;2020-11-28;-27413
2020-11-27;"Banskobystrický kraj";219;2266;123;2389;NA;45674;342;2020-11-27;-27549
2020-11-26;"Banskobystrický kraj";208;2124;93;2217;NA;45674;301;2020-11-26;-27891
2020-11-25;"Banskobystrický kraj";170;1952;86;2038;NA;45674;256;2020-11-25;-28192
2020-11-24;"Banskobystrický kraj";166;2566;69;2635;NA;45674;235;2020-11-24;-28448
2020-11-23;"Banskobystrický kraj";66;10240;194;10434;NA;45674;260;2020-11-23;-28683
2020-11-22;"Banskobystrický kraj";38;104;1;105;NA;45674;39;2020-11-22;-28943
2020-11-21;"Banskobystrický kraj";52;904;14;918;NA;45674;66;2020-11-21;-28982
2020-11-20;"Banskobystrický kraj";127;2005;107;2112;NA;45674;234;2020-11-20;-29048
2020-11-19;"Banskobystrický kraj";170;1218;82;1300;NA;45674;252;2020-11-19;-29282
2020-11-18;"Banskobystrický kraj";153;698;65;763;NA;45674;218;2020-11-18;-29534
2020-11-17;"Banskobystrický kraj";52;578;35;613;NA;45674;87;2020-11-17;-29752
2020-11-16;"Banskobystrický kraj";106;470;25;495;NA;45674;131;2020-11-16;-29839
2020-11-15;"Banskobystrický kraj";52;301;4;305;NA;45674;56;2020-11-15;-29970
2020-11-14;"Banskobystrický kraj";73;305;2;307;NA;45674;75;2020-11-14;-30026
2020-11-13;"Banskobystrický kraj";157;552;11;563;NA;45674;168;2020-11-13;-30101
2020-11-12;"Banskobystrický kraj";218;952;44;996;NA;45674;262;2020-11-12;-30269
2020-11-11;"Banskobystrický kraj";224;437;9;446;NA;45674;233;2020-11-11;-30531
2020-11-10;"Banskobystrický kraj";263;463;18;481;NA;45674;281;2020-11-10;-30764
2020-11-09;"Banskobystrický kraj";80;2678;31;2709;NA;45674;111;2020-11-09;-31045
2020-11-08;"Banskobystrický kraj";82;981;16;997;NA;45674;98;2020-11-08;-31156
2020-11-07;"Banskobystrický kraj";164;8828;94;8922;NA;45674;258;2020-11-07;-31254
2020-11-06;"Banskobystrický kraj";227;2496;16;2512;NA;45674;243;2020-11-06;-31512
2020-11-05;"Banskobystrický kraj";240;290;33;323;NA;45674;273;2020-11-05;-31755
2020-11-04;"Banskobystrický kraj";254;1366;13;1379;NA;45674;267;2020-11-04;-32028
2020-11-03;"Banskobystrický kraj";246;1332;4;1336;NA;45674;250;2020-11-03;-32295
2020-11-02;"Banskobystrický kraj";90;2909;65;2974;NA;45674;155;2020-11-02;-32545
2020-11-01;"Banskobystrický kraj";101;2671;42;2713;NA;45674;143;2020-11-01;-32700
2020-10-31;"Banskobystrický kraj";199;13516;116;13632;NA;45674;315;2020-10-31;-32843
2020-10-30;"Banskobystrický kraj";254;2829;20;2849;NA;45674;274;2020-10-30;-33158
2020-10-29;"Banskobystrický kraj";372;969;42;1011;NA;45674;414;2020-10-29;-33432
2020-10-28;"Banskobystrický kraj";285;302;30;332;NA;45674;315;2020-10-28;-33846
2020-10-27;"Banskobystrický kraj";266;654;40;694;NA;45674;306;2020-10-27;-34161
2020-10-26;"Banskobystrický kraj";38;234;29;263;NA;45674;67;2020-10-26;-34467
2020-10-25;"Banskobystrický kraj";50;140;11;151;NA;45674;61;2020-10-25;-34534
2020-10-24;"Banskobystrický kraj";315;114;12;126;NA;45674;327;2020-10-24;-34595
2020-10-23;"Banskobystrický kraj";231;230;29;259;NA;45674;260;2020-10-23;-34922
2020-10-22;"Banskobystrický kraj";264;253;24;277;NA;45674;288;2020-10-22;-35182
2020-10-21;"Banskobystrický kraj";209;266;3;269;NA;45674;212;2020-10-21;-35470
2020-10-20;"Banskobystrický kraj";210;66;3;69;NA;45674;213;2020-10-20;-35682
2020-10-19;"Banskobystrický kraj";27;73;12;85;NA;45674;39;2020-10-19;-35895
2020-10-18;"Banskobystrický kraj";49;0;0;0;NA;45674;49;2020-10-18;-35934
2020-10-17;"Banskobystrický kraj";91;0;0;0;NA;45674;91;2020-10-17;-35983
2020-10-16;"Banskobystrický kraj";224;37;3;40;NA;45674;227;2020-10-16;-36074
2020-10-15;"Banskobystrický kraj";133;29;1;30;NA;45674;134;2020-10-15;-36301
2020-10-14;"Banskobystrický kraj";139;31;1;32;NA;45674;140;2020-10-14;-36435
2020-10-13;"Banskobystrický kraj";151;169;11;180;NA;45674;162;2020-10-13;-36575
2020-10-12;"Banskobystrický kraj";11;110;4;114;NA;45674;15;2020-10-12;-36737
2020-10-11;"Banskobystrický kraj";14;0;0;0;NA;45674;14;2020-10-11;-36752
2020-10-10;"Banskobystrický kraj";53;0;0;0;NA;45674;53;2020-10-10;-36766
2020-10-09;"Banskobystrický kraj";128;0;0;0;NA;45674;128;2020-10-09;-36819
2020-10-08;"Banskobystrický kraj";99;0;0;0;NA;45674;99;2020-10-08;-36947
2020-10-07;"Banskobystrický kraj";124;0;0;0;NA;45674;124;2020-10-07;-37046
2020-10-06;"Banskobystrický kraj";68;0;0;0;NA;45674;68;2020-10-06;-37170
2020-10-05;"Banskobystrický kraj";49;0;0;0;NA;45674;49;2020-10-05;-37238
2020-10-04;"Banskobystrický kraj";8;0;0;0;NA;45674;8;2020-10-04;-37287
2020-10-03;"Banskobystrický kraj";37;0;0;0;NA;45674;37;2020-10-03;-37295
2020-10-02;"Banskobystrický kraj";74;0;0;0;NA;45674;74;2020-10-02;-37332
2020-10-01;"Banskobystrický kraj";49;0;0;0;NA;45674;49;2020-10-01;-37406
2020-09-30;"Banskobystrický kraj";60;0;0;0;NA;45674;60;2020-09-30;-37455
2020-09-29;"Banskobystrický kraj";24;0;0;0;NA;45674;24;2020-09-29;-37515
2020-09-28;"Banskobystrický kraj";0;0;0;0;NA;45674;0;2020-09-28;-37539
2020-09-27;"Banskobystrický kraj";20;0;0;0;NA;45674;20;2020-09-27;-37539
2020-09-26;"Banskobystrický kraj";24;0;0;0;NA;45674;24;2020-09-26;-37559
2020-09-25;"Banskobystrický kraj";29;0;0;0;NA;45674;29;2020-09-25;-37583
2020-09-24;"Banskobystrický kraj";25;0;0;0;NA;45674;25;2020-09-24;-37612
2020-09-23;"Banskobystrický kraj";17;0;0;0;NA;45674;17;2020-09-23;-37637
2020-09-22;"Banskobystrický kraj";25;0;0;0;NA;45674;25;2020-09-22;-37654
2020-09-21;"Banskobystrický kraj";3;0;0;0;NA;45674;3;2020-09-21;-37679
2020-09-20;"Banskobystrický kraj";0;0;0;0;NA;45674;0;2020-09-20;-37682
2020-09-19;"Banskobystrický kraj";3;0;0;0;NA;45674;3;2020-09-19;-37682
2020-09-18;"Banskobystrický kraj";24;0;0;0;NA;45674;24;2020-09-18;-37685
2020-09-17;"Banskobystrický kraj";14;0;0;0;NA;45674;14;2020-09-17;-37709
2020-09-16;"Banskobystrický kraj";6;0;0;0;NA;45674;6;2020-09-16;-37723
2020-09-15;"Banskobystrický kraj";2;0;0;0;NA;45674;2;2020-09-15;-37729
2020-09-14;"Banskobystrický kraj";13;0;0;0;NA;45674;13;2020-09-14;-37731
2020-09-13;"Banskobystrický kraj";1;0;0;0;NA;45674;1;2020-09-13;-37744
2020-09-12;"Banskobystrický kraj";5;0;0;0;NA;45674;5;2020-09-12;-37745
2020-09-11;"Banskobystrický kraj";19;0;0;0;NA;45674;19;2020-09-11;-37750
2020-09-10;"Banskobystrický kraj";11;0;0;0;NA;45674;11;2020-09-10;-37769
2020-09-09;"Banskobystrický kraj";13;0;0;0;NA;45674;13;2020-09-09;-37780
2020-09-08;"Banskobystrický kraj";5;0;0;0;NA;45674;5;2020-09-08;-37793
2020-09-07;"Banskobystrický kraj";2;0;0;0;NA;45674;2;2020-09-07;-37798
2020-09-06;"Banskobystrický kraj";0;0;0;0;NA;45674;0;2020-09-06;-37800
2020-09-05;"Banskobystrický kraj";0;0;0;0;NA;45674;0;2020-09-05;-37800
2020-09-04;"Banskobystrický kraj";9;0;0;0;NA;45674;9;2020-09-04;-37800
2020-09-03;"Banskobystrický kraj";5;0;0;0;NA;45674;5;2020-09-03;-37809
2020-09-02;"Banskobystrický kraj";6;0;0;0;NA;45674;6;2020-09-02;-37814
2020-09-01;"Banskobystrický kraj";2;0;0;0;NA;45674;2;2020-09-01;-37820
2020-08-31;"Banskobystrický kraj";6;0;0;0;NA;45674;6;2020-08-31;-37822
2020-08-30;"Banskobystrický kraj";0;0;0;0;NA;45674;0;2020-08-30;-37828
2020-08-29;"Banskobystrický kraj";1;0;0;0;NA;45674;1;2020-08-29;-37828
2020-08-28;"Banskobystrický kraj";3;0;0;0;NA;45674;3;2020-08-28;-37829
2020-08-27;"Banskobystrický kraj";1;0;0;0;NA;45674;1;2020-08-27;-37832
2020-08-26;"Banskobystrický kraj";2;0;0;0;NA;45674;2;2020-08-26;-37833
2020-08-25;"Banskobystrický kraj";2;0;0;0;NA;45674;2;2020-08-25;-37835
2020-08-24;"Banskobystrický kraj";0;0;0;0;NA;45674;0;2020-08-24;-37837
2020-08-23;"Banskobystrický kraj";0;0;0;0;NA;45674;0;2020-08-23;-37837
2020-08-22;"Banskobystrický kraj";0;0;0;0;NA;45674;0;2020-08-22;-37837
2020-08-21;"Banskobystrický kraj";4;0;0;0;NA;45674;4;2020-08-21;-37837
2020-08-20;"Banskobystrický kraj";1;0;0;0;NA;45674;1;2020-08-20;-37841
2020-08-19;"Banskobystrický kraj";4;0;0;0;NA;45674;4;2020-08-19;-37842
2020-08-18;"Banskobystrický kraj";0;0;0;0;NA;45674;0;2020-08-18;-37846
2020-08-17;"Banskobystrický kraj";1;0;0;0;NA;45674;1;2020-08-17;-37846
2020-08-16;"Banskobystrický kraj";0;0;0;0;NA;45674;0;2020-08-16;-37847
2020-08-15;"Banskobystrický kraj";0;0;0;0;NA;45674;0;2020-08-15;-37847
2020-08-14;"Banskobystrický kraj";5;0;0;0;NA;45674;5;2020-08-14;-37847
2020-08-13;"Banskobystrický kraj";0;0;0;0;NA;45674;0;2020-08-13;-37852
2020-08-12;"Banskobystrický kraj";0;0;0;0;NA;45674;0;2020-08-12;-37852
2020-08-11;"Banskobystrický kraj";2;0;0;0;NA;45674;2;2020-08-11;-37852
2020-08-10;"Banskobystrický kraj";3;0;0;0;NA;45674;3;2020-08-10;-37854
2020-08-09;"Banskobystrický kraj";0;0;0;0;NA;45674;0;2020-08-09;-37857
2020-08-08;"Banskobystrický kraj";2;0;0;0;NA;45674;2;2020-08-08;-37857
2020-08-07;"Banskobystrický kraj";1;0;0;0;NA;45674;1;2020-08-07;-37859
2020-08-06;"Banskobystrický kraj";1;0;0;0;NA;45674;1;2020-08-06;-37860
2020-08-05;"Banskobystrický kraj";0;0;0;0;NA;45674;0;2020-08-05;-37861
2020-08-04;"Banskobystrický kraj";3;0;0;0;NA;45674;3;2020-08-04;-37861
2020-08-03;"Banskobystrický kraj";0;0;0;0;NA;45674;0;2020-08-03;-37864
2020-08-02;"Banskobystrický kraj";0;0;0;0;NA;45674;0;2020-08-02;-37864
2020-08-01;"Banskobystrický kraj";1;0;0;0;NA;45674;1;2020-08-01;-37864
2020-07-31;"Banskobystrický kraj";2;0;0;0;NA;45674;2;2020-07-31;-37865
2020-07-30;"Banskobystrický kraj";1;0;0;0;NA;45674;1;2020-07-30;-37867
2020-07-29;"Banskobystrický kraj";0;0;0;0;NA;45674;0;2020-07-29;-37868
2020-07-28;"Banskobystrický kraj";2;0;0;0;NA;45674;2;2020-07-28;-37868
2020-07-27;"Banskobystrický kraj";3;0;0;0;NA;45674;3;2020-07-27;-37870
2020-07-26;"Banskobystrický kraj";0;0;0;0;NA;45674;0;2020-07-26;-37873
2020-07-25;"Banskobystrický kraj";0;0;0;0;NA;45674;0;2020-07-25;-37873
2020-07-24;"Banskobystrický kraj";9;0;0;0;NA;45674;9;2020-07-24;-37873
2020-07-23;"Banskobystrický kraj";0;0;0;0;NA;45674;0;2020-07-23;-37882
2020-07-22;"Banskobystrický kraj";3;0;0;0;NA;45674;3;2020-07-22;-37882
2020-07-21;"Banskobystrický kraj";3;0;0;0;NA;45674;3;2020-07-21;-37885
2020-07-20;"Banskobystrický kraj";1;0;0;0;NA;45674;1;2020-07-20;-37888
2020-07-19;"Banskobystrický kraj";1;0;0;0;NA;45674;1;2020-07-19;-37889
2020-07-18;"Banskobystrický kraj";0;0;0;0;NA;45674;0;2020-07-18;-37890
2020-07-17;"Banskobystrický kraj";2;0;0;0;NA;45674;2;2020-07-17;-37890
2020-07-16;"Banskobystrický kraj";1;0;0;0;NA;45674;1;2020-07-16;-37892
2020-07-15;"Banskobystrický kraj";4;0;0;0;NA;45674;4;2020-07-15;-37893
2020-07-14;"Banskobystrický kraj";2;0;0;0;NA;45674;2;2020-07-14;-37897
2020-07-13;"Banskobystrický kraj";1;0;0;0;NA;45674;1;2020-07-13;-37899
2020-07-12;"Banskobystrický kraj";0;0;0;0;NA;45674;0;2020-07-12;-37900
2020-07-11;"Banskobystrický kraj";0;0;0;0;NA;45674;0;2020-07-11;-37900
2020-07-10;"Banskobystrický kraj";3;0;0;0;NA;45674;3;2020-07-10;-37900
2020-07-09;"Banskobystrický kraj";9;0;0;0;NA;45674;9;2020-07-09;-37903
2020-07-08;"Banskobystrický kraj";0;0;0;0;NA;45674;0;2020-07-08;-37912
2020-07-07;"Banskobystrický kraj";4;0;0;0;NA;45674;4;2020-07-07;-37912
2020-07-06;"Banskobystrický kraj";0;0;0;0;NA;45674;0;2020-07-06;-37916
2020-07-05;"Banskobystrický kraj";0;0;0;0;NA;45674;0;2020-07-05;-37916
2020-07-04;"Banskobystrický kraj";1;0;0;0;NA;45674;1;2020-07-04;-37916
2020-07-03;"Banskobystrický kraj";4;0;0;0;NA;45674;4;2020-07-03;-37917
2020-07-02;"Banskobystrický kraj";0;0;0;0;NA;45674;0;2020-07-02;-37921
2020-07-01;"Banskobystrický kraj";1;0;0;0;NA;45674;1;2020-07-01;-37921
2020-06-30;"Banskobystrický kraj";0;0;0;0;NA;45674;0;2020-06-30;-37922
2020-06-29;"Banskobystrický kraj";0;0;0;0;NA;45674;0;2020-06-29;-37922
2020-06-28;"Banskobystrický kraj";0;0;0;0;NA;45674;0;2020-06-28;-37922
2020-06-27;"Banskobystrický kraj";0;0;0;0;NA;45674;0;2020-06-27;-37922
2020-06-26;"Banskobystrický kraj";0;0;0;0;NA;45674;0;2020-06-26;-37922
2020-06-25;"Banskobystrický kraj";1;0;0;0;NA;45674;1;2020-06-25;-37922
2020-06-24;"Banskobystrický kraj";0;0;0;0;NA;45674;0;2020-06-24;-37923
2020-06-23;"Banskobystrický kraj";6;0;0;0;NA;45674;6;2020-06-23;-37923
2020-06-22;"Banskobystrický kraj";0;0;0;0;NA;45674;0;2020-06-22;-37929
2020-06-21;"Banskobystrický kraj";0;0;0;0;NA;45674;0;2020-06-21;-37929
2020-06-20;"Banskobystrický kraj";0;0;0;0;NA;45674;0;2020-06-20;-37929
2020-06-19;"Banskobystrický kraj";2;0;0;0;NA;45674;2;2020-06-19;-37929
2020-06-18;"Banskobystrický kraj";10;0;0;0;NA;45674;10;2020-06-18;-37931
2020-06-17;"Banskobystrický kraj";1;0;0;0;NA;45674;1;2020-06-17;-37941
2020-06-16;"Banskobystrický kraj";0;0;0;0;NA;45674;0;2020-06-16;-37942
2020-06-14;"Banskobystrický kraj";2;0;0;0;NA;45674;2;2020-06-14;-37942
2020-06-13;"Banskobystrický kraj";2;0;0;0;NA;45674;2;2020-06-13;-37944
2020-06-12;"Banskobystrický kraj";0;0;0;0;NA;45674;0;2020-06-12;-37946
2020-06-11;"Banskobystrický kraj";1;0;0;0;NA;45674;1;2020-06-11;-37946
2020-06-10;"Banskobystrický kraj";0;0;0;0;NA;45674;0;2020-06-10;-37947
2020-06-09;"Banskobystrický kraj";0;0;0;0;NA;45674;0;2020-06-09;-37947
2020-06-08;"Banskobystrický kraj";0;0;0;0;NA;45674;0;2020-06-08;-37947
2020-06-07;"Banskobystrický kraj";0;0;0;0;NA;45674;0;2020-06-07;-37947
2020-06-05;"Banskobystrický kraj";2;0;0;0;NA;45674;2;2020-06-05;-37947
2020-06-03;"Banskobystrický kraj";0;0;0;0;NA;45674;0;2020-06-03;-37949
2020-06-02;"Banskobystrický kraj";0;0;0;0;NA;45674;0;2020-06-02;-37949
2020-05-31;"Banskobystrický kraj";0;0;0;0;NA;45674;0;2020-05-31;-37949
2020-05-29;"Banskobystrický kraj";0;0;0;0;NA;45674;0;2020-05-29;-37949
2020-05-27;"Banskobystrický kraj";1;0;0;0;NA;45674;1;2020-05-27;-37949
2020-05-26;"Banskobystrický kraj";0;0;0;0;NA;45674;0;2020-05-26;-37950
2020-05-25;"Banskobystrický kraj";0;0;0;0;NA;45674;0;2020-05-25;-37950
2020-05-24;"Banskobystrický kraj";0;0;0;0;NA;45674;0;2020-05-24;-37950
2020-05-23;"Banskobystrický kraj";1;0;0;0;NA;45674;1;2020-05-23;-37950
2020-05-22;"Banskobystrický kraj";0;0;0;0;NA;45674;0;2020-05-22;-37951
2020-05-21;"Banskobystrický kraj";0;0;0;0;NA;45674;0;2020-05-21;-37951
2020-05-20;"Banskobystrický kraj";1;0;0;0;NA;45674;1;2020-05-20;-37951
2020-05-19;"Banskobystrický kraj";0;0;0;0;NA;45674;0;2020-05-19;-37952
2020-05-17;"Banskobystrický kraj";0;0;0;0;NA;45674;0;2020-05-17;-37952
2020-05-16;"Banskobystrický kraj";0;0;0;0;NA;45674;0;2020-05-16;-37952
2020-05-15;"Banskobystrický kraj";0;0;0;0;NA;45674;0;2020-05-15;-37952
2020-05-14;"Banskobystrický kraj";0;0;0;0;NA;45674;0;2020-05-14;-37952
2020-05-13;"Banskobystrický kraj";0;0;0;0;NA;45674;0;2020-05-13;-37952
2020-05-12;"Banskobystrický kraj";1;0;0;0;NA;45674;1;2020-05-12;-37952
2020-05-11;"Banskobystrický kraj";0;0;0;0;NA;45674;0;2020-05-11;-37953
2020-05-09;"Banskobystrický kraj";0;0;0;0;NA;45674;0;2020-05-09;-37953
2020-05-07;"Banskobystrický kraj";2;0;0;0;NA;45674;2;2020-05-07;-37953
2020-05-06;"Banskobystrický kraj";1;0;0;0;NA;45674;1;2020-05-06;-37955
2020-05-05;"Banskobystrický kraj";2;0;0;0;NA;45674;2;2020-05-05;-37956
2020-05-04;"Banskobystrický kraj";0;0;0;0;NA;45674;0;2020-05-04;-37958
2020-05-03;"Banskobystrický kraj";0;0;0;0;NA;45674;0;2020-05-03;-37958
2020-05-02;"Banskobystrický kraj";0;0;0;0;NA;45674;0;2020-05-02;-37958
2020-05-01;"Banskobystrický kraj";0;0;0;0;NA;45674;0;2020-05-01;-37958
2020-04-30;"Banskobystrický kraj";1;0;0;0;NA;45674;1;2020-04-30;-37958
2020-04-29;"Banskobystrický kraj";1;0;0;0;NA;45674;1;2020-04-29;-37959
2020-04-28;"Banskobystrický kraj";0;0;0;0;NA;45674;0;2020-04-28;-37960
2020-04-27;"Banskobystrický kraj";0;0;0;0;NA;45674;0;2020-04-27;-37960
2020-04-26;"Banskobystrický kraj";0;0;0;0;NA;45674;0;2020-04-26;-37960
2020-04-25;"Banskobystrický kraj";2;0;0;0;NA;45674;2;2020-04-25;-37960
2020-04-24;"Banskobystrický kraj";3;0;0;0;NA;45674;3;2020-04-24;-37962
2020-04-23;"Banskobystrický kraj";2;0;0;0;NA;45674;2;2020-04-23;-37965
2020-04-22;"Banskobystrický kraj";2;0;0;0;NA;45674;2;2020-04-22;-37967
2020-04-21;"Banskobystrický kraj";2;0;0;0;NA;45674;2;2020-04-21;-37969
2020-04-20;"Banskobystrický kraj";0;0;0;0;NA;45674;0;2020-04-20;-37971
2020-04-19;"Banskobystrický kraj";0;0;0;0;NA;45674;0;2020-04-19;-37971
2020-04-18;"Banskobystrický kraj";8;0;0;0;NA;45674;8;2020-04-18;-37971
2020-04-17;"Banskobystrický kraj";2;0;0;0;NA;45674;2;2020-04-17;-37979
2020-04-16;"Banskobystrický kraj";0;0;0;0;NA;45674;0;2020-04-16;-37981
2020-04-15;"Banskobystrický kraj";10;0;0;0;NA;45674;10;2020-04-15;-37981
2020-04-14;"Banskobystrický kraj";0;0;0;0;NA;45674;0;2020-04-14;-37991
2020-04-13;"Banskobystrický kraj";2;0;0;0;NA;45674;2;2020-04-13;-37991
2020-04-12;"Banskobystrický kraj";4;0;0;0;NA;45674;4;2020-04-12;-37993
2020-04-11;"Banskobystrický kraj";1;0;0;0;NA;45674;1;2020-04-11;-37997
2020-04-10;"Banskobystrický kraj";0;0;0;0;NA;45674;0;2020-04-10;-37998
2020-04-09;"Banskobystrický kraj";2;0;0;0;NA;45674;2;2020-04-09;-37998
2020-04-08;"Banskobystrický kraj";0;0;0;0;NA;45674;0;2020-04-08;-38000
2020-04-07;"Banskobystrický kraj";4;0;0;0;NA;45674;4;2020-04-07;-38000
2020-04-06;"Banskobystrický kraj";10;0;0;0;NA;45674;10;2020-04-06;-38004
2020-04-05;"Banskobystrický kraj";9;0;0;0;NA;45674;9;2020-04-05;-38014
2020-04-04;"Banskobystrický kraj";0;0;0;0;NA;45674;0;2020-04-04;-38023
2020-04-03;"Banskobystrický kraj";2;0;0;0;NA;45674;2;2020-04-03;-38023
2020-04-02;"Banskobystrický kraj";2;0;0;0;NA;45674;2;2020-04-02;-38025
2020-04-01;"Banskobystrický kraj";5;0;0;0;NA;45674;5;2020-04-01;-38027
2020-03-31;"Banskobystrický kraj";3;0;0;0;NA;45674;3;2020-03-31;-38032
2020-03-30;"Banskobystrický kraj";1;0;0;0;NA;45674;1;2020-03-30;-38035
2020-03-29;"Banskobystrický kraj";2;0;0;0;NA;45674;2;2020-03-29;-38036
2020-03-28;"Banskobystrický kraj";1;0;0;0;NA;45674;1;2020-03-28;-38038
2020-03-27;"Banskobystrický kraj";1;0;0;0;NA;45674;1;2020-03-27;-38039
2020-03-26;"Banskobystrický kraj";1;0;0;0;NA;45674;1;2020-03-26;-38040
2020-03-25;"Banskobystrický kraj";0;0;0;0;NA;45674;0;2020-03-25;-38041
2020-03-24;"Banskobystrický kraj";1;0;0;0;NA;45674;1;2020-03-24;-38041
2020-03-23;"Banskobystrický kraj";1;0;0;0;NA;45674;1;2020-03-23;-38042
2020-03-22;"Banskobystrický kraj";0;0;0;0;NA;45674;0;2020-03-22;-38043
2020-03-21;"Banskobystrický kraj";3;0;0;0;NA;45674;3;2020-03-21;-38043
2020-03-20;"Banskobystrický kraj";0;0;0;0;NA;45674;0;2020-03-20;-38046
2020-03-19;"Banskobystrický kraj";2;0;0;0;NA;45674;2;2020-03-19;-38046
2020-03-18;"Banskobystrický kraj";1;0;0;0;NA;45674;1;2020-03-18;-38048
2020-03-17;"Banskobystrický kraj";1;0;0;0;NA;45674;1;2020-03-17;-38049
2020-03-16;"Banskobystrický kraj";0;0;0;0;NA;45674;0;2020-03-16;-38050
2020-03-15;"Banskobystrický kraj";1;0;0;0;NA;45674;1;2020-03-15;-38050
2020-03-14;"Banskobystrický kraj";0;0;0;0;NA;45674;0;2020-03-14;-38051
2020-03-13;"Banskobystrický kraj";1;0;0;0;NA;45674;1;2020-03-13;-38051
2020-03-12;"Banskobystrický kraj";0;0;0;0;NA;45674;0;2020-03-12;-38052
2020-03-11;"Banskobystrický kraj";0;0;0;0;NA;45674;0;2020-03-11;-38052
2020-03-09;"Banskobystrický kraj";0;0;0;0;NA;45674;0;2020-03-09;-38052
2020-03-08;"Banskobystrický kraj";0;0;0;0;NA;45674;0;2020-03-08;-38052
2020-03-07;"Banskobystrický kraj";0;0;0;0;NA;45674;0;2020-03-07;-38052
2020-03-06;"Banskobystrický kraj";0;0;0;0;NA;45674;0;2020-03-06;-38052
2021-06-22;"Bratislavský kraj";6;4319;8;4327;0;46608;14;2021-06-22;46608
2021-06-21;"Bratislavský kraj";5;6910;9;6919;NA;46608;14;2021-06-21;46594
2021-06-20;"Bratislavský kraj";0;7336;6;7342;NA;46608;6;2021-06-20;46580
2021-06-19;"Bratislavský kraj";3;8186;4;8190;NA;46608;7;2021-06-19;46574
2021-06-18;"Bratislavský kraj";5;12360;9;12369;NA;46608;14;2021-06-18;46567
2021-06-17;"Bratislavský kraj";3;8344;13;8357;NA;46608;16;2021-06-17;46553
2021-06-16;"Bratislavský kraj";3;7083;4;7087;NA;46608;7;2021-06-16;46537
2021-06-15;"Bratislavský kraj";7;7198;16;7214;NA;46608;23;2021-06-15;46530
2021-06-14;"Bratislavský kraj";4;8132;9;8141;NA;46608;13;2021-06-14;46507
2021-06-13;"Bratislavský kraj";2;8677;10;8687;NA;46608;12;2021-06-13;46494
2021-06-12;"Bratislavský kraj";4;10609;11;10620;NA;46608;15;2021-06-12;46482
2021-06-11;"Bratislavský kraj";9;13336;21;13357;NA;46608;30;2021-06-11;46467
2021-06-10;"Bratislavský kraj";12;8511;15;8526;NA;46608;27;2021-06-10;46437
2021-06-09;"Bratislavský kraj";12;7575;12;7587;NA;46608;24;2021-06-09;46410
2021-06-08;"Bratislavský kraj";13;7616;29;7645;NA;46608;42;2021-06-08;46386
2021-06-07;"Bratislavský kraj";13;9101;43;9144;NA;46608;56;2021-06-07;46344
2021-06-06;"Bratislavský kraj";3;10213;20;10233;NA;46608;23;2021-06-06;46288
2021-06-05;"Bratislavský kraj";2;11993;15;12008;NA;46608;17;2021-06-05;46265
2021-06-04;"Bratislavský kraj";10;13556;31;13587;NA;46608;41;2021-06-04;46248
2021-06-03;"Bratislavský kraj";12;9451;19;9470;NA;46608;31;2021-06-03;46207
2021-06-02;"Bratislavský kraj";10;8684;17;8701;NA;46608;27;2021-06-02;46176
2021-06-01;"Bratislavský kraj";3;8540;25;8565;NA;46608;28;2021-06-01;46149
2021-05-31;"Bratislavský kraj";18;11120;32;11152;NA;46608;50;2021-05-31;46121
2021-05-30;"Bratislavský kraj";1;11608;16;11624;NA;46608;17;2021-05-30;46071
2021-05-29;"Bratislavský kraj";4;11742;8;11750;NA;46608;12;2021-05-29;46054
2021-05-28;"Bratislavský kraj";14;15585;22;15607;NA;46608;36;2021-05-28;46042
2021-05-27;"Bratislavský kraj";5;11196;18;11214;NA;46608;23;2021-05-27;46006
2021-05-26;"Bratislavský kraj";20;10653;17;10670;NA;46608;37;2021-05-26;45983
2021-05-25;"Bratislavský kraj";19;11338;31;11369;NA;46608;50;2021-05-25;45946
2021-05-24;"Bratislavský kraj";12;12965;23;12988;NA;46608;35;2021-05-24;45896
2021-05-23;"Bratislavský kraj";7;12858;24;12882;NA;46608;31;2021-05-23;45861
2021-05-22;"Bratislavský kraj";6;13522;21;13543;NA;46608;27;2021-05-22;45830
2021-05-21;"Bratislavský kraj";15;18645;22;18667;NA;46608;37;2021-05-21;45803
2021-05-20;"Bratislavský kraj";15;13718;17;13735;NA;46608;32;2021-05-20;45766
2021-05-19;"Bratislavský kraj";21;11760;24;11784;NA;46608;45;2021-05-19;45734
2021-05-18;"Bratislavský kraj";14;12748;32;12780;NA;46608;46;2021-05-18;45689
2021-05-17;"Bratislavský kraj";15;13750;29;13779;NA;46608;44;2021-05-17;45643
2021-05-16;"Bratislavský kraj";12;19549;32;19581;NA;46608;44;2021-05-16;45599
2021-05-15;"Bratislavský kraj";1;17469;30;17499;NA;46608;31;2021-05-15;45555
2021-05-14;"Bratislavský kraj";15;21841;30;21871;NA;46608;45;2021-05-14;45524
2021-05-13;"Bratislavský kraj";9;15952;17;15969;NA;46608;26;2021-05-13;45479
2021-05-12;"Bratislavský kraj";11;14413;28;14441;NA;46608;39;2021-05-12;45453
2021-05-11;"Bratislavský kraj";29;16490;31;16521;NA;46608;60;2021-05-11;45414
2021-05-10;"Bratislavský kraj";27;19747;64;19811;NA;46608;91;2021-05-10;45354
2021-05-09;"Bratislavský kraj";9;29162;32;29194;NA;46608;41;2021-05-09;45263
2021-05-08;"Bratislavský kraj";5;19014;24;19038;NA;46608;29;2021-05-08;45222
2021-05-07;"Bratislavský kraj";32;27516;64;27580;NA;46608;96;2021-05-07;45193
2021-05-06;"Bratislavský kraj";19;20079;52;20131;NA;46608;71;2021-05-06;45097
2021-05-05;"Bratislavský kraj";29;15368;29;15397;NA;46608;58;2021-05-05;45026
2021-05-04;"Bratislavský kraj";46;18910;53;18963;NA;46608;99;2021-05-04;44968
2021-05-03;"Bratislavský kraj";37;22180;64;22244;NA;46608;101;2021-05-03;44869
2021-05-02;"Bratislavský kraj";38;43064;75;43139;NA;46608;113;2021-05-02;44768
2021-05-01;"Bratislavský kraj";11;39905;40;39945;NA;46608;51;2021-05-01;44655
2021-04-30;"Bratislavský kraj";43;46706;82;46788;NA;46608;125;2021-04-30;44604
2021-04-29;"Bratislavský kraj";48;30015;94;30109;NA;46608;142;2021-04-29;44479
2021-04-28;"Bratislavský kraj";40;28408;76;28484;NA;46608;116;2021-04-28;44337
2021-04-27;"Bratislavský kraj";41;29922;52;29974;NA;46608;93;2021-04-27;44221
2021-04-26;"Bratislavský kraj";59;34519;96;34615;NA;46608;155;2021-04-26;44128
2021-04-25;"Bratislavský kraj";8;57615;74;57689;NA;46608;82;2021-04-25;43973
2021-04-24;"Bratislavský kraj";28;74254;66;74320;NA;46608;94;2021-04-24;43891
2021-04-23;"Bratislavský kraj";70;47937;61;47998;NA;46608;131;2021-04-23;43797
2021-04-22;"Bratislavský kraj";39;30816;72;30888;NA;46608;111;2021-04-22;43666
2021-04-21;"Bratislavský kraj";48;30099;62;30161;NA;46608;110;2021-04-21;43555
2021-04-20;"Bratislavský kraj";58;34760;63;34823;NA;46608;121;2021-04-20;43445
2021-04-19;"Bratislavský kraj";48;39305;80;39385;NA;46608;128;2021-04-19;43324
2021-04-18;"Bratislavský kraj";35;62300;76;62376;NA;46608;111;2021-04-18;43196
2021-04-17;"Bratislavský kraj";13;79656;111;79767;NA;46608;124;2021-04-17;43085
2021-04-16;"Bratislavský kraj";62;46723;80;46803;NA;46608;142;2021-04-16;42961
2021-04-15;"Bratislavský kraj";34;31695;74;31769;NA;46608;108;2021-04-15;42819
2021-04-14;"Bratislavský kraj";65;33494;88;33582;NA;46608;153;2021-04-14;42711
2021-04-13;"Bratislavský kraj";82;35032;82;35114;NA;46608;164;2021-04-13;42558
2021-04-12;"Bratislavský kraj";77;42034;115;42149;NA;46608;192;2021-04-12;42394
2021-04-11;"Bratislavský kraj";42;61151;123;61274;NA;46608;165;2021-04-11;42202
2021-04-10;"Bratislavský kraj";14;77167;167;77334;NA;46608;181;2021-04-10;42037
2021-04-09;"Bratislavský kraj";72;41034;97;41131;NA;46608;169;2021-04-09;41856
2021-04-08;"Bratislavský kraj";71;28475;93;28568;NA;46608;164;2021-04-08;41687
2021-04-07;"Bratislavský kraj";96;37570;101;37671;NA;46608;197;2021-04-07;41523
2021-04-06;"Bratislavský kraj";94;55523;175;55698;NA;46608;269;2021-04-06;41326
2021-04-05;"Bratislavský kraj";85;18380;85;18465;NA;46608;170;2021-04-05;41057
2021-04-04;"Bratislavský kraj";37;29225;75;29300;NA;46608;112;2021-04-04;40887
2021-04-03;"Bratislavský kraj";52;79082;220;79302;NA;46608;272;2021-04-03;40775
2021-04-02;"Bratislavský kraj";33;23790;104;23894;NA;46608;137;2021-04-02;40503
2021-04-01;"Bratislavský kraj";119;56653;158;56811;NA;46608;277;2021-04-01;40366
2021-03-31;"Bratislavský kraj";105;45689;149;45838;NA;46608;254;2021-03-31;40089
2021-03-30;"Bratislavský kraj";100;39010;142;39152;NA;46608;242;2021-03-30;39835
2021-03-29;"Bratislavský kraj";153;40124;178;40302;NA;46608;331;2021-03-29;39593
2021-03-28;"Bratislavský kraj";59;53372;137;53509;NA;46608;196;2021-03-28;39262
2021-03-27;"Bratislavský kraj";53;79160;239;79399;NA;46608;292;2021-03-27;39066
2021-03-26;"Bratislavský kraj";114;55513;190;55703;NA;46608;304;2021-03-26;38774
2021-03-25;"Bratislavský kraj";76;36300;170;36470;NA;46608;246;2021-03-25;38470
2021-03-24;"Bratislavský kraj";120;30184;200;30384;NA;46608;320;2021-03-24;38224
2021-03-23;"Bratislavský kraj";138;36029;189;36218;NA;46608;327;2021-03-23;37904
2021-03-22;"Bratislavský kraj";110;42516;218;42734;NA;46608;328;2021-03-22;37577
2021-03-21;"Bratislavský kraj";54;61299;212;61511;NA;46608;266;2021-03-21;37249
2021-03-20;"Bratislavský kraj";59;72630;228;72858;NA;46608;287;2021-03-20;36983
2021-03-19;"Bratislavský kraj";139;53952;255;54207;NA;46608;394;2021-03-19;36696
2021-03-18;"Bratislavský kraj";142;34057;190;34247;NA;46608;332;2021-03-18;36302
2021-03-17;"Bratislavský kraj";177;30179;215;30394;NA;46608;392;2021-03-17;35970
2021-03-16;"Bratislavský kraj";258;36425;282;36707;NA;46608;540;2021-03-16;35578
2021-03-15;"Bratislavský kraj";180;38089;252;38341;NA;46608;432;2021-03-15;35038
2021-03-14;"Bratislavský kraj";75;52609;275;52884;NA;46608;350;2021-03-14;34606
2021-03-13;"Bratislavský kraj";110;79741;329;80070;NA;46608;439;2021-03-13;34256
2021-03-12;"Bratislavský kraj";152;54534;301;54835;NA;46608;453;2021-03-12;33817
2021-03-11;"Bratislavský kraj";178;34290;281;34571;NA;46608;459;2021-03-11;33364
2021-03-10;"Bratislavský kraj";164;30828;273;31101;NA;46608;437;2021-03-10;32905
2021-03-09;"Bratislavský kraj";242;37798;267;38065;NA;46608;509;2021-03-09;32468
2021-03-08;"Bratislavský kraj";255;40722;343;41065;NA;46608;598;2021-03-08;31959
2021-03-07;"Bratislavský kraj";142;52812;301;53113;NA;46608;443;2021-03-07;31361
2021-03-06;"Bratislavský kraj";79;71410;412;71822;NA;46608;491;2021-03-06;30918
2021-03-05;"Bratislavský kraj";238;50484;292;50776;NA;46608;530;2021-03-05;30427
2021-03-04;"Bratislavský kraj";204;34544;344;34888;NA;46608;548;2021-03-04;29897
2021-03-03;"Bratislavský kraj";250;30525;364;30889;NA;46608;614;2021-03-03;29349
2021-03-02;"Bratislavský kraj";267;39735;388;40123;NA;46608;655;2021-03-02;28735
2021-03-01;"Bratislavský kraj";320;38222;432;38654;NA;46608;752;2021-03-01;28080
2021-02-28;"Bratislavský kraj";184;50323;323;50646;NA;46608;507;2021-02-28;27328
2021-02-27;"Bratislavský kraj";151;76580;464;77044;NA;46608;615;2021-02-27;26821
2021-02-26;"Bratislavský kraj";277;47265;400;47665;NA;46608;677;2021-02-26;26206
2021-02-25;"Bratislavský kraj";277;28769;405;29174;NA;46608;682;2021-02-25;25529
2021-02-24;"Bratislavský kraj";217;27095;412;27507;NA;46608;629;2021-02-24;24847
2021-02-23;"Bratislavský kraj";257;31297;395;31692;NA;46608;652;2021-02-23;24218
2021-02-22;"Bratislavský kraj";353;36454;480;36934;NA;46608;833;2021-02-22;23566
2021-02-21;"Bratislavský kraj";185;54150;396;54546;NA;46608;581;2021-02-21;22733
2021-02-20;"Bratislavský kraj";167;74787;550;75337;NA;46608;717;2021-02-20;22152
2021-02-19;"Bratislavský kraj";280;44871;415;45286;NA;46608;695;2021-02-19;21435
2021-02-18;"Bratislavský kraj";263;26377;371;26748;NA;46608;634;2021-02-18;20740
2021-02-17;"Bratislavský kraj";264;22815;316;23131;NA;46608;580;2021-02-17;20106
2021-02-16;"Bratislavský kraj";289;28265;354;28619;NA;46608;643;2021-02-16;19526
2021-02-15;"Bratislavský kraj";248;36893;396;37289;NA;46608;644;2021-02-15;18883
2021-02-14;"Bratislavský kraj";153;47948;323;48271;NA;46608;476;2021-02-14;18239
2021-02-13;"Bratislavský kraj";173;68589;515;69104;NA;46608;688;2021-02-13;17763
2021-02-12;"Bratislavský kraj";282;35729;327;36056;NA;46608;609;2021-02-12;17075
2021-02-11;"Bratislavský kraj";337;24542;285;24827;NA;46608;622;2021-02-11;16466
2021-02-10;"Bratislavský kraj";314;23120;359;23479;NA;46608;673;2021-02-10;15844
2021-02-09;"Bratislavský kraj";288;36565;454;37019;NA;46608;742;2021-02-09;15171
2021-02-08;"Bratislavský kraj";484;31866;397;32263;NA;46608;881;2021-02-08;14429
2021-02-07;"Bratislavský kraj";243;51290;425;51715;NA;46608;668;2021-02-07;13548
2021-02-06;"Bratislavský kraj";116;62602;508;63110;NA;46608;624;2021-02-06;12880
2021-02-05;"Bratislavský kraj";327;27033;375;27408;NA;46608;702;2021-02-05;12256
2021-02-04;"Bratislavský kraj";555;17260;348;17608;NA;46608;903;2021-02-04;11554
2021-02-03;"Bratislavský kraj";161;13057;351;13408;NA;46608;512;2021-02-03;10651
2021-02-02;"Bratislavský kraj";397;25945;480;26425;NA;46608;877;2021-02-02;10139
2021-02-01;"Bratislavský kraj";221;35536;513;36049;NA;46608;734;2021-02-01;9262
2021-01-31;"Bratislavský kraj";180;35693;425;36118;NA;46608;605;2021-01-31;8528
2021-01-30;"Bratislavský kraj";310;49588;521;50109;NA;46608;831;2021-01-30;7923
2021-01-29;"Bratislavský kraj";344;16568;344;16912;NA;46608;688;2021-01-29;7092
2021-01-28;"Bratislavský kraj";307;10710;297;11007;NA;46608;604;2021-01-28;6404
2021-01-27;"Bratislavský kraj";336;22052;340;22392;NA;46608;676;2021-01-27;5800
2021-01-26;"Bratislavský kraj";297;21550;292;21842;NA;46608;589;2021-01-26;5124
2021-01-25;"Bratislavský kraj";356;23023;243;23266;NA;46608;599;2021-01-25;4535
2021-01-24;"Bratislavský kraj";175;37903;404;38307;NA;46608;579;2021-01-24;3936
2021-01-23;"Bratislavský kraj";396;79447;690;80137;NA;46608;1086;2021-01-23;3357
2021-01-22;"Bratislavský kraj";199;42028;365;42393;NA;46608;564;2021-01-22;2271
2021-01-21;"Bratislavský kraj";255;105732;1317;107049;NA;46608;1572;2021-01-21;1707
2021-01-20;"Bratislavský kraj";360;27252;450;27702;NA;46608;810;2021-01-20;135
2021-01-19;"Bratislavský kraj";375;15309;346;15655;NA;46608;721;2021-01-19;-675
2021-01-18;"Bratislavský kraj";357;12533;707;13240;NA;46608;1064;2021-01-18;-1396
2021-01-17;"Bratislavský kraj";244;482;26;508;NA;46608;270;2021-01-17;-2460
2021-01-16;"Bratislavský kraj";70;3016;156;3172;NA;46608;226;2021-01-16;-2730
2021-01-15;"Bratislavský kraj";251;7896;256;8152;NA;46608;507;2021-01-15;-2956
2021-01-14;"Bratislavský kraj";363;8511;273;8784;NA;46608;636;2021-01-14;-3463
2021-01-13;"Bratislavský kraj";336;8490;327;8817;NA;46608;663;2021-01-13;-4099
2021-01-12;"Bratislavský kraj";450;10729;463;11192;NA;46608;913;2021-01-12;-4762
2021-01-11;"Bratislavský kraj";397;20140;381;20521;NA;46608;778;2021-01-11;-5675
2021-01-10;"Bratislavský kraj";252;1507;79;1586;NA;46608;331;2021-01-10;-6453
2021-01-09;"Bratislavský kraj";351;5005;291;5296;NA;46608;642;2021-01-09;-6784
2021-01-08;"Bratislavský kraj";556;10045;436;10481;NA;46608;992;2021-01-08;-7426
2021-01-07;"Bratislavský kraj";537;7532;409;7941;NA;46608;946;2021-01-07;-8418
2021-01-06;"Bratislavský kraj";271;3329;216;3545;NA;46608;487;2021-01-06;-9364
2021-01-05;"Bratislavský kraj";619;11035;846;11881;NA;46608;1465;2021-01-05;-9851
2021-01-04;"Bratislavský kraj";601;8634;606;9240;NA;46608;1207;2021-01-04;-11316
2021-01-03;"Bratislavský kraj";77;433;41;474;NA;46608;118;2021-01-03;-12523
2021-01-02;"Bratislavský kraj";185;462;57;519;NA;46608;242;2021-01-02;-12641
2021-01-01;"Bratislavský kraj";235;3277;131;3408;NA;46608;366;2021-01-01;-12883
2020-12-31;"Bratislavský kraj";925;14685;563;15248;NA;46608;1488;2020-12-31;-13249
2020-12-30;"Bratislavský kraj";650;9823;554;10377;NA;46608;1204;2020-12-30;-14737
2020-12-29;"Bratislavský kraj";303;10887;776;11663;NA;46608;1079;2020-12-29;-15941
2020-12-28;"Bratislavský kraj";255;8447;560;9007;NA;46608;815;2020-12-28;-17020
2020-12-27;"Bratislavský kraj";160;709;76;785;NA;46608;236;2020-12-27;-17835
2020-12-26;"Bratislavský kraj";75;480;27;507;NA;46608;102;2020-12-26;-18071
2020-12-25;"Bratislavský kraj";114;503;38;541;NA;46608;152;2020-12-25;-18173
2020-12-24;"Bratislavský kraj";536;3461;102;3563;NA;46608;638;2020-12-24;-18325
2020-12-23;"Bratislavský kraj";416;13293;500;13793;NA;46608;916;2020-12-23;-18963
2020-12-22;"Bratislavský kraj";327;15783;772;16555;NA;46608;1099;2020-12-22;-19879
2020-12-21;"Bratislavský kraj";392;15669;2007;17676;NA;46608;2399;2020-12-21;-20978
2020-12-20;"Bratislavský kraj";180;775;54;829;NA;46608;234;2020-12-20;-23377
2020-12-19;"Bratislavský kraj";396;3314;130;3444;NA;46608;526;2020-12-19;-23611
2020-12-18;"Bratislavský kraj";306;10735;401;11136;NA;46608;707;2020-12-18;-24137
2020-12-17;"Bratislavský kraj";502;10270;412;10682;NA;46608;914;2020-12-17;-24844
2020-12-16;"Bratislavský kraj";282;10772;452;11224;NA;46608;734;2020-12-16;-25758
2020-12-15;"Bratislavský kraj";423;10916;479;11395;NA;46608;902;2020-12-15;-26492
2020-12-14;"Bratislavský kraj";279;7198;293;7491;NA;46608;572;2020-12-14;-27394
2020-12-13;"Bratislavský kraj";125;139;10;149;NA;46608;135;2020-12-13;-27966
2020-12-12;"Bratislavský kraj";361;3886;157;4043;NA;46608;518;2020-12-12;-28101
2020-12-11;"Bratislavský kraj";326;7344;289;7633;NA;46608;615;2020-12-11;-28619
2020-12-10;"Bratislavský kraj";286;5823;209;6032;NA;46608;495;2020-12-10;-29234
2020-12-09;"Bratislavský kraj";382;4795;178;4973;NA;46608;560;2020-12-09;-29729
2020-12-08;"Bratislavský kraj";234;6243;207;6450;NA;46608;441;2020-12-08;-30289
2020-12-07;"Bratislavský kraj";272;4639;152;4791;NA;46608;424;2020-12-07;-30730
2020-12-06;"Bratislavský kraj";61;1625;52;1677;NA;46608;113;2020-12-06;-31154
2020-12-05;"Bratislavský kraj";266;2221;41;2262;NA;46608;307;2020-12-05;-31267
2020-12-04;"Bratislavský kraj";200;4954;99;5053;NA;46608;299;2020-12-04;-31574
2020-12-03;"Bratislavský kraj";213;5672;95;5767;NA;46608;308;2020-12-03;-31873
2020-12-02;"Bratislavský kraj";205;3462;103;3565;NA;46608;308;2020-12-02;-32181
2020-12-01;"Bratislavský kraj";255;3889;172;4061;NA;46608;427;2020-12-01;-32489
2020-11-30;"Bratislavský kraj";152;2153;121;2274;NA;46608;273;2020-11-30;-32916
2020-11-29;"Bratislavský kraj";52;201;24;225;NA;46608;76;2020-11-29;-33189
2020-11-28;"Bratislavský kraj";232;2624;33;2657;NA;46608;265;2020-11-28;-33265
2020-11-27;"Bratislavský kraj";54;2540;64;2604;NA;46608;118;2020-11-27;-33530
2020-11-26;"Bratislavský kraj";129;1976;60;2036;NA;46608;189;2020-11-26;-33648
2020-11-25;"Bratislavský kraj";140;1770;47;1817;NA;46608;187;2020-11-25;-33837
2020-11-24;"Bratislavský kraj";81;2988;67;3055;NA;46608;148;2020-11-24;-34024
2020-11-23;"Bratislavský kraj";67;7083;58;7141;NA;46608;125;2020-11-23;-34172
2020-11-22;"Bratislavský kraj";36;81;7;88;NA;46608;43;2020-11-22;-34297
2020-11-21;"Bratislavský kraj";109;2126;47;2173;NA;46608;156;2020-11-21;-34340
2020-11-20;"Bratislavský kraj";118;2876;48;2924;NA;46608;166;2020-11-20;-34496
2020-11-19;"Bratislavský kraj";173;987;29;1016;NA;46608;202;2020-11-19;-34662
2020-11-18;"Bratislavský kraj";118;616;75;691;NA;46608;193;2020-11-18;-34864
2020-11-17;"Bratislavský kraj";108;928;23;951;NA;46608;131;2020-11-17;-35057
2020-11-16;"Bratislavský kraj";82;651;9;660;NA;46608;91;2020-11-16;-35188
2020-11-15;"Bratislavský kraj";47;236;0;236;NA;46608;47;2020-11-15;-35279
2020-11-14;"Bratislavský kraj";53;1834;15;1849;NA;46608;68;2020-11-14;-35326
2020-11-13;"Bratislavský kraj";94;2096;21;2117;NA;46608;115;2020-11-13;-35394
2020-11-12;"Bratislavský kraj";141;1727;6;1733;NA;46608;147;2020-11-12;-35509
2020-11-11;"Bratislavský kraj";159;1429;12;1441;NA;46608;171;2020-11-11;-35656
2020-11-10;"Bratislavský kraj";136;805;14;819;NA;46608;150;2020-11-10;-35827
2020-11-09;"Bratislavský kraj";70;616;8;624;NA;46608;78;2020-11-09;-35977
2020-11-08;"Bratislavský kraj";82;869;6;875;NA;46608;88;2020-11-08;-36055
2020-11-07;"Bratislavský kraj";88;4039;17;4056;NA;46608;105;2020-11-07;-36143
2020-11-06;"Bratislavský kraj";281;6441;25;6466;NA;46608;306;2020-11-06;-36248
2020-11-05;"Bratislavský kraj";175;476;11;487;NA;46608;186;2020-11-05;-36554
2020-11-04;"Bratislavský kraj";65;411;10;421;NA;46608;75;2020-11-04;-36740
2020-11-03;"Bratislavský kraj";251;1085;12;1097;NA;46608;263;2020-11-03;-36815
2020-11-02;"Bratislavský kraj";202;3365;22;3387;NA;46608;224;2020-11-02;-37078
2020-11-01;"Bratislavský kraj";227;8694;39;8733;NA;46608;266;2020-11-01;-37302
2020-10-31;"Bratislavský kraj";173;22407;123;22530;NA;46608;296;2020-10-31;-37568
2020-10-30;"Bratislavský kraj";158;17350;138;17488;NA;46608;296;2020-10-30;-37864
2020-10-29;"Bratislavský kraj";262;116;4;120;NA;46608;266;2020-10-29;-38160
2020-10-28;"Bratislavský kraj";220;260;15;275;NA;46608;235;2020-10-28;-38426
2020-10-27;"Bratislavský kraj";256;145;4;149;NA;46608;260;2020-10-27;-38661
2020-10-26;"Bratislavský kraj";123;229;11;240;NA;46608;134;2020-10-26;-38921
2020-10-25;"Bratislavský kraj";152;33;2;35;NA;46608;154;2020-10-25;-39055
2020-10-24;"Bratislavský kraj";170;221;6;227;NA;46608;176;2020-10-24;-39209
2020-10-23;"Bratislavský kraj";151;144;8;152;NA;46608;159;2020-10-23;-39385
2020-10-22;"Bratislavský kraj";192;204;15;219;NA;46608;207;2020-10-22;-39544
2020-10-21;"Bratislavský kraj";66;90;6;96;NA;46608;72;2020-10-21;-39751
2020-10-20;"Bratislavský kraj";183;97;4;101;NA;46608;187;2020-10-20;-39823
2020-10-19;"Bratislavský kraj";148;80;3;83;NA;46608;151;2020-10-19;-40010
2020-10-18;"Bratislavský kraj";75;92;0;92;NA;46608;75;2020-10-18;-40161
2020-10-17;"Bratislavský kraj";136;0;0;0;NA;46608;136;2020-10-17;-40236
2020-10-16;"Bratislavský kraj";103;14;1;15;NA;46608;104;2020-10-16;-40372
2020-10-15;"Bratislavský kraj";135;6;1;7;NA;46608;136;2020-10-15;-40476
2020-10-14;"Bratislavský kraj";127;4;0;4;NA;46608;127;2020-10-14;-40612
2020-10-13;"Bratislavský kraj";86;108;8;116;NA;46608;94;2020-10-13;-40739
2020-10-12;"Bratislavský kraj";46;0;0;0;NA;46608;46;2020-10-12;-40833
2020-10-11;"Bratislavský kraj";80;0;0;0;NA;46608;80;2020-10-11;-40879
2020-10-10;"Bratislavský kraj";55;0;0;0;NA;46608;55;2020-10-10;-40959
2020-10-09;"Bratislavský kraj";148;0;0;0;NA;46608;148;2020-10-09;-41014
2020-10-08;"Bratislavský kraj";100;0;0;0;NA;46608;100;2020-10-08;-41162
2020-10-07;"Bratislavský kraj";107;0;0;0;NA;46608;107;2020-10-07;-41262
2020-10-06;"Bratislavský kraj";108;0;0;0;NA;46608;108;2020-10-06;-41369
2020-10-05;"Bratislavský kraj";30;0;0;0;NA;46608;30;2020-10-05;-41477
2020-10-04;"Bratislavský kraj";49;0;0;0;NA;46608;49;2020-10-04;-41507
2020-10-03;"Bratislavský kraj";82;0;0;0;NA;46608;82;2020-10-03;-41556
2020-10-02;"Bratislavský kraj";101;0;0;0;NA;46608;101;2020-10-02;-41638
2020-10-01;"Bratislavský kraj";72;0;0;0;NA;46608;72;2020-10-01;-41739
2020-09-30;"Bratislavský kraj";91;0;0;0;NA;46608;91;2020-09-30;-41811
2020-09-29;"Bratislavský kraj";74;0;0;0;NA;46608;74;2020-09-29;-41902
2020-09-28;"Bratislavský kraj";29;0;0;0;NA;46608;29;2020-09-28;-41976
2020-09-27;"Bratislavský kraj";48;0;0;0;NA;46608;48;2020-09-27;-42005
2020-09-26;"Bratislavský kraj";86;0;0;0;NA;46608;86;2020-09-26;-42053
2020-09-25;"Bratislavský kraj";97;0;0;0;NA;46608;97;2020-09-25;-42139
2020-09-24;"Bratislavský kraj";73;0;0;0;NA;46608;73;2020-09-24;-42236
2020-09-23;"Bratislavský kraj";55;0;0;0;NA;46608;55;2020-09-23;-42309
2020-09-22;"Bratislavský kraj";81;0;0;0;NA;46608;81;2020-09-22;-42364
2020-09-21;"Bratislavský kraj";32;0;0;0;NA;46608;32;2020-09-21;-42445
2020-09-20;"Bratislavský kraj";25;0;0;0;NA;46608;25;2020-09-20;-42477
2020-09-19;"Bratislavský kraj";59;0;0;0;NA;46608;59;2020-09-19;-42502
2020-09-18;"Bratislavský kraj";42;0;0;0;NA;46608;42;2020-09-18;-42561
2020-09-17;"Bratislavský kraj";52;0;0;0;NA;46608;52;2020-09-17;-42603
2020-09-16;"Bratislavský kraj";32;0;0;0;NA;46608;32;2020-09-16;-42655
2020-09-15;"Bratislavský kraj";26;0;0;0;NA;46608;26;2020-09-15;-42687
2020-09-14;"Bratislavský kraj";24;0;0;0;NA;46608;24;2020-09-14;-42713
2020-09-13;"Bratislavský kraj";11;0;0;0;NA;46608;11;2020-09-13;-42737
2020-09-12;"Bratislavský kraj";24;0;0;0;NA;46608;24;2020-09-12;-42748
2020-09-11;"Bratislavský kraj";50;0;0;0;NA;46608;50;2020-09-11;-42772
2020-09-10;"Bratislavský kraj";47;0;0;0;NA;46608;47;2020-09-10;-42822
2020-09-09;"Bratislavský kraj";40;0;0;0;NA;46608;40;2020-09-09;-42869
2020-09-08;"Bratislavský kraj";58;0;0;0;NA;46608;58;2020-09-08;-42909
2020-09-07;"Bratislavský kraj";39;0;0;0;NA;46608;39;2020-09-07;-42967
2020-09-06;"Bratislavský kraj";11;0;0;0;NA;46608;11;2020-09-06;-43006
2020-09-05;"Bratislavský kraj";37;0;0;0;NA;46608;37;2020-09-05;-43017
2020-09-04;"Bratislavský kraj";87;0;0;0;NA;46608;87;2020-09-04;-43054
2020-09-03;"Bratislavský kraj";51;0;0;0;NA;46608;51;2020-09-03;-43141
2020-09-02;"Bratislavský kraj";50;0;0;0;NA;46608;50;2020-09-02;-43192
2020-09-01;"Bratislavský kraj";16;0;0;0;NA;46608;16;2020-09-01;-43242
2020-08-31;"Bratislavský kraj";19;0;0;0;NA;46608;19;2020-08-31;-43258
2020-08-30;"Bratislavský kraj";9;0;0;0;NA;46608;9;2020-08-30;-43277
2020-08-29;"Bratislavský kraj";12;0;0;0;NA;46608;12;2020-08-29;-43286
2020-08-28;"Bratislavský kraj";35;0;0;0;NA;46608;35;2020-08-28;-43298
2020-08-27;"Bratislavský kraj";33;0;0;0;NA;46608;33;2020-08-27;-43333
2020-08-26;"Bratislavský kraj";27;0;0;0;NA;46608;27;2020-08-26;-43366
2020-08-25;"Bratislavský kraj";29;0;0;0;NA;46608;29;2020-08-25;-43393
2020-08-24;"Bratislavský kraj";6;0;0;0;NA;46608;6;2020-08-24;-43422
2020-08-23;"Bratislavský kraj";45;0;0;0;NA;46608;45;2020-08-23;-43428
2020-08-22;"Bratislavský kraj";13;0;0;0;NA;46608;13;2020-08-22;-43473
2020-08-21;"Bratislavský kraj";46;0;0;0;NA;46608;46;2020-08-21;-43486
2020-08-20;"Bratislavský kraj";41;0;0;0;NA;46608;41;2020-08-20;-43532
2020-08-19;"Bratislavský kraj";27;0;0;0;NA;46608;27;2020-08-19;-43573
2020-08-18;"Bratislavský kraj";47;0;0;0;NA;46608;47;2020-08-18;-43600
2020-08-17;"Bratislavský kraj";2;0;0;0;NA;46608;2;2020-08-17;-43647
2020-08-16;"Bratislavský kraj";3;0;0;0;NA;46608;3;2020-08-16;-43649
2020-08-15;"Bratislavský kraj";18;0;0;0;NA;46608;18;2020-08-15;-43652
2020-08-14;"Bratislavský kraj";16;0;0;0;NA;46608;16;2020-08-14;-43670
2020-08-13;"Bratislavský kraj";12;0;0;0;NA;46608;12;2020-08-13;-43686
2020-08-12;"Bratislavský kraj";10;0;0;0;NA;46608;10;2020-08-12;-43698
2020-08-11;"Bratislavský kraj";23;0;0;0;NA;46608;23;2020-08-11;-43708
2020-08-10;"Bratislavský kraj";2;0;0;0;NA;46608;2;2020-08-10;-43731
2020-08-09;"Bratislavský kraj";2;0;0;0;NA;46608;2;2020-08-09;-43733
2020-08-08;"Bratislavský kraj";1;0;0;0;NA;46608;1;2020-08-08;-43735
2020-08-07;"Bratislavský kraj";9;0;0;0;NA;46608;9;2020-08-07;-43736
2020-08-06;"Bratislavský kraj";15;0;0;0;NA;46608;15;2020-08-06;-43745
2020-08-05;"Bratislavský kraj";11;0;0;0;NA;46608;11;2020-08-05;-43760
2020-08-04;"Bratislavský kraj";21;0;0;0;NA;46608;21;2020-08-04;-43771
2020-08-03;"Bratislavský kraj";7;0;0;0;NA;46608;7;2020-08-03;-43792
2020-08-02;"Bratislavský kraj";0;0;0;0;NA;46608;0;2020-08-02;-43799
2020-08-01;"Bratislavský kraj";0;0;0;0;NA;46608;0;2020-08-01;-43799
2020-07-31;"Bratislavský kraj";14;0;0;0;NA;46608;14;2020-07-31;-43799
2020-07-30;"Bratislavský kraj";6;0;0;0;NA;46608;6;2020-07-30;-43813
2020-07-29;"Bratislavský kraj";7;0;0;0;NA;46608;7;2020-07-29;-43819
2020-07-28;"Bratislavský kraj";14;0;0;0;NA;46608;14;2020-07-28;-43826
2020-07-27;"Bratislavský kraj";3;0;0;0;NA;46608;3;2020-07-27;-43840
2020-07-26;"Bratislavský kraj";0;0;0;0;NA;46608;0;2020-07-26;-43843
2020-07-25;"Bratislavský kraj";8;0;0;0;NA;46608;8;2020-07-25;-43843
2020-07-24;"Bratislavský kraj";2;0;0;0;NA;46608;2;2020-07-24;-43851
2020-07-23;"Bratislavský kraj";8;0;0;0;NA;46608;8;2020-07-23;-43853
2020-07-22;"Bratislavský kraj";11;0;0;0;NA;46608;11;2020-07-22;-43861
2020-07-21;"Bratislavský kraj";8;0;0;0;NA;46608;8;2020-07-21;-43872
2020-07-20;"Bratislavský kraj";12;0;0;0;NA;46608;12;2020-07-20;-43880
2020-07-19;"Bratislavský kraj";0;0;0;0;NA;46608;0;2020-07-19;-43892
2020-07-18;"Bratislavský kraj";2;0;0;0;NA;46608;2;2020-07-18;-43892
2020-07-17;"Bratislavský kraj";2;0;0;0;NA;46608;2;2020-07-17;-43894
2020-07-16;"Bratislavský kraj";6;0;0;0;NA;46608;6;2020-07-16;-43896
2020-07-15;"Bratislavský kraj";3;0;0;0;NA;46608;3;2020-07-15;-43902
2020-07-14;"Bratislavský kraj";2;0;0;0;NA;46608;2;2020-07-14;-43905
2020-07-13;"Bratislavský kraj";2;0;0;0;NA;46608;2;2020-07-13;-43907
2020-07-12;"Bratislavský kraj";0;0;0;0;NA;46608;0;2020-07-12;-43909
2020-07-11;"Bratislavský kraj";0;0;0;0;NA;46608;0;2020-07-11;-43909
2020-07-10;"Bratislavský kraj";8;0;0;0;NA;46608;8;2020-07-10;-43909
2020-07-09;"Bratislavský kraj";2;0;0;0;NA;46608;2;2020-07-09;-43917
2020-07-08;"Bratislavský kraj";11;0;0;0;NA;46608;11;2020-07-08;-43919
2020-07-07;"Bratislavský kraj";5;0;0;0;NA;46608;5;2020-07-07;-43930
2020-07-06;"Bratislavský kraj";1;0;0;0;NA;46608;1;2020-07-06;-43935
2020-07-05;"Bratislavský kraj";0;0;0;0;NA;46608;0;2020-07-05;-43936
2020-07-04;"Bratislavský kraj";3;0;0;0;NA;46608;3;2020-07-04;-43936
2020-07-03;"Bratislavský kraj";1;0;0;0;NA;46608;1;2020-07-03;-43939
2020-07-02;"Bratislavský kraj";0;0;0;0;NA;46608;0;2020-07-02;-43940
2020-07-01;"Bratislavský kraj";7;0;0;0;NA;46608;7;2020-07-01;-43940
2020-06-30;"Bratislavský kraj";3;0;0;0;NA;46608;3;2020-06-30;-43947
2020-06-29;"Bratislavský kraj";1;0;0;0;NA;46608;1;2020-06-29;-43950
2020-06-28;"Bratislavský kraj";0;0;0;0;NA;46608;0;2020-06-28;-43951
2020-06-27;"Bratislavský kraj";1;0;0;0;NA;46608;1;2020-06-27;-43951
2020-06-26;"Bratislavský kraj";6;0;0;0;NA;46608;6;2020-06-26;-43952
2020-06-25;"Bratislavský kraj";0;0;0;0;NA;46608;0;2020-06-25;-43958
2020-06-24;"Bratislavský kraj";3;0;0;0;NA;46608;3;2020-06-24;-43958
2020-06-23;"Bratislavský kraj";0;0;0;0;NA;46608;0;2020-06-23;-43961
2020-06-22;"Bratislavský kraj";1;0;0;0;NA;46608;1;2020-06-22;-43961
2020-06-21;"Bratislavský kraj";0;0;0;0;NA;46608;0;2020-06-21;-43962
2020-06-20;"Bratislavský kraj";0;0;0;0;NA;46608;0;2020-06-20;-43962
2020-06-19;"Bratislavský kraj";3;0;0;0;NA;46608;3;2020-06-19;-43962
2020-06-18;"Bratislavský kraj";0;0;0;0;NA;46608;0;2020-06-18;-43965
2020-06-17;"Bratislavský kraj";0;0;0;0;NA;46608;0;2020-06-17;-43965
2020-06-16;"Bratislavský kraj";0;0;0;0;NA;46608;0;2020-06-16;-43965
2020-06-14;"Bratislavský kraj";2;0;0;0;NA;46608;2;2020-06-14;-43965
2020-06-13;"Bratislavský kraj";1;0;0;0;NA;46608;1;2020-06-13;-43967
2020-06-12;"Bratislavský kraj";2;0;0;0;NA;46608;2;2020-06-12;-43968
2020-06-11;"Bratislavský kraj";0;0;0;0;NA;46608;0;2020-06-11;-43970
2020-06-10;"Bratislavský kraj";0;0;0;0;NA;46608;0;2020-06-10;-43970
2020-06-09;"Bratislavský kraj";0;0;0;0;NA;46608;0;2020-06-09;-43970
2020-06-08;"Bratislavský kraj";1;0;0;0;NA;46608;1;2020-06-08;-43970
2020-06-07;"Bratislavský kraj";0;0;0;0;NA;46608;0;2020-06-07;-43971
2020-06-05;"Bratislavský kraj";0;0;0;0;NA;46608;0;2020-06-05;-43971
2020-06-03;"Bratislavský kraj";1;0;0;0;NA;46608;1;2020-06-03;-43971
2020-06-02;"Bratislavský kraj";0;0;0;0;NA;46608;0;2020-06-02;-43972
2020-05-31;"Bratislavský kraj";0;0;0;0;NA;46608;0;2020-05-31;-43972
2020-05-29;"Bratislavský kraj";0;0;0;0;NA;46608;0;2020-05-29;-43972
2020-05-27;"Bratislavský kraj";1;0;0;0;NA;46608;1;2020-05-27;-43972
2020-05-26;"Bratislavský kraj";0;0;0;0;NA;46608;0;2020-05-26;-43973
2020-05-25;"Bratislavský kraj";0;0;0;0;NA;46608;0;2020-05-25;-43973
2020-05-24;"Bratislavský kraj";0;0;0;0;NA;46608;0;2020-05-24;-43973
2020-05-23;"Bratislavský kraj";2;0;0;0;NA;46608;2;2020-05-23;-43973
2020-05-22;"Bratislavský kraj";0;0;0;0;NA;46608;0;2020-05-22;-43975
2020-05-21;"Bratislavský kraj";0;0;0;0;NA;46608;0;2020-05-21;-43975
2020-05-20;"Bratislavský kraj";0;0;0;0;NA;46608;0;2020-05-20;-43975
2020-05-19;"Bratislavský kraj";0;0;0;0;NA;46608;0;2020-05-19;-43975
2020-05-17;"Bratislavský kraj";0;0;0;0;NA;46608;0;2020-05-17;-43975
2020-05-16;"Bratislavský kraj";0;0;0;0;NA;46608;0;2020-05-16;-43975
2020-05-15;"Bratislavský kraj";0;0;0;0;NA;46608;0;2020-05-15;-43975
2020-05-14;"Bratislavský kraj";0;0;0;0;NA;46608;0;2020-05-14;-43975
2020-05-13;"Bratislavský kraj";0;0;0;0;NA;46608;0;2020-05-13;-43975
2020-05-12;"Bratislavský kraj";2;0;0;0;NA;46608;2;2020-05-12;-43975
2020-05-11;"Bratislavský kraj";0;0;0;0;NA;46608;0;2020-05-11;-43977
2020-05-09;"Bratislavský kraj";0;0;0;0;NA;46608;0;2020-05-09;-43977
2020-05-07;"Bratislavský kraj";1;0;0;0;NA;46608;1;2020-05-07;-43977
2020-05-06;"Bratislavský kraj";3;0;0;0;NA;46608;3;2020-05-06;-43978
2020-05-05;"Bratislavský kraj";0;0;0;0;NA;46608;0;2020-05-05;-43981
2020-05-04;"Bratislavský kraj";0;0;0;0;NA;46608;0;2020-05-04;-43981
2020-05-03;"Bratislavský kraj";2;0;0;0;NA;46608;2;2020-05-03;-43981
2020-05-02;"Bratislavský kraj";0;0;0;0;NA;46608;0;2020-05-02;-43983
2020-05-01;"Bratislavský kraj";0;0;0;0;NA;46608;0;2020-05-01;-43983
2020-04-30;"Bratislavský kraj";5;0;0;0;NA;46608;5;2020-04-30;-43983
2020-04-29;"Bratislavský kraj";0;0;0;0;NA;46608;0;2020-04-29;-43988
2020-04-28;"Bratislavský kraj";2;0;0;0;NA;46608;2;2020-04-28;-43988
2020-04-27;"Bratislavský kraj";0;0;0;0;NA;46608;0;2020-04-27;-43990
2020-04-26;"Bratislavský kraj";1;0;0;0;NA;46608;1;2020-04-26;-43990
2020-04-25;"Bratislavský kraj";0;0;0;0;NA;46608;0;2020-04-25;-43991
2020-04-24;"Bratislavský kraj";2;0;0;0;NA;46608;2;2020-04-24;-43991
2020-04-23;"Bratislavský kraj";6;0;0;0;NA;46608;6;2020-04-23;-43993
2020-04-22;"Bratislavský kraj";11;0;0;0;NA;46608;11;2020-04-22;-43999
2020-04-21;"Bratislavský kraj";4;0;0;0;NA;46608;4;2020-04-21;-44010
2020-04-20;"Bratislavský kraj";0;0;0;0;NA;46608;0;2020-04-20;-44014
2020-04-19;"Bratislavský kraj";4;0;0;0;NA;46608;4;2020-04-19;-44014
2020-04-18;"Bratislavský kraj";5;0;0;0;NA;46608;5;2020-04-18;-44018
2020-04-17;"Bratislavský kraj";6;0;0;0;NA;46608;6;2020-04-17;-44023
2020-04-16;"Bratislavský kraj";15;0;0;0;NA;46608;15;2020-04-16;-44029
2020-04-15;"Bratislavský kraj";11;0;0;0;NA;46608;11;2020-04-15;-44044
2020-04-14;"Bratislavský kraj";19;0;0;0;NA;46608;19;2020-04-14;-44055
2020-04-13;"Bratislavský kraj";53;0;0;0;NA;46608;53;2020-04-13;-44074
2020-04-12;"Bratislavský kraj";3;0;0;0;NA;46608;3;2020-04-12;-44127
2020-04-11;"Bratislavský kraj";1;0;0;0;NA;46608;1;2020-04-11;-44130
2020-04-10;"Bratislavský kraj";8;0;0;0;NA;46608;8;2020-04-10;-44131
2020-04-09;"Bratislavský kraj";3;0;0;0;NA;46608;3;2020-04-09;-44139
2020-04-08;"Bratislavský kraj";3;0;0;0;NA;46608;3;2020-04-08;-44142
2020-04-07;"Bratislavský kraj";24;0;0;0;NA;46608;24;2020-04-07;-44145
2020-04-06;"Bratislavský kraj";5;0;0;0;NA;46608;5;2020-04-06;-44169
2020-04-05;"Bratislavský kraj";6;0;0;0;NA;46608;6;2020-04-05;-44174
2020-04-04;"Bratislavský kraj";2;0;0;0;NA;46608;2;2020-04-04;-44180
2020-04-03;"Bratislavský kraj";1;0;0;0;NA;46608;1;2020-04-03;-44182
2020-04-02;"Bratislavský kraj";2;0;0;0;NA;46608;2;2020-04-02;-44183
2020-04-01;"Bratislavský kraj";5;0;0;0;NA;46608;5;2020-04-01;-44185
2020-03-31;"Bratislavský kraj";19;0;0;0;NA;46608;19;2020-03-31;-44190
2020-03-30;"Bratislavský kraj";6;0;0;0;NA;46608;6;2020-03-30;-44209
2020-03-29;"Bratislavský kraj";8;0;0;0;NA;46608;8;2020-03-29;-44215
2020-03-28;"Bratislavský kraj";4;0;0;0;NA;46608;4;2020-03-28;-44223
2020-03-27;"Bratislavský kraj";3;0;0;0;NA;46608;3;2020-03-27;-44227
2020-03-26;"Bratislavský kraj";15;0;0;0;NA;46608;15;2020-03-26;-44230
2020-03-25;"Bratislavský kraj";1;0;0;0;NA;46608;1;2020-03-25;-44245
2020-03-24;"Bratislavský kraj";4;0;0;0;NA;46608;4;2020-03-24;-44246
2020-03-23;"Bratislavský kraj";9;0;0;0;NA;46608;9;2020-03-23;-44250
2020-03-22;"Bratislavský kraj";2;0;0;0;NA;46608;2;2020-03-22;-44259
2020-03-21;"Bratislavský kraj";22;0;0;0;NA;46608;22;2020-03-21;-44261
2020-03-20;"Bratislavský kraj";3;0;0;0;NA;46608;3;2020-03-20;-44283
2020-03-19;"Bratislavský kraj";4;0;0;0;NA;46608;4;2020-03-19;-44286
2020-03-18;"Bratislavský kraj";3;0;0;0;NA;46608;3;2020-03-18;-44290
2020-03-17;"Bratislavský kraj";13;0;0;0;NA;46608;13;2020-03-17;-44293
2020-03-16;"Bratislavský kraj";1;0;0;0;NA;46608;1;2020-03-16;-44306
2020-03-15;"Bratislavský kraj";4;0;0;0;NA;46608;4;2020-03-15;-44307
2020-03-14;"Bratislavský kraj";9;0;0;0;NA;46608;9;2020-03-14;-44311
2020-03-13;"Bratislavský kraj";2;0;0;0;NA;46608;2;2020-03-13;-44320
2020-03-12;"Bratislavský kraj";8;0;0;0;NA;46608;8;2020-03-12;-44322
2020-03-11;"Bratislavský kraj";3;0;0;0;NA;46608;3;2020-03-11;-44330
2020-03-09;"Bratislavský kraj";0;0;0;0;NA;46608;0;2020-03-09;-44333
2020-03-08;"Bratislavský kraj";2;0;0;0;NA;46608;2;2020-03-08;-44333
2020-03-07;"Bratislavský kraj";2;0;0;0;NA;46608;2;2020-03-07;-44335
2020-03-06;"Bratislavský kraj";1;0;0;0;NA;46608;1;2020-03-06;-44337
2021-06-22;"Košický kraj";1;3939;1;3940;0;44720;2;2021-06-22;44720
2021-06-21;"Košický kraj";5;6742;10;6752;NA;44720;15;2021-06-21;44718
2021-06-20;"Košický kraj";0;4653;5;4658;NA;44720;5;2021-06-20;44703
2021-06-19;"Košický kraj";7;6068;1;6069;NA;44720;8;2021-06-19;44698
2021-06-18;"Košický kraj";4;7411;7;7418;NA;44720;11;2021-06-18;44690
2021-06-17;"Košický kraj";6;5792;3;5795;NA;44720;9;2021-06-17;44679
2021-06-16;"Košický kraj";11;5734;7;5741;NA;44720;18;2021-06-16;44670
2021-06-15;"Košický kraj";12;6260;2;6262;NA;44720;14;2021-06-15;44652
2021-06-14;"Košický kraj";10;6777;9;6786;NA;44720;19;2021-06-14;44638
2021-06-13;"Košický kraj";7;6916;8;6924;NA;44720;15;2021-06-13;44619
2021-06-12;"Košický kraj";7;7424;9;7433;NA;44720;16;2021-06-12;44604
2021-06-11;"Košický kraj";15;8774;5;8779;NA;44720;20;2021-06-11;44588
2021-06-10;"Košický kraj";11;6540;16;6556;NA;44720;27;2021-06-10;44568
2021-06-09;"Košický kraj";37;5995;7;6002;NA;44720;44;2021-06-09;44541
2021-06-08;"Košický kraj";33;6954;13;6967;NA;44720;46;2021-06-08;44497
2021-06-07;"Košický kraj";11;7735;22;7757;NA;44720;33;2021-06-07;44451
2021-06-06;"Košický kraj";1;7803;7;7810;NA;44720;8;2021-06-06;44418
2021-06-05;"Košický kraj";21;9221;3;9224;NA;44720;24;2021-06-05;44410
2021-06-04;"Košický kraj";26;11262;20;11282;NA;44720;46;2021-06-04;44386
2021-06-03;"Košický kraj";23;6472;14;6486;NA;44720;37;2021-06-03;44340
2021-06-02;"Košický kraj";15;7114;24;7138;NA;44720;39;2021-06-02;44303
2021-06-01;"Košický kraj";13;7541;10;7551;NA;44720;23;2021-06-01;44264
2021-05-31;"Košický kraj";13;9224;17;9241;NA;44720;30;2021-05-31;44241
2021-05-30;"Košický kraj";3;11154;10;11164;NA;44720;13;2021-05-30;44211
2021-05-29;"Košický kraj";25;10863;21;10884;NA;44720;46;2021-05-29;44198
2021-05-28;"Košický kraj";17;12959;29;12988;NA;44720;46;2021-05-28;44152
2021-05-27;"Košický kraj";19;7810;24;7834;NA;44720;43;2021-05-27;44106
2021-05-26;"Košický kraj";35;8039;26;8065;NA;44720;61;2021-05-26;44063
2021-05-25;"Košický kraj";33;9148;12;9160;NA;44720;45;2021-05-25;44002
2021-05-24;"Košický kraj";10;10855;27;10882;NA;44720;37;2021-05-24;43957
2021-05-23;"Košický kraj";4;12084;15;12099;NA;44720;19;2021-05-23;43920
2021-05-22;"Košický kraj";27;12472;18;12490;NA;44720;45;2021-05-22;43901
2021-05-21;"Košický kraj";24;14753;27;14780;NA;44720;51;2021-05-21;43856
2021-05-20;"Košický kraj";20;9320;27;9347;NA;44720;47;2021-05-20;43805
2021-05-19;"Košický kraj";30;10346;19;10365;NA;44720;49;2021-05-19;43758
2021-05-18;"Košický kraj";34;10254;36;10290;NA;44720;70;2021-05-18;43709
2021-05-17;"Košický kraj";20;12628;38;12666;NA;44720;58;2021-05-17;43639
2021-05-16;"Košický kraj";37;17686;19;17705;NA;44720;56;2021-05-16;43581
2021-05-15;"Košický kraj";22;25399;27;25426;NA;44720;49;2021-05-15;43525
2021-05-14;"Košický kraj";32;21537;42;21579;NA;44720;74;2021-05-14;43476
2021-05-13;"Košický kraj";39;10172;32;10204;NA;44720;71;2021-05-13;43402
2021-05-12;"Košický kraj";85;10868;33;10901;NA;44720;118;2021-05-12;43331
2021-05-11;"Košický kraj";68;11166;32;11198;NA;44720;100;2021-05-11;43213
2021-05-10;"Košický kraj";25;16886;41;16927;NA;44720;66;2021-05-10;43113
2021-05-09;"Košický kraj";84;25262;53;25315;NA;44720;137;2021-05-09;43047
2021-05-08;"Košický kraj";18;22917;21;22938;NA;44720;39;2021-05-08;42910
2021-05-07;"Košický kraj";51;24097;55;24152;NA;44720;106;2021-05-07;42871
2021-05-06;"Košický kraj";55;11847;43;11890;NA;44720;98;2021-05-06;42765
2021-05-05;"Košický kraj";23;12004;35;12039;NA;44720;58;2021-05-05;42667
2021-05-04;"Košický kraj";143;13562;38;13600;NA;44720;181;2021-05-04;42609
2021-05-03;"Košický kraj";37;16944;68;17012;NA;44720;105;2021-05-03;42428
2021-05-02;"Košický kraj";45;36096;56;36152;NA;44720;101;2021-05-02;42323
2021-05-01;"Košický kraj";54;51809;76;51885;NA;44720;130;2021-05-01;42222
2021-04-30;"Košický kraj";59;44602;94;44696;NA;44720;153;2021-04-30;42092
2021-04-29;"Košický kraj";76;16986;53;17039;NA;44720;129;2021-04-29;41939
2021-04-28;"Košický kraj";99;17930;52;17982;NA;44720;151;2021-04-28;41810
2021-04-27;"Košický kraj";108;20670;43;20713;NA;44720;151;2021-04-27;41659
2021-04-26;"Košický kraj";39;25897;96;25993;NA;44720;135;2021-04-26;41508
2021-04-25;"Košický kraj";23;48355;57;48412;NA;44720;80;2021-04-25;41373
2021-04-24;"Košický kraj";68;90124;114;90238;NA;44720;182;2021-04-24;41293
2021-04-23;"Košický kraj";110;41232;72;41304;NA;44720;182;2021-04-23;41111
2021-04-22;"Košický kraj";56;16772;44;16816;NA;44720;100;2021-04-22;40929
2021-04-21;"Košický kraj";114;19519;61;19580;NA;44720;175;2021-04-21;40829
2021-04-20;"Košický kraj";81;25359;63;25422;NA;44720;144;2021-04-20;40654
2021-04-19;"Košický kraj";93;29950;108;30058;NA;44720;201;2021-04-19;40510
2021-04-18;"Košický kraj";10;48913;82;48995;NA;44720;92;2021-04-18;40309
2021-04-17;"Košický kraj";187;83856;103;83959;NA;44720;290;2021-04-17;40217
2021-04-16;"Košický kraj";83;41568;127;41695;NA;44720;210;2021-04-16;39927
2021-04-15;"Košický kraj";104;18522;93;18615;NA;44720;197;2021-04-15;39717
2021-04-14;"Košický kraj";119;20089;64;20153;NA;44720;183;2021-04-14;39520
2021-04-13;"Košický kraj";81;23175;120;23295;NA;44720;201;2021-04-13;39337
2021-04-12;"Košický kraj";129;26573;124;26697;NA;44720;253;2021-04-12;39136
2021-04-11;"Košický kraj";29;46948;79;47027;NA;44720;108;2021-04-11;38883
2021-04-10;"Košický kraj";138;99836;183;100019;NA;44720;321;2021-04-10;38775
2021-04-09;"Košický kraj";168;35206;133;35339;NA;44720;301;2021-04-09;38454
2021-04-08;"Košický kraj";81;18530;90;18620;NA;44720;171;2021-04-08;38153
2021-04-07;"Košický kraj";232;28027;194;28221;NA;44720;426;2021-04-07;37982
2021-04-06;"Košický kraj";121;36495;164;36659;NA;44720;285;2021-04-06;37556
2021-04-05;"Košický kraj";19;14361;66;14427;NA;44720;85;2021-04-05;37271
2021-04-04;"Košický kraj";33;15089;66;15155;NA;44720;99;2021-04-04;37186
2021-04-03;"Košický kraj";138;97664;241;97905;NA;44720;379;2021-04-03;37087
2021-04-02;"Košický kraj";128;24290;76;24366;NA;44720;204;2021-04-02;36708
2021-04-01;"Košický kraj";165;46151;156;46307;NA;44720;321;2021-04-01;36504
2021-03-31;"Košický kraj";160;29659;124;29783;NA;44720;284;2021-03-31;36183
2021-03-30;"Košický kraj";229;24038;163;24201;NA;44720;392;2021-03-30;35899
2021-03-29;"Košický kraj";78;28843;194;29037;NA;44720;272;2021-03-29;35507
2021-03-28;"Košický kraj";39;44263;128;44391;NA;44720;167;2021-03-28;35235
2021-03-27;"Košický kraj";222;96602;265;96867;NA;44720;487;2021-03-27;35068
2021-03-26;"Košický kraj";233;45252;202;45454;NA;44720;435;2021-03-26;34581
2021-03-25;"Košický kraj";133;23804;175;23979;NA;44720;308;2021-03-25;34146
2021-03-24;"Košický kraj";165;20677;155;20832;NA;44720;320;2021-03-24;33838
2021-03-23;"Košický kraj";202;22434;192;22626;NA;44720;394;2021-03-23;33518
2021-03-22;"Košický kraj";169;26890;228;27118;NA;44720;397;2021-03-22;33124
2021-03-21;"Košický kraj";109;46746;167;46913;NA;44720;276;2021-03-21;32727
2021-03-20;"Košický kraj";126;101334;311;101645;NA;44720;437;2021-03-20;32451
2021-03-19;"Košický kraj";205;45632;260;45892;NA;44720;465;2021-03-19;32014
2021-03-18;"Košický kraj";274;23823;212;24035;NA;44720;486;2021-03-18;31549
2021-03-17;"Košický kraj";177;21545;195;21740;NA;44720;372;2021-03-17;31063
2021-03-16;"Košický kraj";386;23431;226;23657;NA;44720;612;2021-03-16;30691
2021-03-15;"Košický kraj";173;27900;297;28197;NA;44720;470;2021-03-15;30079
2021-03-14;"Košický kraj";145;44354;220;44574;NA;44720;365;2021-03-14;29609
2021-03-13;"Košický kraj";146;103790;483;104273;NA;44720;629;2021-03-13;29244
2021-03-12;"Košický kraj";366;47871;321;48192;NA;44720;687;2021-03-12;28615
2021-03-11;"Košický kraj";396;23229;263;23492;NA;44720;659;2021-03-11;27928
2021-03-10;"Košický kraj";121;22191;269;22460;NA;44720;390;2021-03-10;27269
2021-03-09;"Košický kraj";676;24509;300;24809;NA;44720;976;2021-03-09;26879
2021-03-08;"Košický kraj";559;29836;344;30180;NA;44720;903;2021-03-08;25903
2021-03-07;"Košický kraj";45;44230;299;44529;NA;44720;344;2021-03-07;25000
2021-03-06;"Košický kraj";177;105598;532;106130;NA;44720;709;2021-03-06;24656
2021-03-05;"Košický kraj";439;45567;424;45991;NA;44720;863;2021-03-05;23947
2021-03-04;"Košický kraj";417;23862;320;24182;NA;44720;737;2021-03-04;23084
2021-03-03;"Košický kraj";390;23168;298;23466;NA;44720;688;2021-03-03;22347
2021-03-02;"Košický kraj";464;24150;368;24518;NA;44720;832;2021-03-02;21659
2021-03-01;"Košický kraj";389;30013;514;30527;NA;44720;903;2021-03-01;20827
2021-02-28;"Košický kraj";265;43053;334;43387;NA;44720;599;2021-02-28;19924
2021-02-27;"Košický kraj";301;100559;784;101343;NA;44720;1085;2021-02-27;19325
2021-02-26;"Košický kraj";440;45466;492;45958;NA;44720;932;2021-02-26;18240
2021-02-25;"Košický kraj";331;19872;342;20214;NA;44720;673;2021-02-25;17308
2021-02-24;"Košický kraj";263;18815;506;19321;NA;44720;769;2021-02-24;16635
2021-02-23;"Košický kraj";642;21592;341;21933;NA;44720;983;2021-02-23;15866
2021-02-22;"Košický kraj";362;30830;434;31264;NA;44720;796;2021-02-22;14883
2021-02-21;"Košický kraj";170;40464;385;40849;NA;44720;555;2021-02-21;14087
2021-02-20;"Košický kraj";283;92550;770;93320;NA;44720;1053;2021-02-20;13532
2021-02-19;"Košický kraj";507;42016;586;42602;NA;44720;1093;2021-02-19;12479
2021-02-18;"Košický kraj";397;18442;345;18787;NA;44720;742;2021-02-18;11386
2021-02-17;"Košický kraj";322;18080;387;18467;NA;44720;709;2021-02-17;10644
2021-02-16;"Košický kraj";600;22111;463;22574;NA;44720;1063;2021-02-16;9935
2021-02-15;"Košický kraj";216;27633;419;28052;NA;44720;635;2021-02-15;8872
2021-02-14;"Košický kraj";241;56743;524;57267;NA;44720;765;2021-02-14;8237
2021-02-13;"Košický kraj";206;93965;765;94730;NA;44720;971;2021-02-13;7472
2021-02-12;"Košický kraj";448;50184;611;50795;NA;44720;1059;2021-02-12;6501
2021-02-11;"Košický kraj";435;14524;323;14847;NA;44720;758;2021-02-11;5442
2021-02-10;"Košický kraj";360;18475;431;18906;NA;44720;791;2021-02-10;4684
2021-02-09;"Košický kraj";544;24841;463;25304;NA;44720;1007;2021-02-09;3893
2021-02-08;"Košický kraj";237;24836;392;25228;NA;44720;629;2021-02-08;2886
2021-02-07;"Košický kraj";208;56897;612;57509;NA;44720;820;2021-02-07;2257
2021-02-06;"Košický kraj";318;104357;884;105241;NA;44720;1202;2021-02-06;1437
2021-02-05;"Košický kraj";384;43186;494;43680;NA;44720;878;2021-02-05;235
2021-02-04;"Košický kraj";391;14508;371;14879;NA;44720;762;2021-02-04;-643
2021-02-03;"Košický kraj";296;12599;339;12938;NA;44720;635;2021-02-03;-1405
2021-02-02;"Košický kraj";473;43883;1212;45095;NA;44720;1685;2021-02-02;-2040
2021-02-01;"Košický kraj";415;21965;362;22327;NA;44720;777;2021-02-01;-3725
2021-01-31;"Košický kraj";142;54154;609;54763;NA;44720;751;2021-01-31;-4502
2021-01-30;"Košický kraj";320;76722;661;77383;NA;44720;981;2021-01-30;-5253
2021-01-29;"Košický kraj";311;37130;466;37596;NA;44720;777;2021-01-29;-6234
2021-01-28;"Košický kraj";540;9006;244;9250;NA;44720;784;2021-01-28;-7011
2021-01-27;"Košický kraj";265;7575;211;7786;NA;44720;476;2021-01-27;-7795
2021-01-26;"Košický kraj";530;14210;245;14455;NA;44720;775;2021-01-26;-8271
2021-01-25;"Košický kraj";226;26430;413;26843;NA;44720;639;2021-01-25;-9046
2021-01-24;"Košický kraj";150;44419;581;45000;NA;44720;731;2021-01-24;-9685
2021-01-23;"Košický kraj";232;82705;857;83562;NA;44720;1089;2021-01-23;-10416
2021-01-22;"Košický kraj";316;19997;265;20262;NA;44720;581;2021-01-22;-11505
2021-01-21;"Košický kraj";274;14047;158;14205;NA;44720;432;2021-01-21;-12086
2021-01-20;"Košický kraj";374;10843;201;11044;NA;44720;575;2021-01-20;-12518
2021-01-19;"Košický kraj";248;9717;181;9898;NA;44720;429;2021-01-19;-13093
2021-01-18;"Košický kraj";333;7659;262;7921;NA;44720;595;2021-01-18;-13522
2021-01-17;"Košický kraj";155;535;14;549;NA;44720;169;2021-01-17;-14117
2021-01-16;"Košický kraj";153;1403;47;1450;NA;44720;200;2021-01-16;-14286
2021-01-15;"Košický kraj";308;6443;213;6656;NA;44720;521;2021-01-15;-14486
2021-01-14;"Košický kraj";358;5471;221;5692;NA;44720;579;2021-01-14;-15007
2021-01-13;"Košický kraj";421;4897;226;5123;NA;44720;647;2021-01-13;-15586
2021-01-12;"Košický kraj";482;6689;258;6947;NA;44720;740;2021-01-12;-16233
2021-01-11;"Košický kraj";309;7945;304;8249;NA;44720;613;2021-01-11;-16973
2021-01-10;"Košický kraj";193;136;6;142;NA;44720;199;2021-01-10;-17586
2021-01-09;"Košický kraj";469;1134;45;1179;NA;44720;514;2021-01-09;-17785
2021-01-08;"Košický kraj";551;8222;388;8610;NA;44720;939;2021-01-08;-18299
2021-01-07;"Košický kraj";251;6566;434;7000;NA;44720;685;2021-01-07;-19238
2021-01-06;"Košický kraj";442;429;33;462;NA;44720;475;2021-01-06;-19923
2021-01-05;"Košický kraj";584;8100;560;8660;NA;44720;1144;2021-01-05;-20398
2021-01-04;"Košický kraj";407;7113;737;7850;NA;44720;1144;2021-01-04;-21542
2021-01-03;"Košický kraj";118;661;22;683;NA;44720;140;2021-01-03;-22686
2021-01-02;"Košický kraj";88;440;52;492;NA;44720;140;2021-01-02;-22826
2021-01-01;"Košický kraj";398;725;49;774;NA;44720;447;2021-01-01;-22966
2020-12-31;"Košický kraj";625;7877;461;8338;NA;44720;1086;2020-12-31;-23413
2020-12-30;"Košický kraj";590;6477;412;6889;NA;44720;1002;2020-12-30;-24499
2020-12-29;"Košický kraj";419;7573;605;8178;NA;44720;1024;2020-12-29;-25501
2020-12-28;"Košický kraj";356;8296;804;9100;NA;44720;1160;2020-12-28;-26525
2020-12-27;"Košický kraj";159;147;16;163;NA;44720;175;2020-12-27;-27685
2020-12-26;"Košický kraj";163;274;23;297;NA;44720;186;2020-12-26;-27860
2020-12-25;"Košický kraj";237;140;10;150;NA;44720;247;2020-12-25;-28046
2020-12-24;"Košický kraj";564;1470;90;1560;NA;44720;654;2020-12-24;-28293
2020-12-23;"Košický kraj";304;7942;354;8296;NA;44720;658;2020-12-23;-28947
2020-12-22;"Košický kraj";438;7920;459;8379;NA;44720;897;2020-12-22;-29605
2020-12-21;"Košický kraj";405;6984;509;7493;NA;44720;914;2020-12-21;-30502
2020-12-20;"Košický kraj";215;73;11;84;NA;44720;226;2020-12-20;-31416
2020-12-19;"Košický kraj";207;1309;63;1372;NA;44720;270;2020-12-19;-31642
2020-12-18;"Košický kraj";310;8484;326;8810;NA;44720;636;2020-12-18;-31912
2020-12-17;"Košický kraj";463;5292;255;5547;NA;44720;718;2020-12-17;-32548
2020-12-16;"Košický kraj";455;5898;316;6214;NA;44720;771;2020-12-16;-33266
2020-12-15;"Košický kraj";319;5086;338;5424;NA;44720;657;2020-12-15;-34037
2020-12-14;"Košický kraj";256;3401;264;3665;NA;44720;520;2020-12-14;-34694
2020-12-13;"Košický kraj";47;181;2;183;NA;44720;49;2020-12-13;-35214
2020-12-12;"Košický kraj";369;1587;118;1705;NA;44720;487;2020-12-12;-35263
2020-12-11;"Košický kraj";354;5461;258;5719;NA;44720;612;2020-12-11;-35750
2020-12-10;"Košický kraj";283;4064;176;4240;NA;44720;459;2020-12-10;-36362
2020-12-09;"Košický kraj";279;3786;166;3952;NA;44720;445;2020-12-09;-36821
2020-12-08;"Košický kraj";226;4105;355;4460;NA;44720;581;2020-12-08;-37266
2020-12-07;"Košický kraj";270;2383;106;2489;NA;44720;376;2020-12-07;-37847
2020-12-06;"Košický kraj";121;97;20;117;NA;44720;141;2020-12-06;-38223
2020-12-05;"Košický kraj";90;1096;48;1144;NA;44720;138;2020-12-05;-38364
2020-12-04;"Košický kraj";224;2680;82;2762;NA;44720;306;2020-12-04;-38502
2020-12-03;"Košický kraj";211;7717;173;7890;NA;44720;384;2020-12-03;-38808
2020-12-02;"Košický kraj";193;8132;496;8628;NA;44720;689;2020-12-02;-39192
2020-12-01;"Košický kraj";178;2237;124;2361;NA;44720;302;2020-12-01;-39881
2020-11-30;"Košický kraj";171;3754;62;3816;NA;44720;233;2020-11-30;-40183
2020-11-29;"Košický kraj";31;325;17;342;NA;44720;48;2020-11-29;-40416
2020-11-28;"Košický kraj";69;721;52;773;NA;44720;121;2020-11-28;-40464
2020-11-27;"Košický kraj";149;2921;78;2999;NA;44720;227;2020-11-27;-40585
2020-11-26;"Košický kraj";239;1234;60;1294;NA;44720;299;2020-11-26;-40812
2020-11-25;"Košický kraj";237;1785;123;1908;NA;44720;360;2020-11-25;-41111
2020-11-24;"Košický kraj";196;1976;67;2043;NA;44720;263;2020-11-24;-41471
2020-11-23;"Košický kraj";51;4115;63;4178;NA;44720;114;2020-11-23;-41734
2020-11-22;"Košický kraj";57;57;5;62;NA;44720;62;2020-11-22;-41848
2020-11-21;"Košický kraj";87;858;36;894;NA;44720;123;2020-11-21;-41910
2020-11-20;"Košický kraj";176;3084;49;3133;NA;44720;225;2020-11-20;-42033
2020-11-19;"Košický kraj";206;1736;48;1784;NA;44720;254;2020-11-19;-42258
2020-11-18;"Košický kraj";122;532;17;549;NA;44720;139;2020-11-18;-42512
2020-11-17;"Košický kraj";152;82;9;91;NA;44720;161;2020-11-17;-42651
2020-11-16;"Košický kraj";114;596;27;623;NA;44720;141;2020-11-16;-42812
2020-11-15;"Košický kraj";15;338;7;345;NA;44720;22;2020-11-15;-42953
2020-11-14;"Košický kraj";234;520;12;532;NA;44720;246;2020-11-14;-42975
2020-11-13;"Košický kraj";207;664;29;693;NA;44720;236;2020-11-13;-43221
2020-11-12;"Košický kraj";192;736;13;749;NA;44720;205;2020-11-12;-43457
2020-11-11;"Košický kraj";301;593;7;600;NA;44720;308;2020-11-11;-43662
2020-11-10;"Košický kraj";190;541;11;552;NA;44720;201;2020-11-10;-43970
2020-11-09;"Košický kraj";129;380;17;397;NA;44720;146;2020-11-09;-44171
2020-11-08;"Košický kraj";78;1306;8;1314;NA;44720;86;2020-11-08;-44317
2020-11-07;"Košický kraj";192;3909;22;3931;NA;44720;214;2020-11-07;-44403
2020-11-06;"Košický kraj";195;5310;34;5344;NA;44720;229;2020-11-06;-44617
2020-11-05;"Košický kraj";342;330;31;361;NA;44720;373;2020-11-05;-44846
2020-11-04;"Košický kraj";101;154;6;160;NA;44720;107;2020-11-04;-45219
2020-11-03;"Košický kraj";358;1122;13;1135;NA;44720;371;2020-11-03;-45326
2020-11-02;"Košický kraj";111;6125;56;6181;NA;44720;167;2020-11-02;-45697
2020-11-01;"Košický kraj";346;6522;34;6556;NA;44720;380;2020-11-01;-45864
2020-10-31;"Košický kraj";82;14035;106;14141;NA;44720;188;2020-10-31;-46244
2020-10-30;"Košický kraj";379;2835;27;2862;NA;44720;406;2020-10-30;-46432
2020-10-29;"Košický kraj";333;983;13;996;NA;44720;346;2020-10-29;-46838
2020-10-28;"Košický kraj";224;305;13;318;NA;44720;237;2020-10-28;-47184
2020-10-27;"Košický kraj";386;439;21;460;NA;44720;407;2020-10-27;-47421
2020-10-26;"Košický kraj";56;212;12;224;NA;44720;68;2020-10-26;-47828
2020-10-25;"Košický kraj";154;79;2;81;NA;44720;156;2020-10-25;-47896
2020-10-24;"Košický kraj";313;118;16;134;NA;44720;329;2020-10-24;-48052
2020-10-23;"Košický kraj";315;331;8;339;NA;44720;323;2020-10-23;-48381
2020-10-22;"Košický kraj";349;530;16;546;NA;44720;365;2020-10-22;-48704
2020-10-21;"Košický kraj";129;84;2;86;NA;44720;131;2020-10-21;-49069
2020-10-20;"Košický kraj";181;14;1;15;NA;44720;182;2020-10-20;-49200
2020-10-19;"Košický kraj";64;38;1;39;NA;44720;65;2020-10-19;-49382
2020-10-18;"Košický kraj";158;0;0;0;NA;44720;158;2020-10-18;-49447
2020-10-17;"Košický kraj";142;0;0;0;NA;44720;142;2020-10-17;-49605
2020-10-16;"Košický kraj";206;19;0;19;NA;44720;206;2020-10-16;-49747
2020-10-15;"Košický kraj";177;19;5;24;NA;44720;182;2020-10-15;-49953
2020-10-14;"Košický kraj";211;8;0;8;NA;44720;211;2020-10-14;-50135
2020-10-13;"Košický kraj";179;80;3;83;NA;44720;182;2020-10-13;-50346
2020-10-12;"Košický kraj";74;0;0;0;NA;44720;74;2020-10-12;-50528
2020-10-11;"Košický kraj";121;0;0;0;NA;44720;121;2020-10-11;-50602
2020-10-10;"Košický kraj";70;0;0;0;NA;44720;70;2020-10-10;-50723
2020-10-09;"Košický kraj";188;0;0;0;NA;44720;188;2020-10-09;-50793
2020-10-08;"Košický kraj";102;0;0;0;NA;44720;102;2020-10-08;-50981
2020-10-07;"Košický kraj";158;0;0;0;NA;44720;158;2020-10-07;-51083
2020-10-06;"Košický kraj";70;0;0;0;NA;44720;70;2020-10-06;-51241
2020-10-05;"Košický kraj";39;0;0;0;NA;44720;39;2020-10-05;-51311
2020-10-04;"Košický kraj";45;0;0;0;NA;44720;45;2020-10-04;-51350
2020-10-03;"Košický kraj";105;0;0;0;NA;44720;105;2020-10-03;-51395
2020-10-02;"Košický kraj";57;0;0;0;NA;44720;57;2020-10-02;-51500
2020-10-01;"Košický kraj";69;0;0;0;NA;44720;69;2020-10-01;-51557
2020-09-30;"Košický kraj";95;0;0;0;NA;44720;95;2020-09-30;-51626
2020-09-29;"Košický kraj";75;0;0;0;NA;44720;75;2020-09-29;-51721
2020-09-28;"Košický kraj";19;0;0;0;NA;44720;19;2020-09-28;-51796
2020-09-27;"Košický kraj";21;0;0;0;NA;44720;21;2020-09-27;-51815
2020-09-26;"Košický kraj";53;0;0;0;NA;44720;53;2020-09-26;-51836
2020-09-25;"Košický kraj";72;0;0;0;NA;44720;72;2020-09-25;-51889
2020-09-24;"Košický kraj";35;0;0;0;NA;44720;35;2020-09-24;-51961
2020-09-23;"Košický kraj";23;0;0;0;NA;44720;23;2020-09-23;-51996
2020-09-22;"Košický kraj";39;0;0;0;NA;44720;39;2020-09-22;-52019
2020-09-21;"Košický kraj";5;0;0;0;NA;44720;5;2020-09-21;-52058
2020-09-20;"Košický kraj";3;0;0;0;NA;44720;3;2020-09-20;-52063
2020-09-19;"Košický kraj";13;0;0;0;NA;44720;13;2020-09-19;-52066
2020-09-18;"Košický kraj";20;0;0;0;NA;44720;20;2020-09-18;-52079
2020-09-17;"Košický kraj";22;0;0;0;NA;44720;22;2020-09-17;-52099
2020-09-16;"Košický kraj";12;0;0;0;NA;44720;12;2020-09-16;-52121
2020-09-15;"Košický kraj";10;0;0;0;NA;44720;10;2020-09-15;-52133
2020-09-14;"Košický kraj";6;0;0;0;NA;44720;6;2020-09-14;-52143
2020-09-13;"Košický kraj";3;0;0;0;NA;44720;3;2020-09-13;-52149
2020-09-12;"Košický kraj";16;0;0;0;NA;44720;16;2020-09-12;-52152
2020-09-11;"Košický kraj";20;0;0;0;NA;44720;20;2020-09-11;-52168
2020-09-10;"Košický kraj";11;0;0;0;NA;44720;11;2020-09-10;-52188
2020-09-09;"Košický kraj";37;0;0;0;NA;44720;37;2020-09-09;-52199
2020-09-08;"Košický kraj";10;0;0;0;NA;44720;10;2020-09-08;-52236
2020-09-07;"Košický kraj";4;0;0;0;NA;44720;4;2020-09-07;-52246
2020-09-06;"Košický kraj";2;0;0;0;NA;44720;2;2020-09-06;-52250
2020-09-05;"Košický kraj";10;0;0;0;NA;44720;10;2020-09-05;-52252
2020-09-04;"Košický kraj";14;0;0;0;NA;44720;14;2020-09-04;-52262
2020-09-03;"Košický kraj";22;0;0;0;NA;44720;22;2020-09-03;-52276
2020-09-02;"Košický kraj";13;0;0;0;NA;44720;13;2020-09-02;-52298
2020-09-01;"Košický kraj";21;0;0;0;NA;44720;21;2020-09-01;-52311
2020-08-31;"Košický kraj";9;0;0;0;NA;44720;9;2020-08-31;-52332
2020-08-30;"Košický kraj";21;0;0;0;NA;44720;21;2020-08-30;-52341
2020-08-29;"Košický kraj";1;0;0;0;NA;44720;1;2020-08-29;-52362
2020-08-28;"Košický kraj";19;0;0;0;NA;44720;19;2020-08-28;-52363
2020-08-27;"Košický kraj";15;0;0;0;NA;44720;15;2020-08-27;-52382
2020-08-26;"Košický kraj";8;0;0;0;NA;44720;8;2020-08-26;-52397
2020-08-25;"Košický kraj";23;0;0;0;NA;44720;23;2020-08-25;-52405
2020-08-24;"Košický kraj";6;0;0;0;NA;44720;6;2020-08-24;-52428
2020-08-23;"Košický kraj";8;0;0;0;NA;44720;8;2020-08-23;-52434
2020-08-22;"Košický kraj";13;0;0;0;NA;44720;13;2020-08-22;-52442
2020-08-21;"Košický kraj";10;0;0;0;NA;44720;10;2020-08-21;-52455
2020-08-20;"Košický kraj";10;0;0;0;NA;44720;10;2020-08-20;-52465
2020-08-19;"Košický kraj";3;0;0;0;NA;44720;3;2020-08-19;-52475
2020-08-18;"Košický kraj";7;0;0;0;NA;44720;7;2020-08-18;-52478
2020-08-17;"Košický kraj";2;0;0;0;NA;44720;2;2020-08-17;-52485
2020-08-16;"Košický kraj";2;0;0;0;NA;44720;2;2020-08-16;-52487
2020-08-15;"Košický kraj";3;0;0;0;NA;44720;3;2020-08-15;-52489
2020-08-14;"Košický kraj";1;0;0;0;NA;44720;1;2020-08-14;-52492
2020-08-13;"Košický kraj";3;0;0;0;NA;44720;3;2020-08-13;-52493
2020-08-12;"Košický kraj";12;0;0;0;NA;44720;12;2020-08-12;-52496
2020-08-11;"Košický kraj";5;0;0;0;NA;44720;5;2020-08-11;-52508
2020-08-10;"Košický kraj";1;0;0;0;NA;44720;1;2020-08-10;-52513
2020-08-09;"Košický kraj";0;0;0;0;NA;44720;0;2020-08-09;-52514
2020-08-08;"Košický kraj";5;0;0;0;NA;44720;5;2020-08-08;-52514
2020-08-07;"Košický kraj";7;0;0;0;NA;44720;7;2020-08-07;-52519
2020-08-06;"Košický kraj";3;0;0;0;NA;44720;3;2020-08-06;-52526
2020-08-05;"Košický kraj";4;0;0;0;NA;44720;4;2020-08-05;-52529
2020-08-04;"Košický kraj";1;0;0;0;NA;44720;1;2020-08-04;-52533
2020-08-03;"Košický kraj";1;0;0;0;NA;44720;1;2020-08-03;-52534
2020-08-02;"Košický kraj";0;0;0;0;NA;44720;0;2020-08-02;-52535
2020-08-01;"Košický kraj";0;0;0;0;NA;44720;0;2020-08-01;-52535
2020-07-31;"Košický kraj";0;0;0;0;NA;44720;0;2020-07-31;-52535
2020-07-30;"Košický kraj";2;0;0;0;NA;44720;2;2020-07-30;-52535
2020-07-29;"Košický kraj";1;0;0;0;NA;44720;1;2020-07-29;-52537
2020-07-28;"Košický kraj";9;0;0;0;NA;44720;9;2020-07-28;-52538
2020-07-27;"Košický kraj";4;0;0;0;NA;44720;4;2020-07-27;-52547
2020-07-26;"Košický kraj";0;0;0;0;NA;44720;0;2020-07-26;-52551
2020-07-25;"Košický kraj";2;0;0;0;NA;44720;2;2020-07-25;-52551
2020-07-24;"Košický kraj";2;0;0;0;NA;44720;2;2020-07-24;-52553
2020-07-23;"Košický kraj";1;0;0;0;NA;44720;1;2020-07-23;-52555
2020-07-22;"Košický kraj";1;0;0;0;NA;44720;1;2020-07-22;-52556
2020-07-21;"Košický kraj";0;0;0;0;NA;44720;0;2020-07-21;-52557
2020-07-20;"Košický kraj";0;0;0;0;NA;44720;0;2020-07-20;-52557
2020-07-19;"Košický kraj";0;0;0;0;NA;44720;0;2020-07-19;-52557
2020-07-18;"Košický kraj";1;0;0;0;NA;44720;1;2020-07-18;-52557
2020-07-17;"Košický kraj";1;0;0;0;NA;44720;1;2020-07-17;-52558
2020-07-16;"Košický kraj";0;0;0;0;NA;44720;0;2020-07-16;-52559
2020-07-15;"Košický kraj";2;0;0;0;NA;44720;2;2020-07-15;-52559
2020-07-14;"Košický kraj";1;0;0;0;NA;44720;1;2020-07-14;-52561
2020-07-13;"Košický kraj";1;0;0;0;NA;44720;1;2020-07-13;-52562
2020-07-12;"Košický kraj";0;0;0;0;NA;44720;0;2020-07-12;-52563
2020-07-11;"Košický kraj";0;0;0;0;NA;44720;0;2020-07-11;-52563
2020-07-10;"Košický kraj";1;0;0;0;NA;44720;1;2020-07-10;-52563
2020-07-09;"Košický kraj";1;0;0;0;NA;44720;1;2020-07-09;-52564
2020-07-08;"Košický kraj";12;0;0;0;NA;44720;12;2020-07-08;-52565
2020-07-07;"Košický kraj";0;0;0;0;NA;44720;0;2020-07-07;-52577
2020-07-06;"Košický kraj";0;0;0;0;NA;44720;0;2020-07-06;-52577
2020-07-05;"Košický kraj";0;0;0;0;NA;44720;0;2020-07-05;-52577
2020-07-04;"Košický kraj";0;0;0;0;NA;44720;0;2020-07-04;-52577
2020-07-03;"Košický kraj";1;0;0;0;NA;44720;1;2020-07-03;-52577
2020-07-02;"Košický kraj";0;0;0;0;NA;44720;0;2020-07-02;-52578
2020-07-01;"Košický kraj";1;0;0;0;NA;44720;1;2020-07-01;-52578
2020-06-30;"Košický kraj";0;0;0;0;NA;44720;0;2020-06-30;-52579
2020-06-29;"Košický kraj";0;0;0;0;NA;44720;0;2020-06-29;-52579
2020-06-28;"Košický kraj";0;0;0;0;NA;44720;0;2020-06-28;-52579
2020-06-27;"Košický kraj";0;0;0;0;NA;44720;0;2020-06-27;-52579
2020-06-26;"Košický kraj";0;0;0;0;NA;44720;0;2020-06-26;-52579
2020-06-25;"Košický kraj";3;0;0;0;NA;44720;3;2020-06-25;-52579
2020-06-24;"Košický kraj";3;0;0;0;NA;44720;3;2020-06-24;-52582
2020-06-23;"Košický kraj";3;0;0;0;NA;44720;3;2020-06-23;-52585
2020-06-22;"Košický kraj";0;0;0;0;NA;44720;0;2020-06-22;-52588
2020-06-21;"Košický kraj";0;0;0;0;NA;44720;0;2020-06-21;-52588
2020-06-20;"Košický kraj";0;0;0;0;NA;44720;0;2020-06-20;-52588
2020-06-19;"Košický kraj";0;0;0;0;NA;44720;0;2020-06-19;-52588
2020-06-18;"Košický kraj";1;0;0;0;NA;44720;1;2020-06-18;-52588
2020-06-17;"Košický kraj";0;0;0;0;NA;44720;0;2020-06-17;-52589
2020-06-16;"Košický kraj";2;0;0;0;NA;44720;2;2020-06-16;-52589
2020-06-14;"Košický kraj";0;0;0;0;NA;44720;0;2020-06-14;-52591
2020-06-13;"Košický kraj";0;0;0;0;NA;44720;0;2020-06-13;-52591
2020-06-12;"Košický kraj";0;0;0;0;NA;44720;0;2020-06-12;-52591
2020-06-11;"Košický kraj";0;0;0;0;NA;44720;0;2020-06-11;-52591
2020-06-10;"Košický kraj";6;0;0;0;NA;44720;6;2020-06-10;-52591
2020-06-09;"Košický kraj";0;0;0;0;NA;44720;0;2020-06-09;-52597
2020-06-08;"Košický kraj";0;0;0;0;NA;44720;0;2020-06-08;-52597
2020-06-07;"Košický kraj";2;0;0;0;NA;44720;2;2020-06-07;-52597
2020-06-05;"Košický kraj";0;0;0;0;NA;44720;0;2020-06-05;-52599
2020-06-03;"Košický kraj";0;0;0;0;NA;44720;0;2020-06-03;-52599
2020-06-02;"Košický kraj";1;0;0;0;NA;44720;1;2020-06-02;-52599
2020-05-31;"Košický kraj";0;0;0;0;NA;44720;0;2020-05-31;-52600
2020-05-29;"Košický kraj";1;0;0;0;NA;44720;1;2020-05-29;-52600
2020-05-27;"Košický kraj";0;0;0;0;NA;44720;0;2020-05-27;-52601
2020-05-26;"Košický kraj";1;0;0;0;NA;44720;1;2020-05-26;-52601
2020-05-25;"Košický kraj";1;0;0;0;NA;44720;1;2020-05-25;-52602
2020-05-24;"Košický kraj";0;0;0;0;NA;44720;0;2020-05-24;-52603
2020-05-23;"Košický kraj";0;0;0;0;NA;44720;0;2020-05-23;-52603
2020-05-22;"Košický kraj";0;0;0;0;NA;44720;0;2020-05-22;-52603
2020-05-21;"Košický kraj";0;0;0;0;NA;44720;0;2020-05-21;-52603
2020-05-20;"Košický kraj";3;0;0;0;NA;44720;3;2020-05-20;-52603
2020-05-19;"Košický kraj";0;0;0;0;NA;44720;0;2020-05-19;-52606
2020-05-17;"Košický kraj";1;0;0;0;NA;44720;1;2020-05-17;-52606
2020-05-16;"Košický kraj";1;0;0;0;NA;44720;1;2020-05-16;-52607
2020-05-15;"Košický kraj";10;0;0;0;NA;44720;10;2020-05-15;-52608
2020-05-14;"Košický kraj";1;0;0;0;NA;44720;1;2020-05-14;-52618
2020-05-13;"Košický kraj";6;0;0;0;NA;44720;6;2020-05-13;-52619
2020-05-12;"Košický kraj";0;0;0;0;NA;44720;0;2020-05-12;-52625
2020-05-11;"Košický kraj";0;0;0;0;NA;44720;0;2020-05-11;-52625
2020-05-09;"Košický kraj";0;0;0;0;NA;44720;0;2020-05-09;-52625
2020-05-07;"Košický kraj";0;0;0;0;NA;44720;0;2020-05-07;-52625
2020-05-06;"Košický kraj";1;0;0;0;NA;44720;1;2020-05-06;-52625
2020-05-05;"Košický kraj";0;0;0;0;NA;44720;0;2020-05-05;-52626
2020-05-04;"Košický kraj";0;0;0;0;NA;44720;0;2020-05-04;-52626
2020-05-03;"Košický kraj";0;0;0;0;NA;44720;0;2020-05-03;-52626
2020-05-02;"Košický kraj";1;0;0;0;NA;44720;1;2020-05-02;-52626
2020-05-01;"Košický kraj";0;0;0;0;NA;44720;0;2020-05-01;-52627
2020-04-30;"Košický kraj";1;0;0;0;NA;44720;1;2020-04-30;-52627
2020-04-29;"Košický kraj";1;0;0;0;NA;44720;1;2020-04-29;-52628
2020-04-28;"Košický kraj";1;0;0;0;NA;44720;1;2020-04-28;-52629
2020-04-27;"Košický kraj";1;0;0;0;NA;44720;1;2020-04-27;-52630
2020-04-26;"Košický kraj";0;0;0;0;NA;44720;0;2020-04-26;-52631
2020-04-25;"Košický kraj";0;0;0;0;NA;44720;0;2020-04-25;-52631
2020-04-24;"Košický kraj";3;0;0;0;NA;44720;3;2020-04-24;-52631
2020-04-23;"Košický kraj";4;0;0;0;NA;44720;4;2020-04-23;-52634
2020-04-22;"Košický kraj";21;0;0;0;NA;44720;21;2020-04-22;-52638
2020-04-21;"Košický kraj";4;0;0;0;NA;44720;4;2020-04-21;-52659
2020-04-20;"Košický kraj";0;0;0;0;NA;44720;0;2020-04-20;-52663
2020-04-19;"Košický kraj";1;0;0;0;NA;44720;1;2020-04-19;-52663
2020-04-18;"Košický kraj";2;0;0;0;NA;44720;2;2020-04-18;-52664
2020-04-17;"Košický kraj";7;0;0;0;NA;44720;7;2020-04-17;-52666
2020-04-16;"Košický kraj";29;0;0;0;NA;44720;29;2020-04-16;-52673
2020-04-15;"Košický kraj";50;0;0;0;NA;44720;50;2020-04-15;-52702
2020-04-14;"Košický kraj";4;0;0;0;NA;44720;4;2020-04-14;-52752
2020-04-13;"Košický kraj";5;0;0;0;NA;44720;5;2020-04-13;-52756
2020-04-12;"Košický kraj";4;0;0;0;NA;44720;4;2020-04-12;-52761
2020-04-11;"Košický kraj";2;0;0;0;NA;44720;2;2020-04-11;-52765
2020-04-10;"Košický kraj";1;0;0;0;NA;44720;1;2020-04-10;-52767
2020-04-09;"Košický kraj";4;0;0;0;NA;44720;4;2020-04-09;-52768
2020-04-08;"Košický kraj";5;0;0;0;NA;44720;5;2020-04-08;-52772
2020-04-07;"Košický kraj";34;0;0;0;NA;44720;34;2020-04-07;-52777
2020-04-06;"Košický kraj";6;0;0;0;NA;44720;6;2020-04-06;-52811
2020-04-05;"Košický kraj";4;0;0;0;NA;44720;4;2020-04-05;-52817
2020-04-04;"Košický kraj";5;0;0;0;NA;44720;5;2020-04-04;-52821
2020-04-03;"Košický kraj";4;0;0;0;NA;44720;4;2020-04-03;-52826
2020-04-02;"Košický kraj";3;0;0;0;NA;44720;3;2020-04-02;-52830
2020-04-01;"Košický kraj";3;0;0;0;NA;44720;3;2020-04-01;-52833
2020-03-31;"Košický kraj";1;0;0;0;NA;44720;1;2020-03-31;-52836
2020-03-30;"Košický kraj";5;0;0;0;NA;44720;5;2020-03-30;-52837
2020-03-29;"Košický kraj";0;0;0;0;NA;44720;0;2020-03-29;-52842
2020-03-28;"Košický kraj";1;0;0;0;NA;44720;1;2020-03-28;-52842
2020-03-27;"Košický kraj";1;0;0;0;NA;44720;1;2020-03-27;-52843
2020-03-26;"Košický kraj";3;0;0;0;NA;44720;3;2020-03-26;-52844
2020-03-25;"Košický kraj";2;0;0;0;NA;44720;2;2020-03-25;-52847
2020-03-24;"Košický kraj";0;0;0;0;NA;44720;0;2020-03-24;-52849
2020-03-23;"Košický kraj";2;0;0;0;NA;44720;2;2020-03-23;-52849
2020-03-22;"Košický kraj";0;0;0;0;NA;44720;0;2020-03-22;-52851
2020-03-21;"Košický kraj";3;0;0;0;NA;44720;3;2020-03-21;-52851
2020-03-20;"Košický kraj";1;0;0;0;NA;44720;1;2020-03-20;-52854
2020-03-19;"Košický kraj";0;0;0;0;NA;44720;0;2020-03-19;-52855
2020-03-18;"Košický kraj";0;0;0;0;NA;44720;0;2020-03-18;-52855
2020-03-17;"Košický kraj";0;0;0;0;NA;44720;0;2020-03-17;-52855
2020-03-16;"Košický kraj";3;0;0;0;NA;44720;3;2020-03-16;-52855
2020-03-15;"Košický kraj";1;0;0;0;NA;44720;1;2020-03-15;-52858
2020-03-14;"Košický kraj";0;0;0;0;NA;44720;0;2020-03-14;-52859
2020-03-13;"Košický kraj";2;0;0;0;NA;44720;2;2020-03-13;-52859
2020-03-12;"Košický kraj";0;0;0;0;NA;44720;0;2020-03-12;-52861
2020-03-11;"Košický kraj";0;0;0;0;NA;44720;0;2020-03-11;-52861
2020-03-09;"Košický kraj";1;0;0;0;NA;44720;1;2020-03-09;-52861
2020-03-08;"Košický kraj";0;0;0;0;NA;44720;0;2020-03-08;-52862
2020-03-07;"Košický kraj";0;0;0;0;NA;44720;0;2020-03-07;-52862
2020-03-06;"Košický kraj";0;0;0;0;NA;44720;0;2020-03-06;-52862
2021-06-22;"Nitriansky kraj";1;2449;4;2453;0;53399;5;2021-06-22;53399
2021-06-21;"Nitriansky kraj";8;4726;5;4731;NA;53399;13;2021-06-21;53394
2021-06-20;"Nitriansky kraj";0;4522;6;4528;NA;53399;6;2021-06-20;53381
2021-06-19;"Nitriansky kraj";0;5478;4;5482;NA;53399;4;2021-06-19;53375
2021-06-18;"Nitriansky kraj";4;6453;3;6456;NA;53399;7;2021-06-18;53371
2021-06-17;"Nitriansky kraj";5;4030;1;4031;NA;53399;6;2021-06-17;53364
2021-06-16;"Nitriansky kraj";4;3694;3;3697;NA;53399;7;2021-06-16;53358
2021-06-15;"Nitriansky kraj";1;3849;0;3849;NA;53399;1;2021-06-15;53351
2021-06-14;"Nitriansky kraj";0;5590;3;5593;NA;53399;3;2021-06-14;53350
2021-06-13;"Nitriansky kraj";0;6184;3;6187;NA;53399;3;2021-06-13;53347
2021-06-12;"Nitriansky kraj";1;7723;1;7724;NA;53399;2;2021-06-12;53344
2021-06-11;"Nitriansky kraj";3;6558;4;6562;NA;53399;7;2021-06-11;53342
2021-06-10;"Nitriansky kraj";7;4539;1;4540;NA;53399;8;2021-06-10;53335
2021-06-09;"Nitriansky kraj";2;4656;5;4661;NA;53399;7;2021-06-09;53327
2021-06-08;"Nitriansky kraj";8;4239;3;4242;NA;53399;11;2021-06-08;53320
2021-06-07;"Nitriansky kraj";6;5648;8;5656;NA;53399;14;2021-06-07;53309
2021-06-06;"Nitriansky kraj";0;6981;4;6985;NA;53399;4;2021-06-06;53295
2021-06-05;"Nitriansky kraj";6;8417;9;8426;NA;53399;15;2021-06-05;53291
2021-06-04;"Nitriansky kraj";9;7462;5;7467;NA;53399;14;2021-06-04;53276
2021-06-03;"Nitriansky kraj";2;5062;6;5068;NA;53399;8;2021-06-03;53262
2021-06-02;"Nitriansky kraj";11;4902;11;4913;NA;53399;22;2021-06-02;53254
2021-06-01;"Nitriansky kraj";3;4698;2;4700;NA;53399;5;2021-06-01;53232
2021-05-31;"Nitriansky kraj";8;8708;8;8716;NA;53399;16;2021-05-31;53227
2021-05-30;"Nitriansky kraj";1;9067;8;9075;NA;53399;9;2021-05-30;53211
2021-05-29;"Nitriansky kraj";2;12799;7;12806;NA;53399;9;2021-05-29;53202
2021-05-28;"Nitriansky kraj";10;8575;6;8581;NA;53399;16;2021-05-28;53193
2021-05-27;"Nitriansky kraj";4;6015;5;6020;NA;53399;9;2021-05-27;53177
2021-05-26;"Nitriansky kraj";11;8266;8;8274;NA;53399;19;2021-05-26;53168
2021-05-25;"Nitriansky kraj";15;7437;9;7446;NA;53399;24;2021-05-25;53149
2021-05-24;"Nitriansky kraj";14;9390;16;9406;NA;53399;30;2021-05-24;53125
2021-05-23;"Nitriansky kraj";1;9516;13;9529;NA;53399;14;2021-05-23;53095
2021-05-22;"Nitriansky kraj";7;16714;11;16725;NA;53399;18;2021-05-22;53081
2021-05-21;"Nitriansky kraj";18;10473;15;10488;NA;53399;33;2021-05-21;53063
2021-05-20;"Nitriansky kraj";8;7059;7;7066;NA;53399;15;2021-05-20;53030
2021-05-19;"Nitriansky kraj";20;6640;14;6654;NA;53399;34;2021-05-19;53015
2021-05-18;"Nitriansky kraj";23;7577;18;7595;NA;53399;41;2021-05-18;52981
2021-05-17;"Nitriansky kraj";22;9575;20;9595;NA;53399;42;2021-05-17;52940
2021-05-16;"Nitriansky kraj";4;13830;15;13845;NA;53399;19;2021-05-16;52898
2021-05-15;"Nitriansky kraj";5;25389;23;25412;NA;53399;28;2021-05-15;52879
2021-05-14;"Nitriansky kraj";18;13273;23;13296;NA;53399;41;2021-05-14;52851
2021-05-13;"Nitriansky kraj";24;8049;19;8068;NA;53399;43;2021-05-13;52810
2021-05-12;"Nitriansky kraj";10;7466;26;7492;NA;53399;36;2021-05-12;52767
2021-05-11;"Nitriansky kraj";36;7978;13;7991;NA;53399;49;2021-05-11;52731
2021-05-10;"Nitriansky kraj";16;13590;33;13623;NA;53399;49;2021-05-10;52682
2021-05-09;"Nitriansky kraj";8;21879;35;21914;NA;53399;43;2021-05-09;52633
2021-05-08;"Nitriansky kraj";0;24318;29;24347;NA;53399;29;2021-05-08;52590
2021-05-07;"Nitriansky kraj";32;14657;20;14677;NA;53399;52;2021-05-07;52561
2021-05-06;"Nitriansky kraj";30;9275;20;9295;NA;53399;50;2021-05-06;52509
2021-05-05;"Nitriansky kraj";19;8518;23;8541;NA;53399;42;2021-05-05;52459
2021-05-04;"Nitriansky kraj";46;8954;27;8981;NA;53399;73;2021-05-04;52417
2021-05-03;"Nitriansky kraj";32;14490;44;14534;NA;53399;76;2021-05-03;52344
2021-05-02;"Nitriansky kraj";4;31751;46;31797;NA;53399;50;2021-05-02;52268
2021-05-01;"Nitriansky kraj";23;60318;43;60361;NA;53399;66;2021-05-01;52218
2021-04-30;"Nitriansky kraj";28;31803;53;31856;NA;53399;81;2021-04-30;52152
2021-04-29;"Nitriansky kraj";27;13995;32;14027;NA;53399;59;2021-04-29;52071
2021-04-28;"Nitriansky kraj";36;14678;45;14723;NA;53399;81;2021-04-28;52012
2021-04-27;"Nitriansky kraj";51;13154;35;13189;NA;53399;86;2021-04-27;51931
2021-04-26;"Nitriansky kraj";38;21029;44;21073;NA;53399;82;2021-04-26;51845
2021-04-25;"Nitriansky kraj";7;43494;43;43537;NA;53399;50;2021-04-25;51763
2021-04-24;"Nitriansky kraj";23;92745;71;92816;NA;53399;94;2021-04-24;51713
2021-04-23;"Nitriansky kraj";54;35143;51;35194;NA;53399;105;2021-04-23;51619
2021-04-22;"Nitriansky kraj";32;15435;44;15479;NA;53399;76;2021-04-22;51514
2021-04-21;"Nitriansky kraj";38;14222;45;14267;NA;53399;83;2021-04-21;51438
2021-04-20;"Nitriansky kraj";67;16058;51;16109;NA;53399;118;2021-04-20;51355
2021-04-19;"Nitriansky kraj";35;24816;59;24875;NA;53399;94;2021-04-19;51237
2021-04-18;"Nitriansky kraj";0;39569;27;39596;NA;53399;27;2021-04-18;51143
2021-04-17;"Nitriansky kraj";34;92102;82;92184;NA;53399;116;2021-04-17;51116
2021-04-16;"Nitriansky kraj";46;32348;37;32385;NA;53399;83;2021-04-16;51000
2021-04-15;"Nitriansky kraj";75;16215;52;16267;NA;53399;127;2021-04-15;50917
2021-04-14;"Nitriansky kraj";43;15303;42;15345;NA;53399;85;2021-04-14;50790
2021-04-13;"Nitriansky kraj";110;14947;44;14991;NA;53399;154;2021-04-13;50705
2021-04-12;"Nitriansky kraj";29;22162;50;22212;NA;53399;79;2021-04-12;50551
2021-04-11;"Nitriansky kraj";1;37537;31;37568;NA;53399;32;2021-04-11;50472
2021-04-10;"Nitriansky kraj";35;95524;115;95639;NA;53399;150;2021-04-10;50440
2021-04-09;"Nitriansky kraj";69;30669;58;30727;NA;53399;127;2021-04-09;50290
2021-04-08;"Nitriansky kraj";71;15369;36;15405;NA;53399;107;2021-04-08;50163
2021-04-07;"Nitriansky kraj";64;18541;47;18588;NA;53399;111;2021-04-07;50056
2021-04-06;"Nitriansky kraj";65;33218;112;33330;NA;53399;177;2021-04-06;49945
2021-04-05;"Nitriansky kraj";37;12673;48;12721;NA;53399;85;2021-04-05;49768
2021-04-04;"Nitriansky kraj";5;17887;35;17922;NA;53399;40;2021-04-04;49683
2021-04-03;"Nitriansky kraj";26;85465;153;85618;NA;53399;179;2021-04-03;49643
2021-04-02;"Nitriansky kraj";32;18667;46;18713;NA;53399;78;2021-04-02;49464
2021-04-01;"Nitriansky kraj";63;24610;83;24693;NA;53399;146;2021-04-01;49386
2021-03-31;"Nitriansky kraj";73;21752;94;21846;NA;53399;167;2021-03-31;49240
2021-03-30;"Nitriansky kraj";125;17044;83;17127;NA;53399;208;2021-03-30;49073
2021-03-29;"Nitriansky kraj";81;25139;100;25239;NA;53399;181;2021-03-29;48865
2021-03-28;"Nitriansky kraj";6;45581;106;45687;NA;53399;112;2021-03-28;48684
2021-03-27;"Nitriansky kraj";39;103659;174;103833;NA;53399;213;2021-03-27;48572
2021-03-26;"Nitriansky kraj";90;40444;115;40559;NA;53399;205;2021-03-26;48359
2021-03-25;"Nitriansky kraj";95;19149;94;19243;NA;53399;189;2021-03-25;48154
2021-03-24;"Nitriansky kraj";90;14784;91;14875;NA;53399;181;2021-03-24;47965
2021-03-23;"Nitriansky kraj";167;16753;66;16819;NA;53399;233;2021-03-23;47784
2021-03-22;"Nitriansky kraj";101;23699;124;23823;NA;53399;225;2021-03-22;47551
2021-03-21;"Nitriansky kraj";27;42318;99;42417;NA;53399;126;2021-03-21;47326
2021-03-20;"Nitriansky kraj";36;99816;207;100023;NA;53399;243;2021-03-20;47200
2021-03-19;"Nitriansky kraj";76;37115;101;37216;NA;53399;177;2021-03-19;46957
2021-03-18;"Nitriansky kraj";103;20051;113;20164;NA;53399;216;2021-03-18;46780
2021-03-17;"Nitriansky kraj";87;15832;127;15959;NA;53399;214;2021-03-17;46564
2021-03-16;"Nitriansky kraj";172;18085;121;18206;NA;53399;293;2021-03-16;46350
2021-03-15;"Nitriansky kraj";130;24491;165;24656;NA;53399;295;2021-03-15;46057
2021-03-14;"Nitriansky kraj";3;45758;107;45865;NA;53399;110;2021-03-14;45762
2021-03-13;"Nitriansky kraj";65;112081;241;112322;NA;53399;306;2021-03-13;45652
2021-03-12;"Nitriansky kraj";127;40776;159;40935;NA;53399;286;2021-03-12;45346
2021-03-11;"Nitriansky kraj";131;18685;130;18815;NA;53399;261;2021-03-11;45060
2021-03-10;"Nitriansky kraj";96;17422;143;17565;NA;53399;239;2021-03-10;44799
2021-03-09;"Nitriansky kraj";260;17645;149;17794;NA;53399;409;2021-03-09;44560
2021-03-08;"Nitriansky kraj";145;27214;172;27386;NA;53399;317;2021-03-08;44151
2021-03-07;"Nitriansky kraj";48;46867;185;47052;NA;53399;233;2021-03-07;43834
2021-03-06;"Nitriansky kraj";86;110858;326;111184;NA;53399;412;2021-03-06;43601
2021-03-05;"Nitriansky kraj";133;39068;200;39268;NA;53399;333;2021-03-05;43189
2021-03-04;"Nitriansky kraj";176;18206;173;18379;NA;53399;349;2021-03-04;42856
2021-03-03;"Nitriansky kraj";172;17210;177;17387;NA;53399;349;2021-03-03;42507
2021-03-02;"Nitriansky kraj";274;20999;366;21365;NA;53399;640;2021-03-02;42158
2021-03-01;"Nitriansky kraj";133;27881;279;28160;NA;53399;412;2021-03-01;41518
2021-02-28;"Nitriansky kraj";80;40866;218;41084;NA;53399;298;2021-02-28;41106
2021-02-27;"Nitriansky kraj";101;106352;496;106848;NA;53399;597;2021-02-27;40808
2021-02-26;"Nitriansky kraj";109;36722;306;37028;NA;53399;415;2021-02-26;40211
2021-02-25;"Nitriansky kraj";188;15235;212;15447;NA;53399;400;2021-02-25;39796
2021-02-24;"Nitriansky kraj";125;13833;260;14093;NA;53399;385;2021-02-24;39396
2021-02-23;"Nitriansky kraj";273;15402;273;15675;NA;53399;546;2021-02-23;39011
2021-02-22;"Nitriansky kraj";154;26466;330;26796;NA;53399;484;2021-02-22;38465
2021-02-21;"Nitriansky kraj";22;43657;320;43977;NA;53399;342;2021-02-21;37981
2021-02-20;"Nitriansky kraj";128;108304;584;108888;NA;53399;712;2021-02-20;37639
2021-02-19;"Nitriansky kraj";173;36849;328;37177;NA;53399;501;2021-02-19;36927
2021-02-18;"Nitriansky kraj";202;17051;275;17326;NA;53399;477;2021-02-18;36426
2021-02-17;"Nitriansky kraj";198;12080;310;12390;NA;53399;508;2021-02-17;35949
2021-02-16;"Nitriansky kraj";284;14477;282;14759;NA;53399;566;2021-02-16;35441
2021-02-15;"Nitriansky kraj";122;27620;471;28091;NA;53399;593;2021-02-15;34875
2021-02-14;"Nitriansky kraj";8;50408;318;50726;NA;53399;326;2021-02-14;34282
2021-02-13;"Nitriansky kraj";127;110035;689;110724;NA;53399;816;2021-02-13;33956
2021-02-12;"Nitriansky kraj";162;33400;407;33807;NA;53399;569;2021-02-12;33140
2021-02-11;"Nitriansky kraj";195;12406;270;12676;NA;53399;465;2021-02-11;32571
2021-02-10;"Nitriansky kraj";186;17632;644;18276;NA;53399;830;2021-02-10;32106
2021-02-09;"Nitriansky kraj";260;18523;385;18908;NA;53399;645;2021-02-09;31276
2021-02-08;"Nitriansky kraj";177;37534;569;38103;NA;53399;746;2021-02-08;30631
2021-02-07;"Nitriansky kraj";20;52307;513;52820;NA;53399;533;2021-02-07;29885
2021-02-06;"Nitriansky kraj";129;101942;765;102707;NA;53399;894;2021-02-06;29352
2021-02-05;"Nitriansky kraj";244;26144;491;26635;NA;53399;735;2021-02-05;28458
2021-02-04;"Nitriansky kraj";308;15681;512;16193;NA;53399;820;2021-02-04;27723
2021-02-03;"Nitriansky kraj";191;13468;382;13850;NA;53399;573;2021-02-03;26903
2021-02-02;"Nitriansky kraj";327;17878;382;18260;NA;53399;709;2021-02-02;26330
2021-02-01;"Nitriansky kraj";221;24049;460;24509;NA;53399;681;2021-02-01;25621
2021-01-31;"Nitriansky kraj";9;45339;496;45835;NA;53399;505;2021-01-31;24940
2021-01-30;"Nitriansky kraj";152;98142;1077;99219;NA;53399;1229;2021-01-30;24435
2021-01-29;"Nitriansky kraj";302;22461;477;22938;NA;53399;779;2021-01-29;23206
2021-01-28;"Nitriansky kraj";269;11370;398;11768;NA;53399;667;2021-01-28;22427
2021-01-27;"Nitriansky kraj";235;6760;299;7059;NA;53399;534;2021-01-27;21760
2021-01-26;"Nitriansky kraj";345;16045;454;16499;NA;53399;799;2021-01-26;21226
2021-01-25;"Nitriansky kraj";201;21729;429;22158;NA;53399;630;2021-01-25;20427
2021-01-24;"Nitriansky kraj";12;78775;889;79664;NA;53399;901;2021-01-24;19797
2021-01-23;"Nitriansky kraj";277;97395;1434;98829;NA;53399;1711;2021-01-23;18896
2021-01-22;"Nitriansky kraj";139;35824;619;36443;NA;53399;758;2021-01-22;17185
2021-01-21;"Nitriansky kraj";305;14649;412;15061;NA;53399;717;2021-01-21;16427
2021-01-20;"Nitriansky kraj";326;11991;625;12616;NA;53399;951;2021-01-20;15710
2021-01-19;"Nitriansky kraj";344;11022;633;11655;NA;53399;977;2021-01-19;14759
2021-01-18;"Nitriansky kraj";367;8902;520;9422;NA;53399;887;2021-01-18;13782
2021-01-17;"Nitriansky kraj";97;15061;275;15336;NA;53399;372;2021-01-17;12895
2021-01-16;"Nitriansky kraj";64;36838;679;37517;NA;53399;743;2021-01-16;12523
2021-01-15;"Nitriansky kraj";373;15940;474;16414;NA;53399;847;2021-01-15;11780
2021-01-14;"Nitriansky kraj";627;10577;452;11029;NA;53399;1079;2021-01-14;10933
2021-01-13;"Nitriansky kraj";663;9234;484;9718;NA;53399;1147;2021-01-13;9854
2021-01-12;"Nitriansky kraj";642;9014;557;9571;NA;53399;1199;2021-01-12;8707
2021-01-11;"Nitriansky kraj";422;8625;556;9181;NA;53399;978;2021-01-11;7508
2021-01-10;"Nitriansky kraj";44;19841;730;20571;NA;53399;774;2021-01-10;6530
2021-01-09;"Nitriansky kraj";532;36823;1071;37894;NA;53399;1603;2021-01-09;5756
2021-01-08;"Nitriansky kraj";817;14297;711;15008;NA;53399;1528;2021-01-08;4153
2021-01-07;"Nitriansky kraj";438;10406;822;11228;NA;53399;1260;2021-01-07;2625
2021-01-06;"Nitriansky kraj";259;3192;197;3389;NA;53399;456;2021-01-06;1365
2021-01-05;"Nitriansky kraj";732;8901;1202;10103;NA;53399;1934;2021-01-05;909
2021-01-04;"Nitriansky kraj";362;8692;1329;10021;NA;53399;1691;2021-01-04;-1025
2021-01-03;"Nitriansky kraj";42;84;20;104;NA;53399;62;2021-01-03;-2716
2021-01-02;"Nitriansky kraj";249;1090;26;1116;NA;53399;275;2021-01-02;-2778
2021-01-01;"Nitriansky kraj";119;781;95;876;NA;53399;214;2021-01-01;-3053
2020-12-31;"Nitriansky kraj";786;7646;962;8608;NA;53399;1748;2020-12-31;-3267
2020-12-30;"Nitriansky kraj";1094;9619;1165;10784;NA;53399;2259;2020-12-30;-5015
2020-12-29;"Nitriansky kraj";607;8277;1286;9563;NA;53399;1893;2020-12-29;-7274
2020-12-28;"Nitriansky kraj";83;6981;1271;8252;NA;53399;1354;2020-12-28;-9167
2020-12-27;"Nitriansky kraj";22;60;8;68;NA;53399;30;2020-12-27;-10521
2020-12-26;"Nitriansky kraj";54;297;56;353;NA;53399;110;2020-12-26;-10551
2020-12-25;"Nitriansky kraj";35;60;11;71;NA;53399;46;2020-12-25;-10661
2020-12-24;"Nitriansky kraj";514;1861;176;2037;NA;53399;690;2020-12-24;-10707
2020-12-23;"Nitriansky kraj";349;15295;843;16138;NA;53399;1192;2020-12-23;-11397
2020-12-22;"Nitriansky kraj";673;10989;994;11983;NA;53399;1667;2020-12-22;-12589
2020-12-21;"Nitriansky kraj";128;7953;976;8929;NA;53399;1104;2020-12-21;-14256
2020-12-20;"Nitriansky kraj";77;50;10;60;NA;53399;87;2020-12-20;-15360
2020-12-19;"Nitriansky kraj";262;2259;159;2418;NA;53399;421;2020-12-19;-15447
2020-12-18;"Nitriansky kraj";512;8437;551;8988;NA;53399;1063;2020-12-18;-15868
2020-12-17;"Nitriansky kraj";586;6894;514;7408;NA;53399;1100;2020-12-17;-16931
2020-12-16;"Nitriansky kraj";357;8785;546;9331;NA;53399;903;2020-12-16;-18031
2020-12-15;"Nitriansky kraj";461;9365;769;10134;NA;53399;1230;2020-12-15;-18934
2020-12-14;"Nitriansky kraj";217;8089;827;8916;NA;53399;1044;2020-12-14;-20164
2020-12-13;"Nitriansky kraj";12;69;6;75;NA;53399;18;2020-12-13;-21208
2020-12-12;"Nitriansky kraj";341;1832;125;1957;NA;53399;466;2020-12-12;-21226
2020-12-11;"Nitriansky kraj";409;5430;416;5846;NA;53399;825;2020-12-11;-21692
2020-12-10;"Nitriansky kraj";360;5473;351;5824;NA;53399;711;2020-12-10;-22517
2020-12-09;"Nitriansky kraj";362;5506;529;6035;NA;53399;891;2020-12-09;-23228
2020-12-08;"Nitriansky kraj";340;8168;548;8716;NA;53399;888;2020-12-08;-24119
2020-12-07;"Nitriansky kraj";139;6243;573;6816;NA;53399;712;2020-12-07;-25007
2020-12-06;"Nitriansky kraj";15;89;4;93;NA;53399;19;2020-12-06;-25719
2020-12-05;"Nitriansky kraj";136;1388;19;1407;NA;53399;155;2020-12-05;-25738
2020-12-04;"Nitriansky kraj";232;2884;74;2958;NA;53399;306;2020-12-04;-25893
2020-12-03;"Nitriansky kraj";248;2471;110;2581;NA;53399;358;2020-12-03;-26199
2020-12-02;"Nitriansky kraj";252;3733;163;3896;NA;53399;415;2020-12-02;-26557
2020-12-01;"Nitriansky kraj";331;2891;131;3022;NA;53399;462;2020-12-01;-26972
2020-11-30;"Nitriansky kraj";91;4228;188;4416;NA;53399;279;2020-11-30;-27434
2020-11-29;"Nitriansky kraj";3;634;42;676;NA;53399;45;2020-11-29;-27713
2020-11-28;"Nitriansky kraj";135;892;31;923;NA;53399;166;2020-11-28;-27758
2020-11-27;"Nitriansky kraj";177;2069;73;2142;NA;53399;250;2020-11-27;-27924
2020-11-26;"Nitriansky kraj";191;2813;80;2893;NA;53399;271;2020-11-26;-28174
2020-11-25;"Nitriansky kraj";325;2478;91;2569;NA;53399;416;2020-11-25;-28445
2020-11-24;"Nitriansky kraj";147;1641;64;1705;NA;53399;211;2020-11-24;-28861
2020-11-23;"Nitriansky kraj";102;9891;212;10103;NA;53399;314;2020-11-23;-29072
2020-11-22;"Nitriansky kraj";7;1176;25;1201;NA;53399;32;2020-11-22;-29386
2020-11-21;"Nitriansky kraj";86;1083;38;1121;NA;53399;124;2020-11-21;-29418
2020-11-20;"Nitriansky kraj";264;4180;103;4283;NA;53399;367;2020-11-20;-29542
2020-11-19;"Nitriansky kraj";185;3065;134;3199;NA;53399;319;2020-11-19;-29909
2020-11-18;"Nitriansky kraj";188;2214;79;2293;NA;53399;267;2020-11-18;-30228
2020-11-17;"Nitriansky kraj";178;596;29;625;NA;53399;207;2020-11-17;-30495
2020-11-16;"Nitriansky kraj";139;1877;75;1952;NA;53399;214;2020-11-16;-30702
2020-11-15;"Nitriansky kraj";14;180;5;185;NA;53399;19;2020-11-15;-30916
2020-11-14;"Nitriansky kraj";114;1131;32;1163;NA;53399;146;2020-11-14;-30935
2020-11-13;"Nitriansky kraj";210;936;46;982;NA;53399;256;2020-11-13;-31081
2020-11-12;"Nitriansky kraj";256;1195;35;1230;NA;53399;291;2020-11-12;-31337
2020-11-11;"Nitriansky kraj";279;1247;22;1269;NA;53399;301;2020-11-11;-31628
2020-11-10;"Nitriansky kraj";192;2623;39;2662;NA;53399;231;2020-11-10;-31929
2020-11-09;"Nitriansky kraj";128;3136;43;3179;NA;53399;171;2020-11-09;-32160
2020-11-08;"Nitriansky kraj";43;1462;32;1494;NA;53399;75;2020-11-08;-32331
2020-11-07;"Nitriansky kraj";130;1046;4;1050;NA;53399;134;2020-11-07;-32406
2020-11-06;"Nitriansky kraj";210;2264;32;2296;NA;53399;242;2020-11-06;-32540
2020-11-05;"Nitriansky kraj";178;313;14;327;NA;53399;192;2020-11-05;-32782
2020-11-04;"Nitriansky kraj";211;297;16;313;NA;53399;227;2020-11-04;-32974
2020-11-03;"Nitriansky kraj";216;435;25;460;NA;53399;241;2020-11-03;-33201
2020-11-02;"Nitriansky kraj";171;4208;46;4254;NA;53399;217;2020-11-02;-33442
2020-11-01;"Nitriansky kraj";130;2546;27;2573;NA;53399;157;2020-11-01;-33659
2020-10-31;"Nitriansky kraj";261;10466;134;10600;NA;53399;395;2020-10-31;-33816
2020-10-30;"Nitriansky kraj";204;2593;42;2635;NA;53399;246;2020-10-30;-34211
2020-10-29;"Nitriansky kraj";293;841;39;880;NA;53399;332;2020-10-29;-34457
2020-10-28;"Nitriansky kraj";216;608;59;667;NA;53399;275;2020-10-28;-34789
2020-10-27;"Nitriansky kraj";296;550;47;597;NA;53399;343;2020-10-27;-35064
2020-10-26;"Nitriansky kraj";69;633;56;689;NA;53399;125;2020-10-26;-35407
2020-10-25;"Nitriansky kraj";50;62;8;70;NA;53399;58;2020-10-25;-35532
2020-10-24;"Nitriansky kraj";169;237;11;248;NA;53399;180;2020-10-24;-35590
2020-10-23;"Nitriansky kraj";282;762;41;803;NA;53399;323;2020-10-23;-35770
2020-10-22;"Nitriansky kraj";137;444;39;483;NA;53399;176;2020-10-22;-36093
2020-10-21;"Nitriansky kraj";146;208;3;211;NA;53399;149;2020-10-21;-36269
2020-10-20;"Nitriansky kraj";197;78;6;84;NA;53399;203;2020-10-20;-36418
2020-10-19;"Nitriansky kraj";148;79;1;80;NA;53399;149;2020-10-19;-36621
2020-10-18;"Nitriansky kraj";22;0;0;0;NA;53399;22;2020-10-18;-36770
2020-10-17;"Nitriansky kraj";67;0;0;0;NA;53399;67;2020-10-17;-36792
2020-10-16;"Nitriansky kraj";133;28;3;31;NA;53399;136;2020-10-16;-36859
2020-10-15;"Nitriansky kraj";106;31;2;33;NA;53399;108;2020-10-15;-36995
2020-10-14;"Nitriansky kraj";80;22;4;26;NA;53399;84;2020-10-14;-37103
2020-10-13;"Nitriansky kraj";101;82;2;84;NA;53399;103;2020-10-13;-37187
2020-10-12;"Nitriansky kraj";36;0;0;0;NA;53399;36;2020-10-12;-37290
2020-10-11;"Nitriansky kraj";8;0;0;0;NA;53399;8;2020-10-11;-37326
2020-10-10;"Nitriansky kraj";107;0;0;0;NA;53399;107;2020-10-10;-37334
2020-10-09;"Nitriansky kraj";120;0;0;0;NA;53399;120;2020-10-09;-37441
2020-10-08;"Nitriansky kraj";132;0;0;0;NA;53399;132;2020-10-08;-37561
2020-10-07;"Nitriansky kraj";81;0;0;0;NA;53399;81;2020-10-07;-37693
2020-10-06;"Nitriansky kraj";48;0;0;0;NA;53399;48;2020-10-06;-37774
2020-10-05;"Nitriansky kraj";20;0;0;0;NA;53399;20;2020-10-05;-37822
2020-10-04;"Nitriansky kraj";17;0;0;0;NA;53399;17;2020-10-04;-37842
2020-10-03;"Nitriansky kraj";96;0;0;0;NA;53399;96;2020-10-03;-37859
2020-10-02;"Nitriansky kraj";108;0;0;0;NA;53399;108;2020-10-02;-37955
2020-10-01;"Nitriansky kraj";95;0;0;0;NA;53399;95;2020-10-01;-38063
2020-09-30;"Nitriansky kraj";100;0;0;0;NA;53399;100;2020-09-30;-38158
2020-09-29;"Nitriansky kraj";50;0;0;0;NA;53399;50;2020-09-29;-38258
2020-09-28;"Nitriansky kraj";22;0;0;0;NA;53399;22;2020-09-28;-38308
2020-09-27;"Nitriansky kraj";16;0;0;0;NA;53399;16;2020-09-27;-38330
2020-09-26;"Nitriansky kraj";64;0;0;0;NA;53399;64;2020-09-26;-38346
2020-09-25;"Nitriansky kraj";90;0;0;0;NA;53399;90;2020-09-25;-38410
2020-09-24;"Nitriansky kraj";51;0;0;0;NA;53399;51;2020-09-24;-38500
2020-09-23;"Nitriansky kraj";70;0;0;0;NA;53399;70;2020-09-23;-38551
2020-09-22;"Nitriansky kraj";18;0;0;0;NA;53399;18;2020-09-22;-38621
2020-09-21;"Nitriansky kraj";10;0;0;0;NA;53399;10;2020-09-21;-38639
2020-09-20;"Nitriansky kraj";4;0;0;0;NA;53399;4;2020-09-20;-38649
2020-09-19;"Nitriansky kraj";14;0;0;0;NA;53399;14;2020-09-19;-38653
2020-09-18;"Nitriansky kraj";19;0;0;0;NA;53399;19;2020-09-18;-38667
2020-09-17;"Nitriansky kraj";30;0;0;0;NA;53399;30;2020-09-17;-38686
2020-09-16;"Nitriansky kraj";6;0;0;0;NA;53399;6;2020-09-16;-38716
2020-09-15;"Nitriansky kraj";19;0;0;0;NA;53399;19;2020-09-15;-38722
2020-09-14;"Nitriansky kraj";28;0;0;0;NA;53399;28;2020-09-14;-38741
2020-09-13;"Nitriansky kraj";3;0;0;0;NA;53399;3;2020-09-13;-38769
2020-09-12;"Nitriansky kraj";12;0;0;0;NA;53399;12;2020-09-12;-38772
2020-09-11;"Nitriansky kraj";23;0;0;0;NA;53399;23;2020-09-11;-38784
2020-09-10;"Nitriansky kraj";29;0;0;0;NA;53399;29;2020-09-10;-38807
2020-09-09;"Nitriansky kraj";19;0;0;0;NA;53399;19;2020-09-09;-38836
2020-09-08;"Nitriansky kraj";17;0;0;0;NA;53399;17;2020-09-08;-38855
2020-09-07;"Nitriansky kraj";17;0;0;0;NA;53399;17;2020-09-07;-38872
2020-09-06;"Nitriansky kraj";0;0;0;0;NA;53399;0;2020-09-06;-38889
2020-09-05;"Nitriansky kraj";22;0;0;0;NA;53399;22;2020-09-05;-38889
2020-09-04;"Nitriansky kraj";34;0;0;0;NA;53399;34;2020-09-04;-38911
2020-09-03;"Nitriansky kraj";15;0;0;0;NA;53399;15;2020-09-03;-38945
2020-09-02;"Nitriansky kraj";15;0;0;0;NA;53399;15;2020-09-02;-38960
2020-09-01;"Nitriansky kraj";2;0;0;0;NA;53399;2;2020-09-01;-38975
2020-08-31;"Nitriansky kraj";12;0;0;0;NA;53399;12;2020-08-31;-38977
2020-08-30;"Nitriansky kraj";1;0;0;0;NA;53399;1;2020-08-30;-38989
2020-08-29;"Nitriansky kraj";7;0;0;0;NA;53399;7;2020-08-29;-38990
2020-08-28;"Nitriansky kraj";12;0;0;0;NA;53399;12;2020-08-28;-38997
2020-08-27;"Nitriansky kraj";12;0;0;0;NA;53399;12;2020-08-27;-39009
2020-08-26;"Nitriansky kraj";4;0;0;0;NA;53399;4;2020-08-26;-39021
2020-08-25;"Nitriansky kraj";8;0;0;0;NA;53399;8;2020-08-25;-39025
2020-08-24;"Nitriansky kraj";1;0;0;0;NA;53399;1;2020-08-24;-39033
2020-08-23;"Nitriansky kraj";1;0;0;0;NA;53399;1;2020-08-23;-39034
2020-08-22;"Nitriansky kraj";2;0;0;0;NA;53399;2;2020-08-22;-39035
2020-08-21;"Nitriansky kraj";0;0;0;0;NA;53399;0;2020-08-21;-39037
2020-08-20;"Nitriansky kraj";7;0;0;0;NA;53399;7;2020-08-20;-39037
2020-08-19;"Nitriansky kraj";1;0;0;0;NA;53399;1;2020-08-19;-39044
2020-08-18;"Nitriansky kraj";2;0;0;0;NA;53399;2;2020-08-18;-39045
2020-08-17;"Nitriansky kraj";1;0;0;0;NA;53399;1;2020-08-17;-39047
2020-08-16;"Nitriansky kraj";0;0;0;0;NA;53399;0;2020-08-16;-39048
2020-08-15;"Nitriansky kraj";2;0;0;0;NA;53399;2;2020-08-15;-39048
2020-08-14;"Nitriansky kraj";1;0;0;0;NA;53399;1;2020-08-14;-39050
2020-08-13;"Nitriansky kraj";4;0;0;0;NA;53399;4;2020-08-13;-39051
2020-08-12;"Nitriansky kraj";0;0;0;0;NA;53399;0;2020-08-12;-39055
2020-08-11;"Nitriansky kraj";1;0;0;0;NA;53399;1;2020-08-11;-39055
2020-08-10;"Nitriansky kraj";0;0;0;0;NA;53399;0;2020-08-10;-39056
2020-08-09;"Nitriansky kraj";0;0;0;0;NA;53399;0;2020-08-09;-39056
2020-08-08;"Nitriansky kraj";0;0;0;0;NA;53399;0;2020-08-08;-39056
2020-08-07;"Nitriansky kraj";4;0;0;0;NA;53399;4;2020-08-07;-39056
2020-08-06;"Nitriansky kraj";4;0;0;0;NA;53399;4;2020-08-06;-39060
2020-08-05;"Nitriansky kraj";0;0;0;0;NA;53399;0;2020-08-05;-39064
2020-08-04;"Nitriansky kraj";7;0;0;0;NA;53399;7;2020-08-04;-39064
2020-08-03;"Nitriansky kraj";0;0;0;0;NA;53399;0;2020-08-03;-39071
2020-08-02;"Nitriansky kraj";0;0;0;0;NA;53399;0;2020-08-02;-39071
2020-08-01;"Nitriansky kraj";0;0;0;0;NA;53399;0;2020-08-01;-39071
2020-07-31;"Nitriansky kraj";0;0;0;0;NA;53399;0;2020-07-31;-39071
2020-07-30;"Nitriansky kraj";0;0;0;0;NA;53399;0;2020-07-30;-39071
2020-07-29;"Nitriansky kraj";0;0;0;0;NA;53399;0;2020-07-29;-39071
2020-07-28;"Nitriansky kraj";0;0;0;0;NA;53399;0;2020-07-28;-39071
2020-07-27;"Nitriansky kraj";0;0;0;0;NA;53399;0;2020-07-27;-39071
2020-07-26;"Nitriansky kraj";0;0;0;0;NA;53399;0;2020-07-26;-39071
2020-07-25;"Nitriansky kraj";0;0;0;0;NA;53399;0;2020-07-25;-39071
2020-07-24;"Nitriansky kraj";1;0;0;0;NA;53399;1;2020-07-24;-39071
2020-07-23;"Nitriansky kraj";3;0;0;0;NA;53399;3;2020-07-23;-39072
2020-07-22;"Nitriansky kraj";2;0;0;0;NA;53399;2;2020-07-22;-39075
2020-07-21;"Nitriansky kraj";14;0;0;0;NA;53399;14;2020-07-21;-39077
2020-07-20;"Nitriansky kraj";11;0;0;0;NA;53399;11;2020-07-20;-39091
2020-07-19;"Nitriansky kraj";0;0;0;0;NA;53399;0;2020-07-19;-39102
2020-07-18;"Nitriansky kraj";0;0;0;0;NA;53399;0;2020-07-18;-39102
2020-07-17;"Nitriansky kraj";0;0;0;0;NA;53399;0;2020-07-17;-39102
2020-07-16;"Nitriansky kraj";4;0;0;0;NA;53399;4;2020-07-16;-39102
2020-07-15;"Nitriansky kraj";5;0;0;0;NA;53399;5;2020-07-15;-39106
2020-07-14;"Nitriansky kraj";0;0;0;0;NA;53399;0;2020-07-14;-39111
2020-07-13;"Nitriansky kraj";0;0;0;0;NA;53399;0;2020-07-13;-39111
2020-07-12;"Nitriansky kraj";0;0;0;0;NA;53399;0;2020-07-12;-39111
2020-07-11;"Nitriansky kraj";0;0;0;0;NA;53399;0;2020-07-11;-39111
2020-07-10;"Nitriansky kraj";0;0;0;0;NA;53399;0;2020-07-10;-39111
2020-07-09;"Nitriansky kraj";1;0;0;0;NA;53399;1;2020-07-09;-39111
2020-07-08;"Nitriansky kraj";2;0;0;0;NA;53399;2;2020-07-08;-39112
2020-07-07;"Nitriansky kraj";0;0;0;0;NA;53399;0;2020-07-07;-39114
2020-07-06;"Nitriansky kraj";0;0;0;0;NA;53399;0;2020-07-06;-39114
2020-07-05;"Nitriansky kraj";0;0;0;0;NA;53399;0;2020-07-05;-39114
2020-07-04;"Nitriansky kraj";0;0;0;0;NA;53399;0;2020-07-04;-39114
2020-07-03;"Nitriansky kraj";0;0;0;0;NA;53399;0;2020-07-03;-39114
2020-07-02;"Nitriansky kraj";0;0;0;0;NA;53399;0;2020-07-02;-39114
2020-07-01;"Nitriansky kraj";3;0;0;0;NA;53399;3;2020-07-01;-39114
2020-06-30;"Nitriansky kraj";0;0;0;0;NA;53399;0;2020-06-30;-39117
2020-06-29;"Nitriansky kraj";0;0;0;0;NA;53399;0;2020-06-29;-39117
2020-06-28;"Nitriansky kraj";0;0;0;0;NA;53399;0;2020-06-28;-39117
2020-06-27;"Nitriansky kraj";0;0;0;0;NA;53399;0;2020-06-27;-39117
2020-06-26;"Nitriansky kraj";0;0;0;0;NA;53399;0;2020-06-26;-39117
2020-06-25;"Nitriansky kraj";0;0;0;0;NA;53399;0;2020-06-25;-39117
2020-06-24;"Nitriansky kraj";1;0;0;0;NA;53399;1;2020-06-24;-39117
2020-06-23;"Nitriansky kraj";0;0;0;0;NA;53399;0;2020-06-23;-39118
2020-06-22;"Nitriansky kraj";0;0;0;0;NA;53399;0;2020-06-22;-39118
2020-06-21;"Nitriansky kraj";0;0;0;0;NA;53399;0;2020-06-21;-39118
2020-06-20;"Nitriansky kraj";0;0;0;0;NA;53399;0;2020-06-20;-39118
2020-06-19;"Nitriansky kraj";0;0;0;0;NA;53399;0;2020-06-19;-39118
2020-06-18;"Nitriansky kraj";0;0;0;0;NA;53399;0;2020-06-18;-39118
2020-06-17;"Nitriansky kraj";0;0;0;0;NA;53399;0;2020-06-17;-39118
2020-06-16;"Nitriansky kraj";0;0;0;0;NA;53399;0;2020-06-16;-39118
2020-06-14;"Nitriansky kraj";0;0;0;0;NA;53399;0;2020-06-14;-39118
2020-06-13;"Nitriansky kraj";0;0;0;0;NA;53399;0;2020-06-13;-39118
2020-06-12;"Nitriansky kraj";0;0;0;0;NA;53399;0;2020-06-12;-39118
2020-06-11;"Nitriansky kraj";0;0;0;0;NA;53399;0;2020-06-11;-39118
2020-06-10;"Nitriansky kraj";1;0;0;0;NA;53399;1;2020-06-10;-39118
2020-06-09;"Nitriansky kraj";1;0;0;0;NA;53399;1;2020-06-09;-39119
2020-06-08;"Nitriansky kraj";0;0;0;0;NA;53399;0;2020-06-08;-39120
2020-06-07;"Nitriansky kraj";0;0;0;0;NA;53399;0;2020-06-07;-39120
2020-06-05;"Nitriansky kraj";0;0;0;0;NA;53399;0;2020-06-05;-39120
2020-06-03;"Nitriansky kraj";0;0;0;0;NA;53399;0;2020-06-03;-39120
2020-06-02;"Nitriansky kraj";1;0;0;0;NA;53399;1;2020-06-02;-39120
2020-05-31;"Nitriansky kraj";0;0;0;0;NA;53399;0;2020-05-31;-39121
2020-05-29;"Nitriansky kraj";0;0;0;0;NA;53399;0;2020-05-29;-39121
2020-05-27;"Nitriansky kraj";0;0;0;0;NA;53399;0;2020-05-27;-39121
2020-05-26;"Nitriansky kraj";0;0;0;0;NA;53399;0;2020-05-26;-39121
2020-05-25;"Nitriansky kraj";0;0;0;0;NA;53399;0;2020-05-25;-39121
2020-05-24;"Nitriansky kraj";2;0;0;0;NA;53399;2;2020-05-24;-39121
2020-05-23;"Nitriansky kraj";0;0;0;0;NA;53399;0;2020-05-23;-39123
2020-05-22;"Nitriansky kraj";1;0;0;0;NA;53399;1;2020-05-22;-39123
2020-05-21;"Nitriansky kraj";0;0;0;0;NA;53399;0;2020-05-21;-39124
2020-05-20;"Nitriansky kraj";0;0;0;0;NA;53399;0;2020-05-20;-39124
2020-05-19;"Nitriansky kraj";0;0;0;0;NA;53399;0;2020-05-19;-39124
2020-05-17;"Nitriansky kraj";0;0;0;0;NA;53399;0;2020-05-17;-39124
2020-05-16;"Nitriansky kraj";0;0;0;0;NA;53399;0;2020-05-16;-39124
2020-05-15;"Nitriansky kraj";1;0;0;0;NA;53399;1;2020-05-15;-39124
2020-05-14;"Nitriansky kraj";0;0;0;0;NA;53399;0;2020-05-14;-39125
2020-05-13;"Nitriansky kraj";0;0;0;0;NA;53399;0;2020-05-13;-39125
2020-05-12;"Nitriansky kraj";0;0;0;0;NA;53399;0;2020-05-12;-39125
2020-05-11;"Nitriansky kraj";2;0;0;0;NA;53399;2;2020-05-11;-39125
2020-05-09;"Nitriansky kraj";0;0;0;0;NA;53399;0;2020-05-09;-39127
2020-05-07;"Nitriansky kraj";1;0;0;0;NA;53399;1;2020-05-07;-39127
2020-05-06;"Nitriansky kraj";9;0;0;0;NA;53399;9;2020-05-06;-39128
2020-05-05;"Nitriansky kraj";0;0;0;0;NA;53399;0;2020-05-05;-39137
2020-05-04;"Nitriansky kraj";5;0;0;0;NA;53399;5;2020-05-04;-39137
2020-05-03;"Nitriansky kraj";2;0;0;0;NA;53399;2;2020-05-03;-39142
2020-05-02;"Nitriansky kraj";0;0;0;0;NA;53399;0;2020-05-02;-39144
2020-05-01;"Nitriansky kraj";1;0;0;0;NA;53399;1;2020-05-01;-39144
2020-04-30;"Nitriansky kraj";0;0;0;0;NA;53399;0;2020-04-30;-39145
2020-04-29;"Nitriansky kraj";0;0;0;0;NA;53399;0;2020-04-29;-39145
2020-04-28;"Nitriansky kraj";1;0;0;0;NA;53399;1;2020-04-28;-39145
2020-04-27;"Nitriansky kraj";0;0;0;0;NA;53399;0;2020-04-27;-39146
2020-04-26;"Nitriansky kraj";0;0;0;0;NA;53399;0;2020-04-26;-39146
2020-04-25;"Nitriansky kraj";0;0;0;0;NA;53399;0;2020-04-25;-39146
2020-04-24;"Nitriansky kraj";0;0;0;0;NA;53399;0;2020-04-24;-39146
2020-04-23;"Nitriansky kraj";3;0;0;0;NA;53399;3;2020-04-23;-39146
2020-04-22;"Nitriansky kraj";16;0;0;0;NA;53399;16;2020-04-22;-39149
2020-04-21;"Nitriansky kraj";6;0;0;0;NA;53399;6;2020-04-21;-39165
2020-04-20;"Nitriansky kraj";5;0;0;0;NA;53399;5;2020-04-20;-39171
2020-04-19;"Nitriansky kraj";0;0;0;0;NA;53399;0;2020-04-19;-39176
2020-04-18;"Nitriansky kraj";0;0;0;0;NA;53399;0;2020-04-18;-39176
2020-04-17;"Nitriansky kraj";7;0;0;0;NA;53399;7;2020-04-17;-39176
2020-04-16;"Nitriansky kraj";0;0;0;0;NA;53399;0;2020-04-16;-39183
2020-04-15;"Nitriansky kraj";6;0;0;0;NA;53399;6;2020-04-15;-39183
2020-04-14;"Nitriansky kraj";2;0;0;0;NA;53399;2;2020-04-14;-39189
2020-04-13;"Nitriansky kraj";1;0;0;0;NA;53399;1;2020-04-13;-39191
2020-04-12;"Nitriansky kraj";3;0;0;0;NA;53399;3;2020-04-12;-39192
2020-04-11;"Nitriansky kraj";1;0;0;0;NA;53399;1;2020-04-11;-39195
2020-04-10;"Nitriansky kraj";1;0;0;0;NA;53399;1;2020-04-10;-39196
2020-04-09;"Nitriansky kraj";0;0;0;0;NA;53399;0;2020-04-09;-39197
2020-04-08;"Nitriansky kraj";2;0;0;0;NA;53399;2;2020-04-08;-39197
2020-04-07;"Nitriansky kraj";3;0;0;0;NA;53399;3;2020-04-07;-39199
2020-04-06;"Nitriansky kraj";4;0;0;0;NA;53399;4;2020-04-06;-39202
2020-04-05;"Nitriansky kraj";5;0;0;0;NA;53399;5;2020-04-05;-39206
2020-04-04;"Nitriansky kraj";0;0;0;0;NA;53399;0;2020-04-04;-39211
2020-04-03;"Nitriansky kraj";0;0;0;0;NA;53399;0;2020-04-03;-39211
2020-04-02;"Nitriansky kraj";1;0;0;0;NA;53399;1;2020-04-02;-39211
2020-04-01;"Nitriansky kraj";0;0;0;0;NA;53399;0;2020-04-01;-39212
2020-03-31;"Nitriansky kraj";3;0;0;0;NA;53399;3;2020-03-31;-39212
2020-03-30;"Nitriansky kraj";3;0;0;0;NA;53399;3;2020-03-30;-39215
2020-03-29;"Nitriansky kraj";3;0;0;0;NA;53399;3;2020-03-29;-39218
2020-03-28;"Nitriansky kraj";1;0;0;0;NA;53399;1;2020-03-28;-39221
2020-03-27;"Nitriansky kraj";1;0;0;0;NA;53399;1;2020-03-27;-39222
2020-03-26;"Nitriansky kraj";1;0;0;0;NA;53399;1;2020-03-26;-39223
2020-03-25;"Nitriansky kraj";1;0;0;0;NA;53399;1;2020-03-25;-39224
2020-03-24;"Nitriansky kraj";0;0;0;0;NA;53399;0;2020-03-24;-39225
2020-03-23;"Nitriansky kraj";2;0;0;0;NA;53399;2;2020-03-23;-39225
2020-03-22;"Nitriansky kraj";2;0;0;0;NA;53399;2;2020-03-22;-39227
2020-03-21;"Nitriansky kraj";2;0;0;0;NA;53399;2;2020-03-21;-39229
2020-03-20;"Nitriansky kraj";1;0;0;0;NA;53399;1;2020-03-20;-39231
2020-03-19;"Nitriansky kraj";1;0;0;0;NA;53399;1;2020-03-19;-39232
2020-03-18;"Nitriansky kraj";2;0;0;0;NA;53399;2;2020-03-18;-39233
2020-03-17;"Nitriansky kraj";1;0;0;0;NA;53399;1;2020-03-17;-39235
2020-03-16;"Nitriansky kraj";0;0;0;0;NA;53399;0;2020-03-16;-39236
2020-03-15;"Nitriansky kraj";4;0;0;0;NA;53399;4;2020-03-15;-39236
2020-03-14;"Nitriansky kraj";1;0;0;0;NA;53399;1;2020-03-14;-39240
2020-03-13;"Nitriansky kraj";0;0;0;0;NA;53399;0;2020-03-13;-39241
2020-03-12;"Nitriansky kraj";0;0;0;0;NA;53399;0;2020-03-12;-39241
2020-03-11;"Nitriansky kraj";0;0;0;0;NA;53399;0;2020-03-11;-39241
2020-03-09;"Nitriansky kraj";0;0;0;0;NA;53399;0;2020-03-09;-39241
2020-03-08;"Nitriansky kraj";0;0;0;0;NA;53399;0;2020-03-08;-39241
2020-03-07;"Nitriansky kraj";0;0;0;0;NA;53399;0;2020-03-07;-39241
2020-03-06;"Nitriansky kraj";0;0;0;0;NA;53399;0;2020-03-06;-39241
2021-06-22;"Prešovský kraj";5;3597;1;3598;0;53707;6;2021-06-22;53707
2021-06-21;"Prešovský kraj";13;7121;6;7127;NA;53707;19;2021-06-21;53701
2021-06-20;"Prešovský kraj";0;4732;3;4735;NA;53707;3;2021-06-20;53682
2021-06-19;"Prešovský kraj";1;6555;4;6559;NA;53707;5;2021-06-19;53679
2021-06-18;"Prešovský kraj";9;7903;8;7911;NA;53707;17;2021-06-18;53674
2021-06-17;"Prešovský kraj";9;6397;5;6402;NA;53707;14;2021-06-17;53657
2021-06-16;"Prešovský kraj";6;6073;3;6076;NA;53707;9;2021-06-16;53643
2021-06-15;"Prešovský kraj";2;5577;4;5581;NA;53707;6;2021-06-15;53634
2021-06-14;"Prešovský kraj";5;8181;13;8194;NA;53707;18;2021-06-14;53628
2021-06-13;"Prešovský kraj";1;6559;7;6566;NA;53707;8;2021-06-13;53610
2021-06-12;"Prešovský kraj";3;8501;9;8510;NA;53707;12;2021-06-12;53602
2021-06-11;"Prešovský kraj";21;9485;9;9494;NA;53707;30;2021-06-11;53590
2021-06-10;"Prešovský kraj";11;6294;9;6303;NA;53707;20;2021-06-10;53560
2021-06-09;"Prešovský kraj";16;6161;3;6164;NA;53707;19;2021-06-09;53540
2021-06-08;"Prešovský kraj";31;6291;12;6303;NA;53707;43;2021-06-08;53521
2021-06-07;"Prešovský kraj";11;8891;15;8906;NA;53707;26;2021-06-07;53478
2021-06-06;"Prešovský kraj";0;7702;4;7706;NA;53707;4;2021-06-06;53452
2021-06-05;"Prešovský kraj";17;9970;14;9984;NA;53707;31;2021-06-05;53448
2021-06-04;"Prešovský kraj";26;10021;18;10039;NA;53707;44;2021-06-04;53417
2021-06-03;"Prešovský kraj";14;6446;15;6461;NA;53707;29;2021-06-03;53373
2021-06-02;"Prešovský kraj";47;7368;14;7382;NA;53707;61;2021-06-02;53344
2021-06-01;"Prešovský kraj";15;6781;14;6795;NA;53707;29;2021-06-01;53283
2021-05-31;"Prešovský kraj";27;9620;22;9642;NA;53707;49;2021-05-31;53254
2021-05-30;"Prešovský kraj";2;9429;13;9442;NA;53707;15;2021-05-30;53205
2021-05-29;"Prešovský kraj";23;12398;24;12422;NA;53707;47;2021-05-29;53190
2021-05-28;"Prešovský kraj";30;11974;19;11993;NA;53707;49;2021-05-28;53143
2021-05-27;"Prešovský kraj";16;7606;37;7643;NA;53707;53;2021-05-27;53094
2021-05-26;"Prešovský kraj";32;7979;23;8002;NA;53707;55;2021-05-26;53041
2021-05-25;"Prešovský kraj";38;8409;20;8429;NA;53707;58;2021-05-25;52986
2021-05-24;"Prešovský kraj";17;13297;37;13334;NA;53707;54;2021-05-24;52928
2021-05-23;"Prešovský kraj";3;11593;20;11613;NA;53707;23;2021-05-23;52874
2021-05-22;"Prešovský kraj";11;14263;44;14307;NA;53707;55;2021-05-22;52851
2021-05-21;"Prešovský kraj";44;13279;24;13303;NA;53707;68;2021-05-21;52796
2021-05-20;"Prešovský kraj";13;9076;29;9105;NA;53707;42;2021-05-20;52728
2021-05-19;"Prešovský kraj";60;10395;33;10428;NA;53707;93;2021-05-19;52686
2021-05-18;"Prešovský kraj";44;9058;27;9085;NA;53707;71;2021-05-18;52593
2021-05-17;"Prešovský kraj";60;12592;46;12638;NA;53707;106;2021-05-17;52522
2021-05-16;"Prešovský kraj";20;15945;66;16011;NA;53707;86;2021-05-16;52416
2021-05-15;"Prešovský kraj";20;24280;80;24360;NA;53707;100;2021-05-15;52330
2021-05-14;"Prešovský kraj";49;18019;62;18081;NA;53707;111;2021-05-14;52230
2021-05-13;"Prešovský kraj";54;11164;71;11235;NA;53707;125;2021-05-13;52119
2021-05-12;"Prešovský kraj";59;10822;39;10861;NA;53707;98;2021-05-12;51994
2021-05-11;"Prešovský kraj";61;10728;48;10776;NA;53707;109;2021-05-11;51896
2021-05-10;"Prešovský kraj";79;15450;67;15517;NA;53707;146;2021-05-10;51787
2021-05-09;"Prešovský kraj";54;21448;79;21527;NA;53707;133;2021-05-09;51641
2021-05-08;"Prešovský kraj";39;23012;52;23064;NA;53707;91;2021-05-08;51508
2021-05-07;"Prešovský kraj";81;23356;66;23422;NA;53707;147;2021-05-07;51417
2021-05-06;"Prešovský kraj";107;12833;66;12899;NA;53707;173;2021-05-06;51270
2021-05-05;"Prešovský kraj";60;12808;84;12892;NA;53707;144;2021-05-05;51097
2021-05-04;"Prešovský kraj";203;13463;66;13529;NA;53707;269;2021-05-04;50953
2021-05-03;"Prešovský kraj";68;18435;109;18544;NA;53707;177;2021-05-03;50684
2021-05-02;"Prešovský kraj";29;36175;102;36277;NA;53707;131;2021-05-02;50507
2021-05-01;"Prešovský kraj";70;57153;183;57336;NA;53707;253;2021-05-01;50376
2021-04-30;"Prešovský kraj";135;39333;118;39451;NA;53707;253;2021-04-30;50123
2021-04-29;"Prešovský kraj";110;16585;97;16682;NA;53707;207;2021-04-29;49870
2021-04-28;"Prešovský kraj";122;18671;89;18760;NA;53707;211;2021-04-28;49663
2021-04-27;"Prešovský kraj";154;19984;120;20104;NA;53707;274;2021-04-27;49452
2021-04-26;"Prešovský kraj";99;27120;123;27243;NA;53707;222;2021-04-26;49178
2021-04-25;"Prešovský kraj";9;52257;155;52412;NA;53707;164;2021-04-25;48956
2021-04-24;"Prešovský kraj";61;85301;243;85544;NA;53707;304;2021-04-24;48792
2021-04-23;"Prešovský kraj";171;40362;137;40499;NA;53707;308;2021-04-23;48488
2021-04-22;"Prešovský kraj";86;18104;125;18229;NA;53707;211;2021-04-22;48180
2021-04-21;"Prešovský kraj";144;21549;139;21688;NA;53707;283;2021-04-21;47969
2021-04-20;"Prešovský kraj";115;23345;128;23473;NA;53707;243;2021-04-20;47686
2021-04-19;"Prešovský kraj";106;29131;145;29276;NA;53707;251;2021-04-19;47443
2021-04-18;"Prešovský kraj";4;51540;129;51669;NA;53707;133;2021-04-18;47192
2021-04-17;"Prešovský kraj";119;97970;238;98208;NA;53707;357;2021-04-17;47059
2021-04-16;"Prešovský kraj";135;40983;146;41129;NA;53707;281;2021-04-16;46702
2021-04-15;"Prešovský kraj";112;20179;137;20316;NA;53707;249;2021-04-15;46421
2021-04-14;"Prešovský kraj";199;23331;130;23461;NA;53707;329;2021-04-14;46172
2021-04-13;"Prešovský kraj";180;23907;116;24023;NA;53707;296;2021-04-13;45843
2021-04-12;"Prešovský kraj";172;30152;175;30327;NA;53707;347;2021-04-12;45547
2021-04-11;"Prešovský kraj";11;49807;187;49994;NA;53707;198;2021-04-11;45200
2021-04-10;"Prešovský kraj";94;90181;297;90478;NA;53707;391;2021-04-10;45002
2021-04-09;"Prešovský kraj";255;37163;200;37363;NA;53707;455;2021-04-09;44611
2021-04-08;"Prešovský kraj";192;18891;157;19048;NA;53707;349;2021-04-08;44156
2021-04-07;"Prešovský kraj";314;27797;154;27951;NA;53707;468;2021-04-07;43807
2021-04-06;"Prešovský kraj";231;41702;268;41970;NA;53707;499;2021-04-06;43339
2021-04-05;"Prešovský kraj";54;18454;132;18586;NA;53707;186;2021-04-05;42840
2021-04-04;"Prešovský kraj";31;18569;91;18660;NA;53707;122;2021-04-04;42654
2021-04-03;"Prešovský kraj";104;90608;317;90925;NA;53707;421;2021-04-03;42532
2021-04-02;"Prešovský kraj";194;23381;134;23515;NA;53707;328;2021-04-02;42111
2021-04-01;"Prešovský kraj";256;42824;195;43019;NA;53707;451;2021-04-01;41783
2021-03-31;"Prešovský kraj";311;30160;227;30387;NA;53707;538;2021-03-31;41332
2021-03-30;"Prešovský kraj";374;20747;203;20950;NA;53707;577;2021-03-30;40794
2021-03-29;"Prešovský kraj";219;28188;229;28417;NA;53707;448;2021-03-29;40217
2021-03-28;"Prešovský kraj";26;46811;256;47067;NA;53707;282;2021-03-28;39769
2021-03-27;"Prešovský kraj";181;88413;372;88785;NA;53707;553;2021-03-27;39487
2021-03-26;"Prešovský kraj";310;47751;299;48050;NA;53707;609;2021-03-26;38934
2021-03-25;"Prešovský kraj";248;22279;213;22492;NA;53707;461;2021-03-25;38325
2021-03-24;"Prešovský kraj";381;19588;213;19801;NA;53707;594;2021-03-24;37864
2021-03-23;"Prešovský kraj";241;20329;255;20584;NA;53707;496;2021-03-23;37270
2021-03-22;"Prešovský kraj";299;28490;286;28776;NA;53707;585;2021-03-22;36774
2021-03-21;"Prešovský kraj";32;49439;266;49705;NA;53707;298;2021-03-21;36189
2021-03-20;"Prešovský kraj";180;92531;427;92958;NA;53707;607;2021-03-20;35891
2021-03-19;"Prešovský kraj";373;46196;320;46516;NA;53707;693;2021-03-19;35284
2021-03-18;"Prešovský kraj";251;21721;217;21938;NA;53707;468;2021-03-18;34591
2021-03-17;"Prešovský kraj";331;20887;231;21118;NA;53707;562;2021-03-17;34123
2021-03-16;"Prešovský kraj";461;21094;278;21372;NA;53707;739;2021-03-16;33561
2021-03-15;"Prešovský kraj";370;28789;324;29113;NA;53707;694;2021-03-15;32822
2021-03-14;"Prešovský kraj";52;50410;356;50766;NA;53707;408;2021-03-14;32128
2021-03-13;"Prešovský kraj";200;95300;532;95832;NA;53707;732;2021-03-13;31720
2021-03-12;"Prešovský kraj";425;47691;368;48059;NA;53707;793;2021-03-12;30988
2021-03-11;"Prešovský kraj";463;22059;253;22312;NA;53707;716;2021-03-11;30195
2021-03-10;"Prešovský kraj";325;20821;293;21114;NA;53707;618;2021-03-10;29479
2021-03-09;"Prešovský kraj";505;21489;288;21777;NA;53707;793;2021-03-09;28861
2021-03-08;"Prešovský kraj";314;28903;333;29236;NA;53707;647;2021-03-08;28068
2021-03-07;"Prešovský kraj";19;48024;385;48409;NA;53707;404;2021-03-07;27421
2021-03-06;"Prešovský kraj";193;96985;591;97576;NA;53707;784;2021-03-06;27017
2021-03-05;"Prešovský kraj";497;46044;397;46441;NA;53707;894;2021-03-05;26233
2021-03-04;"Prešovský kraj";372;22670;359;23029;NA;53707;731;2021-03-04;25339
2021-03-03;"Prešovský kraj";397;21621;333;21954;NA;53707;730;2021-03-03;24608
2021-03-02;"Prešovský kraj";421;22679;357;23036;NA;53707;778;2021-03-02;23878
2021-03-01;"Prešovský kraj";303;27716;406;28122;NA;53707;709;2021-03-01;23100
2021-02-28;"Prešovský kraj";75;45000;387;45387;NA;53707;462;2021-02-28;22391
2021-02-27;"Prešovský kraj";273;90231;734;90965;NA;53707;1007;2021-02-27;21929
2021-02-26;"Prešovský kraj";455;41340;438;41778;NA;53707;893;2021-02-26;20922
2021-02-25;"Prešovský kraj";270;19496;337;19833;NA;53707;607;2021-02-25;20029
2021-02-24;"Prešovský kraj";328;19026;377;19403;NA;53707;705;2021-02-24;19422
2021-02-23;"Prešovský kraj";430;21273;345;21618;NA;53707;775;2021-02-23;18717
2021-02-22;"Prešovský kraj";351;27175;356;27531;NA;53707;707;2021-02-22;17942
2021-02-21;"Prešovský kraj";66;31802;302;32104;NA;53707;368;2021-02-21;17235
2021-02-20;"Prešovský kraj";129;71413;517;71930;NA;53707;646;2021-02-20;16867
2021-02-19;"Prešovský kraj";381;38597;425;39022;NA;53707;806;2021-02-19;16221
2021-02-18;"Prešovský kraj";268;16960;322;17282;NA;53707;590;2021-02-18;15415
2021-02-17;"Prešovský kraj";293;17392;246;17638;NA;53707;539;2021-02-17;14825
2021-02-16;"Prešovský kraj";422;18862;265;19127;NA;53707;687;2021-02-16;14286
2021-02-15;"Prešovský kraj";211;31360;303;31663;NA;53707;514;2021-02-15;13599
2021-02-14;"Prešovský kraj";27;39271;318;39589;NA;53707;345;2021-02-14;13085
2021-02-13;"Prešovský kraj";157;74009;392;74401;NA;53707;549;2021-02-13;12740
2021-02-12;"Prešovský kraj";308;38720;362;39082;NA;53707;670;2021-02-12;12191
2021-02-11;"Prešovský kraj";218;16207;238;16445;NA;53707;456;2021-02-11;11521
2021-02-10;"Prešovský kraj";220;18499;279;18778;NA;53707;499;2021-02-10;11065
2021-02-09;"Prešovský kraj";323;21495;370;21865;NA;53707;693;2021-02-09;10566
2021-02-08;"Prešovský kraj";161;36971;261;37232;NA;53707;422;2021-02-08;9873
2021-02-07;"Prešovský kraj";21;34227;209;34436;NA;53707;230;2021-02-07;9451
2021-02-06;"Prešovský kraj";176;69164;360;69524;NA;53707;536;2021-02-06;9221
2021-02-05;"Prešovský kraj";177;31247;261;31508;NA;53707;438;2021-02-05;8685
2021-02-04;"Prešovský kraj";176;13071;237;13308;NA;53707;413;2021-02-04;8247
2021-02-03;"Prešovský kraj";251;8421;236;8657;NA;53707;487;2021-02-03;7834
2021-02-02;"Prešovský kraj";249;11779;264;12043;NA;53707;513;2021-02-02;7347
2021-02-01;"Prešovský kraj";220;16059;316;16375;NA;53707;536;2021-02-01;6834
2021-01-31;"Prešovský kraj";42;10587;107;10694;NA;53707;149;2021-01-31;6298
2021-01-30;"Prešovský kraj";142;23939;215;24154;NA;53707;357;2021-01-30;6149
2021-01-29;"Prešovský kraj";185;17924;326;18250;NA;53707;511;2021-01-29;5792
2021-01-28;"Prešovský kraj";311;7338;150;7488;NA;53707;461;2021-01-28;5281
2021-01-27;"Prešovský kraj";153;9723;147;9870;NA;53707;300;2021-01-27;4820
2021-01-26;"Prešovský kraj";252;16653;151;16804;NA;53707;403;2021-01-26;4520
2021-01-25;"Prešovský kraj";196;29649;251;29900;NA;53707;447;2021-01-25;4117
2021-01-24;"Prešovský kraj";12;45706;304;46010;NA;53707;316;2021-01-24;3670
2021-01-23;"Prešovský kraj";189;96726;487;97213;NA;53707;676;2021-01-23;3354
2021-01-22;"Prešovský kraj";187;35377;261;35638;NA;53707;448;2021-01-22;2678
2021-01-21;"Prešovský kraj";187;20434;212;20646;NA;53707;399;2021-01-21;2230
2021-01-20;"Prešovský kraj";253;14779;195;14974;NA;53707;448;2021-01-20;1831
2021-01-19;"Prešovský kraj";281;12329;305;12634;NA;53707;586;2021-01-19;1383
2021-01-18;"Prešovský kraj";203;10422;336;10758;NA;53707;539;2021-01-18;797
2021-01-17;"Prešovský kraj";107;14391;1008;15399;NA;53707;1115;2021-01-17;258
2021-01-16;"Prešovský kraj";72;1838;81;1919;NA;53707;153;2021-01-16;-857
2021-01-15;"Prešovský kraj";159;7033;257;7290;NA;53707;416;2021-01-15;-1010
2021-01-14;"Prešovský kraj";268;5523;252;5775;NA;53707;520;2021-01-14;-1426
2021-01-13;"Prešovský kraj";342;5649;226;5875;NA;53707;568;2021-01-13;-1946
2021-01-12;"Prešovský kraj";455;8487;409;8896;NA;53707;864;2021-01-12;-2514
2021-01-11;"Prešovský kraj";343;8489;479;8968;NA;53707;822;2021-01-11;-3378
2021-01-10;"Prešovský kraj";63;476;23;499;NA;53707;86;2021-01-10;-4200
2021-01-09;"Prešovský kraj";439;2248;125;2373;NA;53707;564;2021-01-09;-4286
2021-01-08;"Prešovský kraj";430;10865;572;11437;NA;53707;1002;2021-01-08;-4850
2021-01-07;"Prešovský kraj";268;7789;648;8437;NA;53707;916;2021-01-07;-5852
2021-01-06;"Prešovský kraj";315;1484;134;1618;NA;53707;449;2021-01-06;-6768
2021-01-05;"Prešovský kraj";655;11591;1003;12594;NA;53707;1658;2021-01-05;-7217
2021-01-04;"Prešovský kraj";371;17192;1812;19004;NA;53707;2183;2021-01-04;-8875
2021-01-03;"Prešovský kraj";89;459;41;500;NA;53707;130;2021-01-03;-11058
2021-01-02;"Prešovský kraj";65;1556;160;1716;NA;53707;225;2021-01-02;-11188
2021-01-01;"Prešovský kraj";174;956;71;1027;NA;53707;245;2021-01-01;-11413
2020-12-31;"Prešovský kraj";640;11959;783;12742;NA;53707;1423;2020-12-31;-11658
2020-12-30;"Prešovský kraj";729;9062;802;9864;NA;53707;1531;2020-12-30;-13081
2020-12-29;"Prešovský kraj";435;9273;949;10222;NA;53707;1384;2020-12-29;-14612
2020-12-28;"Prešovský kraj";393;9046;1079;10125;NA;53707;1472;2020-12-28;-15996
2020-12-27;"Prešovský kraj";40;613;45;658;NA;53707;85;2020-12-27;-17468
2020-12-26;"Prešovský kraj";64;176;12;188;NA;53707;76;2020-12-26;-17553
2020-12-25;"Prešovský kraj";208;274;11;285;NA;53707;219;2020-12-25;-17629
2020-12-24;"Prešovský kraj";452;1214;85;1299;NA;53707;537;2020-12-24;-17848
2020-12-23;"Prešovský kraj";361;11369;635;12004;NA;53707;996;2020-12-23;-18385
2020-12-22;"Prešovský kraj";439;9371;710;10081;NA;53707;1149;2020-12-22;-19381
2020-12-21;"Prešovský kraj";432;9923;880;10803;NA;53707;1312;2020-12-21;-20530
2020-12-20;"Prešovský kraj";184;396;20;416;NA;53707;204;2020-12-20;-21842
2020-12-19;"Prešovský kraj";276;1658;151;1809;NA;53707;427;2020-12-19;-22046
2020-12-18;"Prešovský kraj";396;8845;595;9440;NA;53707;991;2020-12-18;-22473
2020-12-17;"Prešovský kraj";427;10826;891;11717;NA;53707;1318;2020-12-17;-23464
2020-12-16;"Prešovský kraj";466;6017;508;6525;NA;53707;974;2020-12-16;-24782
2020-12-15;"Prešovský kraj";411;5685;584;6269;NA;53707;995;2020-12-15;-25756
2020-12-14;"Prešovský kraj";334;5767;508;6275;NA;53707;842;2020-12-14;-26751
2020-12-13;"Prešovský kraj";89;29;8;37;NA;53707;97;2020-12-13;-27593
2020-12-12;"Prešovský kraj";319;2474;166;2640;NA;53707;485;2020-12-12;-27690
2020-12-11;"Prešovský kraj";560;5602;402;6004;NA;53707;962;2020-12-11;-28175
2020-12-10;"Prešovský kraj";337;5202;443;5645;NA;53707;780;2020-12-10;-29137
2020-12-09;"Prešovský kraj";358;4357;314;4671;NA;53707;672;2020-12-09;-29917
2020-12-08;"Prešovský kraj";350;6629;651;7280;NA;53707;1001;2020-12-08;-30589
2020-12-07;"Prešovský kraj";309;4345;327;4672;NA;53707;636;2020-12-07;-31590
2020-12-06;"Prešovský kraj";59;655;26;681;NA;53707;85;2020-12-06;-32226
2020-12-05;"Prešovský kraj";218;984;87;1071;NA;53707;305;2020-12-05;-32311
2020-12-04;"Prešovský kraj";352;5070;293;5363;NA;53707;645;2020-12-04;-32616
2020-12-03;"Prešovský kraj";284;2456;179;2635;NA;53707;463;2020-12-03;-33261
2020-12-02;"Prešovský kraj";232;2830;225;3055;NA;53707;457;2020-12-02;-33724
2020-12-01;"Prešovský kraj";281;1884;196;2080;NA;53707;477;2020-12-01;-34181
2020-11-30;"Prešovský kraj";196;5333;97;5430;NA;53707;293;2020-11-30;-34658
2020-11-29;"Prešovský kraj";27;379;42;421;NA;53707;69;2020-11-29;-34951
2020-11-28;"Prešovský kraj";199;772;77;849;NA;53707;276;2020-11-28;-35020
2020-11-27;"Prešovský kraj";232;2350;130;2480;NA;53707;362;2020-11-27;-35296
2020-11-26;"Prešovský kraj";263;3014;329;3343;NA;53707;592;2020-11-26;-35658
2020-11-25;"Prešovský kraj";302;2174;103;2277;NA;53707;405;2020-11-25;-36250
2020-11-24;"Prešovský kraj";365;1777;156;1933;NA;53707;521;2020-11-24;-36655
2020-11-23;"Prešovský kraj";164;1099;60;1159;NA;53707;224;2020-11-23;-37176
2020-11-22;"Prešovský kraj";46;44;1;45;NA;53707;47;2020-11-22;-37400
2020-11-21;"Prešovský kraj";205;754;62;816;NA;53707;267;2020-11-21;-37447
2020-11-20;"Prešovský kraj";363;2258;102;2360;NA;53707;465;2020-11-20;-37714
2020-11-19;"Prešovský kraj";359;2096;238;2334;NA;53707;597;2020-11-19;-38179
2020-11-18;"Prešovský kraj";270;488;43;531;NA;53707;313;2020-11-18;-38776
2020-11-17;"Prešovský kraj";347;205;23;228;NA;53707;370;2020-11-17;-39089
2020-11-16;"Prešovský kraj";226;540;58;598;NA;53707;284;2020-11-16;-39459
2020-11-15;"Prešovský kraj";186;39;4;43;NA;53707;190;2020-11-15;-39743
2020-11-14;"Prešovský kraj";261;54;4;58;NA;53707;265;2020-11-14;-39933
2020-11-13;"Prešovský kraj";395;166;8;174;NA;53707;403;2020-11-13;-40198
2020-11-12;"Prešovský kraj";397;229;50;279;NA;53707;447;2020-11-12;-40601
2020-11-11;"Prešovský kraj";516;161;15;176;NA;53707;531;2020-11-11;-41048
2020-11-10;"Prešovský kraj";437;197;9;206;NA;53707;446;2020-11-10;-41579
2020-11-09;"Prešovský kraj";190;4110;945;5055;NA;53707;1135;2020-11-09;-42025
2020-11-08;"Prešovský kraj";97;2817;32;2849;NA;53707;129;2020-11-08;-43160
2020-11-07;"Prešovský kraj";416;8578;81;8659;NA;53707;497;2020-11-07;-43289
2020-11-06;"Prešovský kraj";520;4791;76;4867;NA;53707;596;2020-11-06;-43786
2020-11-05;"Prešovský kraj";397;180;5;185;NA;53707;402;2020-11-05;-44382
2020-11-04;"Prešovský kraj";350;807;8;815;NA;53707;358;2020-11-04;-44784
2020-11-03;"Prešovský kraj";565;98;12;110;NA;53707;577;2020-11-03;-45142
2020-11-02;"Prešovský kraj";203;4158;1004;5162;NA;53707;1207;2020-11-02;-45719
2020-11-01;"Prešovský kraj";386;2906;53;2959;NA;53707;439;2020-11-01;-46926
2020-10-31;"Prešovský kraj";315;10497;170;10667;NA;53707;485;2020-10-31;-47365
2020-10-30;"Prešovský kraj";552;2949;65;3014;NA;53707;617;2020-10-30;-47850
2020-10-29;"Prešovský kraj";594;301;38;339;NA;53707;632;2020-10-29;-48467
2020-10-28;"Prešovský kraj";617;291;46;337;NA;53707;663;2020-10-28;-49099
2020-10-27;"Prešovský kraj";656;268;34;302;NA;53707;690;2020-10-27;-49762
2020-10-26;"Prešovský kraj";137;363;57;420;NA;53707;194;2020-10-26;-50452
2020-10-25;"Prešovský kraj";237;346;11;357;NA;53707;248;2020-10-25;-50646
2020-10-24;"Prešovský kraj";719;200;12;212;NA;53707;731;2020-10-24;-50894
2020-10-23;"Prešovský kraj";750;218;8;226;NA;53707;758;2020-10-23;-51625
2020-10-22;"Prešovský kraj";646;396;30;426;NA;53707;676;2020-10-22;-52383
2020-10-21;"Prešovský kraj";383;58;8;66;NA;53707;391;2020-10-21;-53059
2020-10-20;"Prešovský kraj";493;65;7;72;NA;53707;500;2020-10-20;-53450
2020-10-19;"Prešovský kraj";140;235;15;250;NA;53707;155;2020-10-19;-53950
2020-10-18;"Prešovský kraj";209;0;0;0;NA;53707;209;2020-10-18;-54105
2020-10-17;"Prešovský kraj";342;0;0;0;NA;53707;342;2020-10-17;-54314
2020-10-16;"Prešovský kraj";388;57;3;60;NA;53707;391;2020-10-16;-54656
2020-10-15;"Prešovský kraj";435;85;18;103;NA;53707;453;2020-10-15;-55047
2020-10-14;"Prešovský kraj";451;54;10;64;NA;53707;461;2020-10-14;-55500
2020-10-13;"Prešovský kraj";264;50;6;56;NA;53707;270;2020-10-13;-55961
2020-10-12;"Prešovský kraj";214;334;35;369;NA;53707;249;2020-10-12;-56231
2020-10-11;"Prešovský kraj";127;0;0;0;NA;53707;127;2020-10-11;-56480
2020-10-10;"Prešovský kraj";248;0;0;0;NA;53707;248;2020-10-10;-56607
2020-10-09;"Prešovský kraj";406;0;0;0;NA;53707;406;2020-10-09;-56855
2020-10-08;"Prešovský kraj";245;0;0;0;NA;53707;245;2020-10-08;-57261
2020-10-07;"Prešovský kraj";244;0;0;0;NA;53707;244;2020-10-07;-57506
2020-10-06;"Prešovský kraj";166;0;0;0;NA;53707;166;2020-10-06;-57750
2020-10-05;"Prešovský kraj";84;0;0;0;NA;53707;84;2020-10-05;-57916
2020-10-04;"Prešovský kraj";118;0;0;0;NA;53707;118;2020-10-04;-58000
2020-10-03;"Prešovský kraj";204;0;0;0;NA;53707;204;2020-10-03;-58118
2020-10-02;"Prešovský kraj";149;0;0;0;NA;53707;149;2020-10-02;-58322
2020-10-01;"Prešovský kraj";136;0;0;0;NA;53707;136;2020-10-01;-58471
2020-09-30;"Prešovský kraj";121;0;0;0;NA;53707;121;2020-09-30;-58607
2020-09-29;"Prešovský kraj";156;0;0;0;NA;53707;156;2020-09-29;-58728
2020-09-28;"Prešovský kraj";51;0;0;0;NA;53707;51;2020-09-28;-58884
2020-09-27;"Prešovský kraj";10;0;0;0;NA;53707;10;2020-09-27;-58935
2020-09-26;"Prešovský kraj";72;0;0;0;NA;53707;72;2020-09-26;-58945
2020-09-25;"Prešovský kraj";91;0;0;0;NA;53707;91;2020-09-25;-59017
2020-09-24;"Prešovský kraj";52;0;0;0;NA;53707;52;2020-09-24;-59108
2020-09-23;"Prešovský kraj";55;0;0;0;NA;53707;55;2020-09-23;-59160
2020-09-22;"Prešovský kraj";29;0;0;0;NA;53707;29;2020-09-22;-59215
2020-09-21;"Prešovský kraj";14;0;0;0;NA;53707;14;2020-09-21;-59244
2020-09-20;"Prešovský kraj";5;0;0;0;NA;53707;5;2020-09-20;-59258
2020-09-19;"Prešovský kraj";12;0;0;0;NA;53707;12;2020-09-19;-59263
2020-09-18;"Prešovský kraj";29;0;0;0;NA;53707;29;2020-09-18;-59275
2020-09-17;"Prešovský kraj";25;0;0;0;NA;53707;25;2020-09-17;-59304
2020-09-16;"Prešovský kraj";8;0;0;0;NA;53707;8;2020-09-16;-59329
2020-09-15;"Prešovský kraj";10;0;0;0;NA;53707;10;2020-09-15;-59337
2020-09-14;"Prešovský kraj";47;0;0;0;NA;53707;47;2020-09-14;-59347
2020-09-13;"Prešovský kraj";3;0;0;0;NA;53707;3;2020-09-13;-59394
2020-09-12;"Prešovský kraj";4;0;0;0;NA;53707;4;2020-09-12;-59397
2020-09-11;"Prešovský kraj";15;0;0;0;NA;53707;15;2020-09-11;-59401
2020-09-10;"Prešovský kraj";10;0;0;0;NA;53707;10;2020-09-10;-59416
2020-09-09;"Prešovský kraj";21;0;0;0;NA;53707;21;2020-09-09;-59426
2020-09-08;"Prešovský kraj";23;0;0;0;NA;53707;23;2020-09-08;-59447
2020-09-07;"Prešovský kraj";5;0;0;0;NA;53707;5;2020-09-07;-59470
2020-09-06;"Prešovský kraj";3;0;0;0;NA;53707;3;2020-09-06;-59475
2020-09-05;"Prešovský kraj";7;0;0;0;NA;53707;7;2020-09-05;-59478
2020-09-04;"Prešovský kraj";24;0;0;0;NA;53707;24;2020-09-04;-59485
2020-09-03;"Prešovský kraj";8;0;0;0;NA;53707;8;2020-09-03;-59509
2020-09-02;"Prešovský kraj";9;0;0;0;NA;53707;9;2020-09-02;-59517
2020-09-01;"Prešovský kraj";6;0;0;0;NA;53707;6;2020-09-01;-59526
2020-08-31;"Prešovský kraj";3;0;0;0;NA;53707;3;2020-08-31;-59532
2020-08-30;"Prešovský kraj";6;0;0;0;NA;53707;6;2020-08-30;-59535
2020-08-29;"Prešovský kraj";4;0;0;0;NA;53707;4;2020-08-29;-59541
2020-08-28;"Prešovský kraj";6;0;0;0;NA;53707;6;2020-08-28;-59545
2020-08-27;"Prešovský kraj";7;0;0;0;NA;53707;7;2020-08-27;-59551
2020-08-26;"Prešovský kraj";22;0;0;0;NA;53707;22;2020-08-26;-59558
2020-08-25;"Prešovský kraj";1;0;0;0;NA;53707;1;2020-08-25;-59580
2020-08-24;"Prešovský kraj";5;0;0;0;NA;53707;5;2020-08-24;-59581
2020-08-23;"Prešovský kraj";3;0;0;0;NA;53707;3;2020-08-23;-59586
2020-08-22;"Prešovský kraj";3;0;0;0;NA;53707;3;2020-08-22;-59589
2020-08-21;"Prešovský kraj";11;0;0;0;NA;53707;11;2020-08-21;-59592
2020-08-20;"Prešovský kraj";8;0;0;0;NA;53707;8;2020-08-20;-59603
2020-08-19;"Prešovský kraj";8;0;0;0;NA;53707;8;2020-08-19;-59611
2020-08-18;"Prešovský kraj";6;0;0;0;NA;53707;6;2020-08-18;-59619
2020-08-17;"Prešovský kraj";1;0;0;0;NA;53707;1;2020-08-17;-59625
2020-08-16;"Prešovský kraj";0;0;0;0;NA;53707;0;2020-08-16;-59626
2020-08-15;"Prešovský kraj";8;0;0;0;NA;53707;8;2020-08-15;-59626
2020-08-14;"Prešovský kraj";6;0;0;0;NA;53707;6;2020-08-14;-59634
2020-08-13;"Prešovský kraj";8;0;0;0;NA;53707;8;2020-08-13;-59640
2020-08-12;"Prešovský kraj";19;0;0;0;NA;53707;19;2020-08-12;-59648
2020-08-11;"Prešovský kraj";3;0;0;0;NA;53707;3;2020-08-11;-59667
2020-08-10;"Prešovský kraj";0;0;0;0;NA;53707;0;2020-08-10;-59670
2020-08-09;"Prešovský kraj";0;0;0;0;NA;53707;0;2020-08-09;-59670
2020-08-08;"Prešovský kraj";2;0;0;0;NA;53707;2;2020-08-08;-59670
2020-08-07;"Prešovský kraj";6;0;0;0;NA;53707;6;2020-08-07;-59672
2020-08-06;"Prešovský kraj";2;0;0;0;NA;53707;2;2020-08-06;-59678
2020-08-05;"Prešovský kraj";8;0;0;0;NA;53707;8;2020-08-05;-59680
2020-08-04;"Prešovský kraj";5;0;0;0;NA;53707;5;2020-08-04;-59688
2020-08-03;"Prešovský kraj";4;0;0;0;NA;53707;4;2020-08-03;-59693
2020-08-02;"Prešovský kraj";6;0;0;0;NA;53707;6;2020-08-02;-59697
2020-08-01;"Prešovský kraj";0;0;0;0;NA;53707;0;2020-08-01;-59703
2020-07-31;"Prešovský kraj";2;0;0;0;NA;53707;2;2020-07-31;-59703
2020-07-30;"Prešovský kraj";6;0;0;0;NA;53707;6;2020-07-30;-59705
2020-07-29;"Prešovský kraj";5;0;0;0;NA;53707;5;2020-07-29;-59711
2020-07-28;"Prešovský kraj";0;0;0;0;NA;53707;0;2020-07-28;-59716
2020-07-27;"Prešovský kraj";1;0;0;0;NA;53707;1;2020-07-27;-59716
2020-07-26;"Prešovský kraj";1;0;0;0;NA;53707;1;2020-07-26;-59717
2020-07-25;"Prešovský kraj";21;0;0;0;NA;53707;21;2020-07-25;-59718
2020-07-24;"Prešovský kraj";1;0;0;0;NA;53707;1;2020-07-24;-59739
2020-07-23;"Prešovský kraj";5;0;0;0;NA;53707;5;2020-07-23;-59740
2020-07-22;"Prešovský kraj";1;0;0;0;NA;53707;1;2020-07-22;-59745
2020-07-21;"Prešovský kraj";2;0;0;0;NA;53707;2;2020-07-21;-59746
2020-07-20;"Prešovský kraj";1;0;0;0;NA;53707;1;2020-07-20;-59748
2020-07-19;"Prešovský kraj";0;0;0;0;NA;53707;0;2020-07-19;-59749
2020-07-18;"Prešovský kraj";0;0;0;0;NA;53707;0;2020-07-18;-59749
2020-07-17;"Prešovský kraj";3;0;0;0;NA;53707;3;2020-07-17;-59749
2020-07-16;"Prešovský kraj";1;0;0;0;NA;53707;1;2020-07-16;-59752
2020-07-15;"Prešovský kraj";5;0;0;0;NA;53707;5;2020-07-15;-59753
2020-07-14;"Prešovský kraj";5;0;0;0;NA;53707;5;2020-07-14;-59758
2020-07-13;"Prešovský kraj";1;0;0;0;NA;53707;1;2020-07-13;-59763
2020-07-12;"Prešovský kraj";1;0;0;0;NA;53707;1;2020-07-12;-59764
2020-07-11;"Prešovský kraj";6;0;0;0;NA;53707;6;2020-07-11;-59765
2020-07-10;"Prešovský kraj";5;0;0;0;NA;53707;5;2020-07-10;-59771
2020-07-09;"Prešovský kraj";2;0;0;0;NA;53707;2;2020-07-09;-59776
2020-07-08;"Prešovský kraj";14;0;0;0;NA;53707;14;2020-07-08;-59778
2020-07-07;"Prešovský kraj";2;0;0;0;NA;53707;2;2020-07-07;-59792
2020-07-06;"Prešovský kraj";0;0;0;0;NA;53707;0;2020-07-06;-59794
2020-07-05;"Prešovský kraj";0;0;0;0;NA;53707;0;2020-07-05;-59794
2020-07-04;"Prešovský kraj";1;0;0;0;NA;53707;1;2020-07-04;-59794
2020-07-03;"Prešovský kraj";3;0;0;0;NA;53707;3;2020-07-03;-59795
2020-07-02;"Prešovský kraj";0;0;0;0;NA;53707;0;2020-07-02;-59798
2020-07-01;"Prešovský kraj";0;0;0;0;NA;53707;0;2020-07-01;-59798
2020-06-30;"Prešovský kraj";7;0;0;0;NA;53707;7;2020-06-30;-59798
2020-06-29;"Prešovský kraj";0;0;0;0;NA;53707;0;2020-06-29;-59805
2020-06-28;"Prešovský kraj";0;0;0;0;NA;53707;0;2020-06-28;-59805
2020-06-27;"Prešovský kraj";3;0;0;0;NA;53707;3;2020-06-27;-59805
2020-06-26;"Prešovský kraj";3;0;0;0;NA;53707;3;2020-06-26;-59808
2020-06-25;"Prešovský kraj";0;0;0;0;NA;53707;0;2020-06-25;-59811
2020-06-24;"Prešovský kraj";4;0;0;0;NA;53707;4;2020-06-24;-59811
2020-06-23;"Prešovský kraj";0;0;0;0;NA;53707;0;2020-06-23;-59815
2020-06-22;"Prešovský kraj";0;0;0;0;NA;53707;0;2020-06-22;-59815
2020-06-21;"Prešovský kraj";0;0;0;0;NA;53707;0;2020-06-21;-59815
2020-06-20;"Prešovský kraj";0;0;0;0;NA;53707;0;2020-06-20;-59815
2020-06-19;"Prešovský kraj";1;0;0;0;NA;53707;1;2020-06-19;-59815
2020-06-18;"Prešovský kraj";0;0;0;0;NA;53707;0;2020-06-18;-59816
2020-06-17;"Prešovský kraj";0;0;0;0;NA;53707;0;2020-06-17;-59816
2020-06-16;"Prešovský kraj";6;0;0;0;NA;53707;6;2020-06-16;-59816
2020-06-14;"Prešovský kraj";0;0;0;0;NA;53707;0;2020-06-14;-59822
2020-06-13;"Prešovský kraj";0;0;0;0;NA;53707;0;2020-06-13;-59822
2020-06-12;"Prešovský kraj";1;0;0;0;NA;53707;1;2020-06-12;-59822
2020-06-11;"Prešovský kraj";0;0;0;0;NA;53707;0;2020-06-11;-59823
2020-06-10;"Prešovský kraj";0;0;0;0;NA;53707;0;2020-06-10;-59823
2020-06-09;"Prešovský kraj";0;0;0;0;NA;53707;0;2020-06-09;-59823
2020-06-08;"Prešovský kraj";0;0;0;0;NA;53707;0;2020-06-08;-59823
2020-06-07;"Prešovský kraj";0;0;0;0;NA;53707;0;2020-06-07;-59823
2020-06-05;"Prešovský kraj";0;0;0;0;NA;53707;0;2020-06-05;-59823
2020-06-03;"Prešovský kraj";0;0;0;0;NA;53707;0;2020-06-03;-59823
2020-06-02;"Prešovský kraj";1;0;0;0;NA;53707;1;2020-06-02;-59823
2020-05-31;"Prešovský kraj";1;0;0;0;NA;53707;1;2020-05-31;-59824
2020-05-29;"Prešovský kraj";0;0;0;0;NA;53707;0;2020-05-29;-59825
2020-05-27;"Prešovský kraj";0;0;0;0;NA;53707;0;2020-05-27;-59825
2020-05-26;"Prešovský kraj";0;0;0;0;NA;53707;0;2020-05-26;-59825
2020-05-25;"Prešovský kraj";0;0;0;0;NA;53707;0;2020-05-25;-59825
2020-05-24;"Prešovský kraj";0;0;0;0;NA;53707;0;2020-05-24;-59825
2020-05-23;"Prešovský kraj";0;0;0;0;NA;53707;0;2020-05-23;-59825
2020-05-22;"Prešovský kraj";0;0;0;0;NA;53707;0;2020-05-22;-59825
2020-05-21;"Prešovský kraj";1;0;0;0;NA;53707;1;2020-05-21;-59825
2020-05-20;"Prešovský kraj";0;0;0;0;NA;53707;0;2020-05-20;-59826
2020-05-19;"Prešovský kraj";0;0;0;0;NA;53707;0;2020-05-19;-59826
2020-05-17;"Prešovský kraj";0;0;0;0;NA;53707;0;2020-05-17;-59826
2020-05-16;"Prešovský kraj";0;0;0;0;NA;53707;0;2020-05-16;-59826
2020-05-15;"Prešovský kraj";0;0;0;0;NA;53707;0;2020-05-15;-59826
2020-05-14;"Prešovský kraj";0;0;0;0;NA;53707;0;2020-05-14;-59826
2020-05-13;"Prešovský kraj";1;0;0;0;NA;53707;1;2020-05-13;-59826
2020-05-12;"Prešovský kraj";0;0;0;0;NA;53707;0;2020-05-12;-59827
2020-05-11;"Prešovský kraj";1;0;0;0;NA;53707;1;2020-05-11;-59827
2020-05-09;"Prešovský kraj";0;0;0;0;NA;53707;0;2020-05-09;-59828
2020-05-07;"Prešovský kraj";0;0;0;0;NA;53707;0;2020-05-07;-59828
2020-05-06;"Prešovský kraj";0;0;0;0;NA;53707;0;2020-05-06;-59828
2020-05-05;"Prešovský kraj";1;0;0;0;NA;53707;1;2020-05-05;-59828
2020-05-04;"Prešovský kraj";0;0;0;0;NA;53707;0;2020-05-04;-59829
2020-05-03;"Prešovský kraj";0;0;0;0;NA;53707;0;2020-05-03;-59829
2020-05-02;"Prešovský kraj";0;0;0;0;NA;53707;0;2020-05-02;-59829
2020-05-01;"Prešovský kraj";2;0;0;0;NA;53707;2;2020-05-01;-59829
2020-04-30;"Prešovský kraj";0;0;0;0;NA;53707;0;2020-04-30;-59831
2020-04-29;"Prešovský kraj";1;0;0;0;NA;53707;1;2020-04-29;-59831
2020-04-28;"Prešovský kraj";1;0;0;0;NA;53707;1;2020-04-28;-59832
2020-04-27;"Prešovský kraj";2;0;0;0;NA;53707;2;2020-04-27;-59833
2020-04-26;"Prešovský kraj";0;0;0;0;NA;53707;0;2020-04-26;-59835
2020-04-25;"Prešovský kraj";0;0;0;0;NA;53707;0;2020-04-25;-59835
2020-04-24;"Prešovský kraj";0;0;0;0;NA;53707;0;2020-04-24;-59835
2020-04-23;"Prešovský kraj";2;0;0;0;NA;53707;2;2020-04-23;-59835
2020-04-22;"Prešovský kraj";11;0;0;0;NA;53707;11;2020-04-22;-59837
2020-04-21;"Prešovský kraj";12;0;0;0;NA;53707;12;2020-04-21;-59848
2020-04-20;"Prešovský kraj";2;0;0;0;NA;53707;2;2020-04-20;-59860
2020-04-19;"Prešovský kraj";4;0;0;0;NA;53707;4;2020-04-19;-59862
2020-04-18;"Prešovský kraj";1;0;0;0;NA;53707;1;2020-04-18;-59866
2020-04-17;"Prešovský kraj";4;0;0;0;NA;53707;4;2020-04-17;-59867
2020-04-16;"Prešovský kraj";9;0;0;0;NA;53707;9;2020-04-16;-59871
2020-04-15;"Prešovský kraj";21;0;0;0;NA;53707;21;2020-04-15;-59880
2020-04-14;"Prešovský kraj";1;0;0;0;NA;53707;1;2020-04-14;-59901
2020-04-13;"Prešovský kraj";2;0;0;0;NA;53707;2;2020-04-13;-59902
2020-04-12;"Prešovský kraj";6;0;0;0;NA;53707;6;2020-04-12;-59904
2020-04-11;"Prešovský kraj";4;0;0;0;NA;53707;4;2020-04-11;-59910
2020-04-10;"Prešovský kraj";0;0;0;0;NA;53707;0;2020-04-10;-59914
2020-04-09;"Prešovský kraj";1;0;0;0;NA;53707;1;2020-04-09;-59914
2020-04-08;"Prešovský kraj";0;0;0;0;NA;53707;0;2020-04-08;-59915
2020-04-07;"Prešovský kraj";7;0;0;0;NA;53707;7;2020-04-07;-59915
2020-04-06;"Prešovský kraj";10;0;0;0;NA;53707;10;2020-04-06;-59922
2020-04-05;"Prešovský kraj";13;0;0;0;NA;53707;13;2020-04-05;-59932
2020-04-04;"Prešovský kraj";1;0;0;0;NA;53707;1;2020-04-04;-59945
2020-04-03;"Prešovský kraj";4;0;0;0;NA;53707;4;2020-04-03;-59946
2020-04-02;"Prešovský kraj";6;0;0;0;NA;53707;6;2020-04-02;-59950
2020-04-01;"Prešovský kraj";6;0;0;0;NA;53707;6;2020-04-01;-59956
2020-03-31;"Prešovský kraj";6;0;0;0;NA;53707;6;2020-03-31;-59962
2020-03-30;"Prešovský kraj";2;0;0;0;NA;53707;2;2020-03-30;-59968
2020-03-29;"Prešovský kraj";2;0;0;0;NA;53707;2;2020-03-29;-59970
2020-03-28;"Prešovský kraj";2;0;0;0;NA;53707;2;2020-03-28;-59972
2020-03-27;"Prešovský kraj";1;0;0;0;NA;53707;1;2020-03-27;-59974
2020-03-26;"Prešovský kraj";8;0;0;0;NA;53707;8;2020-03-26;-59975
2020-03-25;"Prešovský kraj";1;0;0;0;NA;53707;1;2020-03-25;-59983
2020-03-24;"Prešovský kraj";4;0;0;0;NA;53707;4;2020-03-24;-59984
2020-03-23;"Prešovský kraj";0;0;0;0;NA;53707;0;2020-03-23;-59988
2020-03-22;"Prešovský kraj";1;0;0;0;NA;53707;1;2020-03-22;-59988
2020-03-21;"Prešovský kraj";2;0;0;0;NA;53707;2;2020-03-21;-59989
2020-03-20;"Prešovský kraj";3;0;0;0;NA;53707;3;2020-03-20;-59991
2020-03-19;"Prešovský kraj";2;0;0;0;NA;53707;2;2020-03-19;-59994
2020-03-18;"Prešovský kraj";1;0;0;0;NA;53707;1;2020-03-18;-59996
2020-03-17;"Prešovský kraj";1;0;0;0;NA;53707;1;2020-03-17;-59997
2020-03-16;"Prešovský kraj";4;0;0;0;NA;53707;4;2020-03-16;-59998
2020-03-15;"Prešovský kraj";0;0;0;0;NA;53707;0;2020-03-15;-60002
2020-03-14;"Prešovský kraj";1;0;0;0;NA;53707;1;2020-03-14;-60002
2020-03-13;"Prešovský kraj";0;0;0;0;NA;53707;0;2020-03-13;-60003
2020-03-12;"Prešovský kraj";0;0;0;0;NA;53707;0;2020-03-12;-60003
2020-03-11;"Prešovský kraj";0;0;0;0;NA;53707;0;2020-03-11;-60003
2020-03-09;"Prešovský kraj";0;0;0;0;NA;53707;0;2020-03-09;-60003
2020-03-08;"Prešovský kraj";0;0;0;0;NA;53707;0;2020-03-08;-60003
2020-03-07;"Prešovský kraj";0;0;0;0;NA;53707;0;2020-03-07;-60003
2020-03-06;"Prešovský kraj";0;0;0;0;NA;53707;0;2020-03-06;-60003
2021-06-22;"Trenčiansky kraj";7;1946;2;1948;0;47252;9;2021-06-22;47252
2021-06-21;"Trenčiansky kraj";10;4722;3;4725;NA;47252;13;2021-06-21;47243
2021-06-20;"Trenčiansky kraj";0;2706;4;2710;NA;47252;4;2021-06-20;47230
2021-06-19;"Trenčiansky kraj";5;3654;0;3654;NA;47252;5;2021-06-19;47226
2021-06-18;"Trenčiansky kraj";7;5221;6;5227;NA;47252;13;2021-06-18;47221
2021-06-17;"Trenčiansky kraj";0;2974;5;2979;NA;47252;5;2021-06-17;47208
2021-06-16;"Trenčiansky kraj";4;2687;1;2688;NA;47252;5;2021-06-16;47203
2021-06-15;"Trenčiansky kraj";10;3376;2;3378;NA;47252;12;2021-06-15;47198
2021-06-14;"Trenčiansky kraj";10;4198;14;4212;NA;47252;24;2021-06-14;47186
2021-06-13;"Trenčiansky kraj";0;3950;4;3954;NA;47252;4;2021-06-13;47162
2021-06-12;"Trenčiansky kraj";4;4616;6;4622;NA;47252;10;2021-06-12;47158
2021-06-11;"Trenčiansky kraj";10;6227;11;6238;NA;47252;21;2021-06-11;47148
2021-06-10;"Trenčiansky kraj";5;3315;7;3322;NA;47252;12;2021-06-10;47127
2021-06-09;"Trenčiansky kraj";7;3254;6;3260;NA;47252;13;2021-06-09;47115
2021-06-08;"Trenčiansky kraj";21;3628;7;3635;NA;47252;28;2021-06-08;47102
2021-06-07;"Trenčiansky kraj";13;4944;10;4954;NA;47252;23;2021-06-07;47074
2021-06-06;"Trenčiansky kraj";0;4659;9;4668;NA;47252;9;2021-06-06;47051
2021-06-05;"Trenčiansky kraj";7;5712;4;5716;NA;47252;11;2021-06-05;47042
2021-06-04;"Trenčiansky kraj";16;6800;3;6803;NA;47252;19;2021-06-04;47031
2021-06-03;"Trenčiansky kraj";9;3886;9;3895;NA;47252;18;2021-06-03;47012
2021-06-02;"Trenčiansky kraj";28;4293;8;4301;NA;47252;36;2021-06-02;46994
2021-06-01;"Trenčiansky kraj";22;4426;17;4443;NA;47252;39;2021-06-01;46958
2021-05-31;"Trenčiansky kraj";30;5495;24;5519;NA;47252;54;2021-05-31;46919
2021-05-30;"Trenčiansky kraj";0;7365;15;7380;NA;47252;15;2021-05-30;46865
2021-05-29;"Trenčiansky kraj";13;6900;13;6913;NA;47252;26;2021-05-29;46850
2021-05-28;"Trenčiansky kraj";22;7935;24;7959;NA;47252;46;2021-05-28;46824
2021-05-27;"Trenčiansky kraj";6;5163;12;5175;NA;47252;18;2021-05-27;46778
2021-05-26;"Trenčiansky kraj";26;4413;13;4426;NA;47252;39;2021-05-26;46760
2021-05-25;"Trenčiansky kraj";18;5857;21;5878;NA;47252;39;2021-05-25;46721
2021-05-24;"Trenčiansky kraj";19;9008;36;9044;NA;47252;55;2021-05-24;46682
2021-05-23;"Trenčiansky kraj";0;8161;22;8183;NA;47252;22;2021-05-23;46627
2021-05-22;"Trenčiansky kraj";11;10114;12;10126;NA;47252;23;2021-05-22;46605
2021-05-21;"Trenčiansky kraj";23;10606;24;10630;NA;47252;47;2021-05-21;46582
2021-05-20;"Trenčiansky kraj";23;5487;23;5510;NA;47252;46;2021-05-20;46535
2021-05-19;"Trenčiansky kraj";16;4959;31;4990;NA;47252;47;2021-05-19;46489
2021-05-18;"Trenčiansky kraj";26;7610;26;7636;NA;47252;52;2021-05-18;46442
2021-05-17;"Trenčiansky kraj";37;6771;38;6809;NA;47252;75;2021-05-17;46390
2021-05-16;"Trenčiansky kraj";25;14270;30;14300;NA;47252;55;2021-05-16;46315
2021-05-15;"Trenčiansky kraj";3;19573;26;19599;NA;47252;29;2021-05-15;46260
2021-05-14;"Trenčiansky kraj";41;17047;39;17086;NA;47252;80;2021-05-14;46231
2021-05-13;"Trenčiansky kraj";41;8149;24;8173;NA;47252;65;2021-05-13;46151
2021-05-12;"Trenčiansky kraj";41;7408;31;7439;NA;47252;72;2021-05-12;46086
2021-05-11;"Trenčiansky kraj";66;10205;31;10236;NA;47252;97;2021-05-11;46014
2021-05-10;"Trenčiansky kraj";48;11688;52;11740;NA;47252;100;2021-05-10;45917
2021-05-09;"Trenčiansky kraj";52;15597;32;15629;NA;47252;84;2021-05-09;45817
2021-05-08;"Trenčiansky kraj";3;21544;29;21573;NA;47252;32;2021-05-08;45733
2021-05-07;"Trenčiansky kraj";45;21204;44;21248;NA;47252;89;2021-05-07;45701
2021-05-06;"Trenčiansky kraj";26;10679;44;10723;NA;47252;70;2021-05-06;45612
2021-05-05;"Trenčiansky kraj";73;9092;41;9133;NA;47252;114;2021-05-05;45542
2021-05-04;"Trenčiansky kraj";55;12732;53;12785;NA;47252;108;2021-05-04;45428
2021-05-03;"Trenčiansky kraj";60;15330;51;15381;NA;47252;111;2021-05-03;45320
2021-05-02;"Trenčiansky kraj";0;30768;61;30829;NA;47252;61;2021-05-02;45209
2021-05-01;"Trenčiansky kraj";71;56982;60;57042;NA;47252;131;2021-05-01;45148
2021-04-30;"Trenčiansky kraj";77;29420;61;29481;NA;47252;138;2021-04-30;45017
2021-04-29;"Trenčiansky kraj";49;13183;59;13242;NA;47252;108;2021-04-29;44879
2021-04-28;"Trenčiansky kraj";79;12536;52;12588;NA;47252;131;2021-04-28;44771
2021-04-27;"Trenčiansky kraj";107;15526;40;15566;NA;47252;147;2021-04-27;44640
2021-04-26;"Trenčiansky kraj";52;21066;63;21129;NA;47252;115;2021-04-26;44493
2021-04-25;"Trenčiansky kraj";0;34560;48;34608;NA;47252;48;2021-04-25;44378
2021-04-24;"Trenčiansky kraj";76;72398;100;72498;NA;47252;176;2021-04-24;44330
2021-04-23;"Trenčiansky kraj";143;29958;79;30037;NA;47252;222;2021-04-23;44154
2021-04-22;"Trenčiansky kraj";71;13847;64;13911;NA;47252;135;2021-04-22;43932
2021-04-21;"Trenčiansky kraj";79;12996;67;13063;NA;47252;146;2021-04-21;43797
2021-04-20;"Trenčiansky kraj";142;17739;80;17819;NA;47252;222;2021-04-20;43651
2021-04-19;"Trenčiansky kraj";102;22630;103;22733;NA;47252;205;2021-04-19;43429
2021-04-18;"Trenčiansky kraj";3;40879;97;40976;NA;47252;100;2021-04-18;43224
2021-04-17;"Trenčiansky kraj";77;81498;136;81634;NA;47252;213;2021-04-17;43124
2021-04-16;"Trenčiansky kraj";100;31954;90;32044;NA;47252;190;2021-04-16;42911
2021-04-15;"Trenčiansky kraj";71;14477;69;14546;NA;47252;140;2021-04-15;42721
2021-04-14;"Trenčiansky kraj";135;15549;72;15621;NA;47252;207;2021-04-14;42581
2021-04-13;"Trenčiansky kraj";189;18713;75;18788;NA;47252;264;2021-04-13;42374
2021-04-12;"Trenčiansky kraj";97;23743;91;23834;NA;47252;188;2021-04-12;42110
2021-04-11;"Trenčiansky kraj";1;34735;75;34810;NA;47252;76;2021-04-11;41922
2021-04-10;"Trenčiansky kraj";81;83093;145;83238;NA;47252;226;2021-04-10;41846
2021-04-09;"Trenčiansky kraj";120;28008;91;28099;NA;47252;211;2021-04-09;41620
2021-04-08;"Trenčiansky kraj";112;13282;85;13367;NA;47252;197;2021-04-08;41409
2021-04-07;"Trenčiansky kraj";204;17689;122;17811;NA;47252;326;2021-04-07;41212
2021-04-06;"Trenčiansky kraj";157;28532;178;28710;NA;47252;335;2021-04-06;40886
2021-04-05;"Trenčiansky kraj";15;9227;64;9291;NA;47252;79;2021-04-05;40551
2021-04-04;"Trenčiansky kraj";2;20291;85;20376;NA;47252;87;2021-04-04;40472
2021-04-03;"Trenčiansky kraj";86;80473;221;80694;NA;47252;307;2021-04-03;40385
2021-04-02;"Trenčiansky kraj";126;21620;81;21701;NA;47252;207;2021-04-02;40078
2021-04-01;"Trenčiansky kraj";159;32370;139;32509;NA;47252;298;2021-04-01;39871
2021-03-31;"Trenčiansky kraj";198;20100;130;20230;NA;47252;328;2021-03-31;39573
2021-03-30;"Trenčiansky kraj";272;17304;136;17440;NA;47252;408;2021-03-30;39245
2021-03-29;"Trenčiansky kraj";142;19479;170;19649;NA;47252;312;2021-03-29;38837
2021-03-28;"Trenčiansky kraj";3;34759;116;34875;NA;47252;119;2021-03-28;38525
2021-03-27;"Trenčiansky kraj";130;77314;293;77607;NA;47252;423;2021-03-27;38406
2021-03-26;"Trenčiansky kraj";211;35092;157;35249;NA;47252;368;2021-03-26;37983
2021-03-25;"Trenčiansky kraj";184;16579;176;16755;NA;47252;360;2021-03-25;37615
2021-03-24;"Trenčiansky kraj";259;13099;171;13270;NA;47252;430;2021-03-24;37255
2021-03-23;"Trenčiansky kraj";349;17588;174;17762;NA;47252;523;2021-03-23;36825
2021-03-22;"Trenčiansky kraj";141;21118;213;21331;NA;47252;354;2021-03-22;36302
2021-03-21;"Trenčiansky kraj";85;32711;164;32875;NA;47252;249;2021-03-21;35948
2021-03-20;"Trenčiansky kraj";128;80035;322;80357;NA;47252;450;2021-03-20;35699
2021-03-19;"Trenčiansky kraj";231;34784;232;35016;NA;47252;463;2021-03-19;35249
2021-03-18;"Trenčiansky kraj";262;16105;178;16283;NA;47252;440;2021-03-18;34786
2021-03-17;"Trenčiansky kraj";366;13436;163;13599;NA;47252;529;2021-03-17;34346
2021-03-16;"Trenčiansky kraj";450;15281;241;15522;NA;47252;691;2021-03-16;33817
2021-03-15;"Trenčiansky kraj";162;21235;261;21496;NA;47252;423;2021-03-15;33126
2021-03-14;"Trenčiansky kraj";42;33892;233;34125;NA;47252;275;2021-03-14;32703
2021-03-13;"Trenčiansky kraj";270;79187;453;79640;NA;47252;723;2021-03-13;32428
2021-03-12;"Trenčiansky kraj";366;34787;307;35094;NA;47252;673;2021-03-12;31705
2021-03-11;"Trenčiansky kraj";302;15557;213;15770;NA;47252;515;2021-03-11;31032
2021-03-10;"Trenčiansky kraj";402;13585;237;13822;NA;47252;639;2021-03-10;30517
2021-03-09;"Trenčiansky kraj";586;17982;285;18267;NA;47252;871;2021-03-09;29878
2021-03-08;"Trenčiansky kraj";174;21704;363;22067;NA;47252;537;2021-03-08;29007
2021-03-07;"Trenčiansky kraj";4;33991;318;34309;NA;47252;322;2021-03-07;28470
2021-03-06;"Trenčiansky kraj";260;79661;529;80190;NA;47252;789;2021-03-06;28148
2021-03-05;"Trenčiansky kraj";326;32946;416;33362;NA;47252;742;2021-03-05;27359
2021-03-04;"Trenčiansky kraj";323;16820;315;17135;NA;47252;638;2021-03-04;26617
2021-03-03;"Trenčiansky kraj";413;13953;346;14299;NA;47252;759;2021-03-03;25979
2021-03-02;"Trenčiansky kraj";612;17797;344;18141;NA;47252;956;2021-03-02;25220
2021-03-01;"Trenčiansky kraj";217;21127;445;21572;NA;47252;662;2021-03-01;24264
2021-02-28;"Trenčiansky kraj";45;30238;376;30614;NA;47252;421;2021-02-28;23602
2021-02-27;"Trenčiansky kraj";277;78735;686;79421;NA;47252;963;2021-02-27;23181
2021-02-26;"Trenčiansky kraj";420;32932;435;33367;NA;47252;855;2021-02-26;22218
2021-02-25;"Trenčiansky kraj";424;14029;328;14357;NA;47252;752;2021-02-25;21363
2021-02-24;"Trenčiansky kraj";427;11997;398;12395;NA;47252;825;2021-02-24;20611
2021-02-23;"Trenčiansky kraj";577;14904;390;15294;NA;47252;967;2021-02-23;19786
2021-02-22;"Trenčiansky kraj";160;19969;468;20437;NA;47252;628;2021-02-22;18819
2021-02-21;"Trenčiansky kraj";64;29478;392;29870;NA;47252;456;2021-02-21;18191
2021-02-20;"Trenčiansky kraj";274;77840;745;78585;NA;47252;1019;2021-02-20;17735
2021-02-19;"Trenčiansky kraj";272;30245;520;30765;NA;47252;792;2021-02-19;16716
2021-02-18;"Trenčiansky kraj";355;14378;410;14788;NA;47252;765;2021-02-18;15924
2021-02-17;"Trenčiansky kraj";363;11413;376;11789;NA;47252;739;2021-02-17;15159
2021-02-16;"Trenčiansky kraj";488;17761;406;18167;NA;47252;894;2021-02-16;14420
2021-02-15;"Trenčiansky kraj";151;21846;463;22309;NA;47252;614;2021-02-15;13526
2021-02-14;"Trenčiansky kraj";2;31255;324;31579;NA;47252;326;2021-02-14;12912
2021-02-13;"Trenčiansky kraj";274;63006;522;63528;NA;47252;796;2021-02-13;12586
2021-02-12;"Trenčiansky kraj";276;27966;412;28378;NA;47252;688;2021-02-12;11790
2021-02-11;"Trenčiansky kraj";291;11566;323;11889;NA;47252;614;2021-02-11;11102
2021-02-10;"Trenčiansky kraj";304;11402;317;11719;NA;47252;621;2021-02-10;10488
2021-02-09;"Trenčiansky kraj";514;18401;360;18761;NA;47252;874;2021-02-09;9867
2021-02-08;"Trenčiansky kraj";182;26972;430;27402;NA;47252;612;2021-02-08;8993
2021-02-07;"Trenčiansky kraj";31;36772;341;37113;NA;47252;372;2021-02-07;8381
2021-02-06;"Trenčiansky kraj";216;63931;560;64491;NA;47252;776;2021-02-06;8009
2021-02-05;"Trenčiansky kraj";202;18154;367;18521;NA;47252;569;2021-02-05;7233
2021-02-04;"Trenčiansky kraj";266;7248;311;7559;NA;47252;577;2021-02-04;6664
2021-02-03;"Trenčiansky kraj";162;6718;320;7038;NA;47252;482;2021-02-03;6087
2021-02-02;"Trenčiansky kraj";347;8058;380;8438;NA;47252;727;2021-02-02;5605
2021-02-01;"Trenčiansky kraj";167;8917;311;9228;NA;47252;478;2021-02-01;4878
2021-01-31;"Trenčiansky kraj";7;19103;159;19262;NA;47252;166;2021-01-31;4400
2021-01-30;"Trenčiansky kraj";228;38167;332;38499;NA;47252;560;2021-01-30;4234
2021-01-29;"Trenčiansky kraj";214;7586;235;7821;NA;47252;449;2021-01-29;3674
2021-01-28;"Trenčiansky kraj";307;5442;158;5600;NA;47252;465;2021-01-28;3225
2021-01-27;"Trenčiansky kraj";166;4842;181;5023;NA;47252;347;2021-01-27;2760
2021-01-26;"Trenčiansky kraj";303;14585;250;14835;NA;47252;553;2021-01-26;2413
2021-01-25;"Trenčiansky kraj";160;24302;207;24509;NA;47252;367;2021-01-25;1860
2021-01-24;"Trenčiansky kraj";51;38369;282;38651;NA;47252;333;2021-01-24;1493
2021-01-23;"Trenčiansky kraj";206;114125;749;114874;NA;47252;955;2021-01-23;1160
2021-01-22;"Trenčiansky kraj";148;21833;242;22075;NA;47252;390;2021-01-22;205
2021-01-21;"Trenčiansky kraj";143;8582;166;8748;NA;47252;309;2021-01-21;-185
2021-01-20;"Trenčiansky kraj";181;8186;227;8413;NA;47252;408;2021-01-20;-494
2021-01-19;"Trenčiansky kraj";363;6618;262;6880;NA;47252;625;2021-01-19;-902
2021-01-18;"Trenčiansky kraj";72;4970;321;5291;NA;47252;393;2021-01-18;-1527
2021-01-17;"Trenčiansky kraj";124;156;11;167;NA;47252;135;2021-01-17;-1920
2021-01-16;"Trenčiansky kraj";39;1288;53;1341;NA;47252;92;2021-01-16;-2055
2021-01-15;"Trenčiansky kraj";264;4029;218;4247;NA;47252;482;2021-01-15;-2147
2021-01-14;"Trenčiansky kraj";275;3193;189;3382;NA;47252;464;2021-01-14;-2629
2021-01-13;"Trenčiansky kraj";222;3893;215;4108;NA;47252;437;2021-01-13;-3093
2021-01-12;"Trenčiansky kraj";508;4604;261;4865;NA;47252;769;2021-01-12;-3530
2021-01-11;"Trenčiansky kraj";142;4367;354;4721;NA;47252;496;2021-01-11;-4299
2021-01-10;"Trenčiansky kraj";89;4969;77;5046;NA;47252;166;2021-01-10;-4795
2021-01-09;"Trenčiansky kraj";276;8280;128;8408;NA;47252;404;2021-01-09;-4961
2021-01-08;"Trenčiansky kraj";489;6434;484;6918;NA;47252;973;2021-01-08;-5365
2021-01-07;"Trenčiansky kraj";420;6138;577;6715;NA;47252;997;2021-01-07;-6338
2021-01-06;"Trenčiansky kraj";221;1021;64;1085;NA;47252;285;2021-01-06;-7335
2021-01-05;"Trenčiansky kraj";669;5753;706;6459;NA;47252;1375;2021-01-05;-7620
2021-01-04;"Trenčiansky kraj";337;5248;782;6030;NA;47252;1119;2021-01-04;-8995
2021-01-03;"Trenčiansky kraj";38;114;15;129;NA;47252;53;2021-01-03;-10114
2021-01-02;"Trenčiansky kraj";129;196;23;219;NA;47252;152;2021-01-02;-10167
2021-01-01;"Trenčiansky kraj";329;347;23;370;NA;47252;352;2021-01-01;-10319
2020-12-31;"Trenčiansky kraj";597;4943;557;5500;NA;47252;1154;2020-12-31;-10671
2020-12-30;"Trenčiansky kraj";836;7012;762;7774;NA;47252;1598;2020-12-30;-11825
2020-12-29;"Trenčiansky kraj";459;6191;1018;7209;NA;47252;1477;2020-12-29;-13423
2020-12-28;"Trenčiansky kraj";258;4195;777;4972;NA;47252;1035;2020-12-28;-14900
2020-12-27;"Trenčiansky kraj";5;208;36;244;NA;47252;41;2020-12-27;-15935
2020-12-26;"Trenčiansky kraj";174;74;10;84;NA;47252;184;2020-12-26;-15976
2020-12-25;"Trenčiansky kraj";251;325;47;372;NA;47252;298;2020-12-25;-16160
2020-12-24;"Trenčiansky kraj";552;2194;256;2450;NA;47252;808;2020-12-24;-16458
2020-12-23;"Trenčiansky kraj";421;6552;661;7213;NA;47252;1082;2020-12-23;-17266
2020-12-22;"Trenčiansky kraj";673;5760;694;6454;NA;47252;1367;2020-12-22;-18348
2020-12-21;"Trenčiansky kraj";248;13321;956;14277;NA;47252;1204;2020-12-21;-19715
2020-12-20;"Trenčiansky kraj";238;12504;292;12796;NA;47252;530;2020-12-20;-20919
2020-12-19;"Trenčiansky kraj";341;1611;150;1761;NA;47252;491;2020-12-19;-21449
2020-12-18;"Trenčiansky kraj";521;5199;615;5814;NA;47252;1136;2020-12-18;-21940
2020-12-17;"Trenčiansky kraj";670;3843;524;4367;NA;47252;1194;2020-12-17;-23076
2020-12-16;"Trenčiansky kraj";461;4464;647;5111;NA;47252;1108;2020-12-16;-24270
2020-12-15;"Trenčiansky kraj";595;3805;670;4475;NA;47252;1265;2020-12-15;-25378
2020-12-14;"Trenčiansky kraj";318;3194;613;3807;NA;47252;931;2020-12-14;-26643
2020-12-13;"Trenčiansky kraj";77;49;6;55;NA;47252;83;2020-12-13;-27574
2020-12-12;"Trenčiansky kraj";314;1191;132;1323;NA;47252;446;2020-12-12;-27657
2020-12-11;"Trenčiansky kraj";751;4066;479;4545;NA;47252;1230;2020-12-11;-28103
2020-12-10;"Trenčiansky kraj";271;3354;473;3827;NA;47252;744;2020-12-10;-29333
2020-12-09;"Trenčiansky kraj";508;3788;466;4254;NA;47252;974;2020-12-09;-30077
2020-12-08;"Trenčiansky kraj";546;3440;522;3962;NA;47252;1068;2020-12-08;-31051
2020-12-07;"Trenčiansky kraj";258;3832;468;4300;NA;47252;726;2020-12-07;-32119
2020-12-06;"Trenčiansky kraj";114;179;10;189;NA;47252;124;2020-12-06;-32845
2020-12-05;"Trenčiansky kraj";223;610;56;666;NA;47252;279;2020-12-05;-32969
2020-12-04;"Trenčiansky kraj";253;2943;273;3216;NA;47252;526;2020-12-04;-33248
2020-12-03;"Trenčiansky kraj";503;1714;178;1892;NA;47252;681;2020-12-03;-33774
2020-12-02;"Trenčiansky kraj";418;1844;232;2076;NA;47252;650;2020-12-02;-34455
2020-12-01;"Trenčiansky kraj";321;5642;351;5993;NA;47252;672;2020-12-01;-35105
2020-11-30;"Trenčiansky kraj";167;11514;520;12034;NA;47252;687;2020-11-30;-35777
2020-11-29;"Trenčiansky kraj";29;30;5;35;NA;47252;34;2020-11-29;-36464
2020-11-28;"Trenčiansky kraj";202;1051;93;1144;NA;47252;295;2020-11-28;-36498
2020-11-27;"Trenčiansky kraj";330;1888;186;2074;NA;47252;516;2020-11-27;-36793
2020-11-26;"Trenčiansky kraj";395;1252;122;1374;NA;47252;517;2020-11-26;-37309
2020-11-25;"Trenčiansky kraj";322;1444;160;1604;NA;47252;482;2020-11-25;-37826
2020-11-24;"Trenčiansky kraj";348;2553;308;2861;NA;47252;656;2020-11-24;-38308
2020-11-23;"Trenčiansky kraj";159;1186;122;1308;NA;47252;281;2020-11-23;-38964
2020-11-22;"Trenčiansky kraj";26;30;7;37;NA;47252;33;2020-11-22;-39245
2020-11-21;"Trenčiansky kraj";255;1376;69;1445;NA;47252;324;2020-11-21;-39278
2020-11-20;"Trenčiansky kraj";316;861;93;954;NA;47252;409;2020-11-20;-39602
2020-11-19;"Trenčiansky kraj";316;740;113;853;NA;47252;429;2020-11-19;-40011
2020-11-18;"Trenčiansky kraj";233;379;66;445;NA;47252;299;2020-11-18;-40440
2020-11-17;"Trenčiansky kraj";222;106;15;121;NA;47252;237;2020-11-17;-40739
2020-11-16;"Trenčiansky kraj";245;236;45;281;NA;47252;290;2020-11-16;-40976
2020-11-15;"Trenčiansky kraj";109;29;6;35;NA;47252;115;2020-11-15;-41266
2020-11-14;"Trenčiansky kraj";190;74;11;85;NA;47252;201;2020-11-14;-41381
2020-11-13;"Trenčiansky kraj";308;131;13;144;NA;47252;321;2020-11-13;-41582
2020-11-12;"Trenčiansky kraj";324;124;5;129;NA;47252;329;2020-11-12;-41903
2020-11-11;"Trenčiansky kraj";366;113;10;123;NA;47252;376;2020-11-11;-42232
2020-11-10;"Trenčiansky kraj";277;106;6;112;NA;47252;283;2020-11-10;-42608
2020-11-09;"Trenčiansky kraj";115;1407;48;1455;NA;47252;163;2020-11-09;-42891
2020-11-08;"Trenčiansky kraj";81;1271;8;1279;NA;47252;89;2020-11-08;-43054
2020-11-07;"Trenčiansky kraj";319;3662;59;3721;NA;47252;378;2020-11-07;-43143
2020-11-06;"Trenčiansky kraj";383;6893;84;6977;NA;47252;467;2020-11-06;-43521
2020-11-05;"Trenčiansky kraj";399;98;15;113;NA;47252;414;2020-11-05;-43988
2020-11-04;"Trenčiansky kraj";370;91;9;100;NA;47252;379;2020-11-04;-44402
2020-11-03;"Trenčiansky kraj";575;97;8;105;NA;47252;583;2020-11-03;-44781
2020-11-02;"Trenčiansky kraj";197;1833;68;1901;NA;47252;265;2020-11-02;-45364
2020-11-01;"Trenčiansky kraj";257;808;24;832;NA;47252;281;2020-11-01;-45629
2020-10-31;"Trenčiansky kraj";332;4719;82;4801;NA;47252;414;2020-10-31;-45910
2020-10-30;"Trenčiansky kraj";299;5283;102;5385;NA;47252;401;2020-10-30;-46324
2020-10-29;"Trenčiansky kraj";496;764;68;832;NA;47252;564;2020-10-29;-46725
2020-10-28;"Trenčiansky kraj";269;192;33;225;NA;47252;302;2020-10-28;-47289
2020-10-27;"Trenčiansky kraj";473;127;27;154;NA;47252;500;2020-10-27;-47591
2020-10-26;"Trenčiansky kraj";177;107;36;143;NA;47252;213;2020-10-26;-48091
2020-10-25;"Trenčiansky kraj";138;9;5;14;NA;47252;143;2020-10-25;-48304
2020-10-24;"Trenčiansky kraj";395;128;6;134;NA;47252;401;2020-10-24;-48447
2020-10-23;"Trenčiansky kraj";301;154;8;162;NA;47252;309;2020-10-23;-48848
2020-10-22;"Trenčiansky kraj";273;82;12;94;NA;47252;285;2020-10-22;-49157
2020-10-21;"Trenčiansky kraj";183;53;9;62;NA;47252;192;2020-10-21;-49442
2020-10-20;"Trenčiansky kraj";212;47;6;53;NA;47252;218;2020-10-20;-49634
2020-10-19;"Trenčiansky kraj";41;83;25;108;NA;47252;66;2020-10-19;-49852
2020-10-18;"Trenčiansky kraj";104;0;0;0;NA;47252;104;2020-10-18;-49918
2020-10-17;"Trenčiansky kraj";157;0;0;0;NA;47252;157;2020-10-17;-50022
2020-10-16;"Trenčiansky kraj";225;42;6;48;NA;47252;231;2020-10-16;-50179
2020-10-15;"Trenčiansky kraj";255;39;4;43;NA;47252;259;2020-10-15;-50410
2020-10-14;"Trenčiansky kraj";162;42;7;49;NA;47252;169;2020-10-14;-50669
2020-10-13;"Trenčiansky kraj";124;105;12;117;NA;47252;136;2020-10-13;-50838
2020-10-12;"Trenčiansky kraj";55;0;0;0;NA;47252;55;2020-10-12;-50974
2020-10-11;"Trenčiansky kraj";73;0;0;0;NA;47252;73;2020-10-11;-51029
2020-10-10;"Trenčiansky kraj";180;0;0;0;NA;47252;180;2020-10-10;-51102
2020-10-09;"Trenčiansky kraj";198;0;0;0;NA;47252;198;2020-10-09;-51282
2020-10-08;"Trenčiansky kraj";115;0;0;0;NA;47252;115;2020-10-08;-51480
2020-10-07;"Trenčiansky kraj";75;0;0;0;NA;47252;75;2020-10-07;-51595
2020-10-06;"Trenčiansky kraj";72;0;0;0;NA;47252;72;2020-10-06;-51670
2020-10-05;"Trenčiansky kraj";32;0;0;0;NA;47252;32;2020-10-05;-51742
2020-10-04;"Trenčiansky kraj";37;0;0;0;NA;47252;37;2020-10-04;-51774
2020-10-03;"Trenčiansky kraj";79;0;0;0;NA;47252;79;2020-10-03;-51811
2020-10-02;"Trenčiansky kraj";69;0;0;0;NA;47252;69;2020-10-02;-51890
2020-10-01;"Trenčiansky kraj";58;0;0;0;NA;47252;58;2020-10-01;-51959
2020-09-30;"Trenčiansky kraj";76;0;0;0;NA;47252;76;2020-09-30;-52017
2020-09-29;"Trenčiansky kraj";43;0;0;0;NA;47252;43;2020-09-29;-52093
2020-09-28;"Trenčiansky kraj";7;0;0;0;NA;47252;7;2020-09-28;-52136
2020-09-27;"Trenčiansky kraj";12;0;0;0;NA;47252;12;2020-09-27;-52143
2020-09-26;"Trenčiansky kraj";37;0;0;0;NA;47252;37;2020-09-26;-52155
2020-09-25;"Trenčiansky kraj";72;0;0;0;NA;47252;72;2020-09-25;-52192
2020-09-24;"Trenčiansky kraj";41;0;0;0;NA;47252;41;2020-09-24;-52264
2020-09-23;"Trenčiansky kraj";32;0;0;0;NA;47252;32;2020-09-23;-52305
2020-09-22;"Trenčiansky kraj";26;0;0;0;NA;47252;26;2020-09-22;-52337
2020-09-21;"Trenčiansky kraj";23;0;0;0;NA;47252;23;2020-09-21;-52363
2020-09-20;"Trenčiansky kraj";21;0;0;0;NA;47252;21;2020-09-20;-52386
2020-09-19;"Trenčiansky kraj";20;0;0;0;NA;47252;20;2020-09-19;-52407
2020-09-18;"Trenčiansky kraj";41;0;0;0;NA;47252;41;2020-09-18;-52427
2020-09-17;"Trenčiansky kraj";20;0;0;0;NA;47252;20;2020-09-17;-52468
2020-09-16;"Trenčiansky kraj";14;0;0;0;NA;47252;14;2020-09-16;-52488
2020-09-15;"Trenčiansky kraj";8;0;0;0;NA;47252;8;2020-09-15;-52502
2020-09-14;"Trenčiansky kraj";5;0;0;0;NA;47252;5;2020-09-14;-52510
2020-09-13;"Trenčiansky kraj";12;0;0;0;NA;47252;12;2020-09-13;-52515
2020-09-12;"Trenčiansky kraj";2;0;0;0;NA;47252;2;2020-09-12;-52527
2020-09-11;"Trenčiansky kraj";27;0;0;0;NA;47252;27;2020-09-11;-52529
2020-09-10;"Trenčiansky kraj";15;0;0;0;NA;47252;15;2020-09-10;-52556
2020-09-09;"Trenčiansky kraj";11;0;0;0;NA;47252;11;2020-09-09;-52571
2020-09-08;"Trenčiansky kraj";12;0;0;0;NA;47252;12;2020-09-08;-52582
2020-09-07;"Trenčiansky kraj";6;0;0;0;NA;47252;6;2020-09-07;-52594
2020-09-06;"Trenčiansky kraj";1;0;0;0;NA;47252;1;2020-09-06;-52600
2020-09-05;"Trenčiansky kraj";3;0;0;0;NA;47252;3;2020-09-05;-52601
2020-09-04;"Trenčiansky kraj";9;0;0;0;NA;47252;9;2020-09-04;-52604
2020-09-03;"Trenčiansky kraj";10;0;0;0;NA;47252;10;2020-09-03;-52613
2020-09-02;"Trenčiansky kraj";5;0;0;0;NA;47252;5;2020-09-02;-52623
2020-09-01;"Trenčiansky kraj";1;0;0;0;NA;47252;1;2020-09-01;-52628
2020-08-31;"Trenčiansky kraj";12;0;0;0;NA;47252;12;2020-08-31;-52629
2020-08-30;"Trenčiansky kraj";0;0;0;0;NA;47252;0;2020-08-30;-52641
2020-08-29;"Trenčiansky kraj";1;0;0;0;NA;47252;1;2020-08-29;-52641
2020-08-28;"Trenčiansky kraj";12;0;0;0;NA;47252;12;2020-08-28;-52642
2020-08-27;"Trenčiansky kraj";10;0;0;0;NA;47252;10;2020-08-27;-52654
2020-08-26;"Trenčiansky kraj";15;0;0;0;NA;47252;15;2020-08-26;-52664
2020-08-25;"Trenčiansky kraj";12;0;0;0;NA;47252;12;2020-08-25;-52679
2020-08-24;"Trenčiansky kraj";4;0;0;0;NA;47252;4;2020-08-24;-52691
2020-08-23;"Trenčiansky kraj";5;0;0;0;NA;47252;5;2020-08-23;-52695
2020-08-22;"Trenčiansky kraj";6;0;0;0;NA;47252;6;2020-08-22;-52700
2020-08-21;"Trenčiansky kraj";6;0;0;0;NA;47252;6;2020-08-21;-52706
2020-08-20;"Trenčiansky kraj";20;0;0;0;NA;47252;20;2020-08-20;-52712
2020-08-19;"Trenčiansky kraj";17;0;0;0;NA;47252;17;2020-08-19;-52732
2020-08-18;"Trenčiansky kraj";9;0;0;0;NA;47252;9;2020-08-18;-52749
2020-08-17;"Trenčiansky kraj";4;0;0;0;NA;47252;4;2020-08-17;-52758
2020-08-16;"Trenčiansky kraj";0;0;0;0;NA;47252;0;2020-08-16;-52762
2020-08-15;"Trenčiansky kraj";9;0;0;0;NA;47252;9;2020-08-15;-52762
2020-08-14;"Trenčiansky kraj";15;0;0;0;NA;47252;15;2020-08-14;-52771
2020-08-13;"Trenčiansky kraj";23;0;0;0;NA;47252;23;2020-08-13;-52786
2020-08-12;"Trenčiansky kraj";6;0;0;0;NA;47252;6;2020-08-12;-52809
2020-08-11;"Trenčiansky kraj";7;0;0;0;NA;47252;7;2020-08-11;-52815
2020-08-10;"Trenčiansky kraj";9;0;0;0;NA;47252;9;2020-08-10;-52822
2020-08-09;"Trenčiansky kraj";1;0;0;0;NA;47252;1;2020-08-09;-52831
2020-08-08;"Trenčiansky kraj";4;0;0;0;NA;47252;4;2020-08-08;-52832
2020-08-07;"Trenčiansky kraj";4;0;0;0;NA;47252;4;2020-08-07;-52836
2020-08-06;"Trenčiansky kraj";13;0;0;0;NA;47252;13;2020-08-06;-52840
2020-08-05;"Trenčiansky kraj";39;0;0;0;NA;47252;39;2020-08-05;-52853
2020-08-04;"Trenčiansky kraj";9;0;0;0;NA;47252;9;2020-08-04;-52892
2020-08-03;"Trenčiansky kraj";0;0;0;0;NA;47252;0;2020-08-03;-52901
2020-08-02;"Trenčiansky kraj";2;0;0;0;NA;47252;2;2020-08-02;-52901
2020-08-01;"Trenčiansky kraj";6;0;0;0;NA;47252;6;2020-08-01;-52903
2020-07-31;"Trenčiansky kraj";16;0;0;0;NA;47252;16;2020-07-31;-52909
2020-07-30;"Trenčiansky kraj";4;0;0;0;NA;47252;4;2020-07-30;-52925
2020-07-29;"Trenčiansky kraj";5;0;0;0;NA;47252;5;2020-07-29;-52929
2020-07-28;"Trenčiansky kraj";11;0;0;0;NA;47252;11;2020-07-28;-52934
2020-07-27;"Trenčiansky kraj";4;0;0;0;NA;47252;4;2020-07-27;-52945
2020-07-26;"Trenčiansky kraj";1;0;0;0;NA;47252;1;2020-07-26;-52949
2020-07-25;"Trenčiansky kraj";7;0;0;0;NA;47252;7;2020-07-25;-52950
2020-07-24;"Trenčiansky kraj";5;0;0;0;NA;47252;5;2020-07-24;-52957
2020-07-23;"Trenčiansky kraj";10;0;0;0;NA;47252;10;2020-07-23;-52962
2020-07-22;"Trenčiansky kraj";11;0;0;0;NA;47252;11;2020-07-22;-52972
2020-07-21;"Trenčiansky kraj";6;0;0;0;NA;47252;6;2020-07-21;-52983
2020-07-20;"Trenčiansky kraj";13;0;0;0;NA;47252;13;2020-07-20;-52989
2020-07-19;"Trenčiansky kraj";0;0;0;0;NA;47252;0;2020-07-19;-53002
2020-07-18;"Trenčiansky kraj";0;0;0;0;NA;47252;0;2020-07-18;-53002
2020-07-17;"Trenčiansky kraj";1;0;0;0;NA;47252;1;2020-07-17;-53002
2020-07-16;"Trenčiansky kraj";0;0;0;0;NA;47252;0;2020-07-16;-53003
2020-07-15;"Trenčiansky kraj";2;0;0;0;NA;47252;2;2020-07-15;-53003
2020-07-14;"Trenčiansky kraj";8;0;0;0;NA;47252;8;2020-07-14;-53005
2020-07-13;"Trenčiansky kraj";1;0;0;0;NA;47252;1;2020-07-13;-53013
2020-07-12;"Trenčiansky kraj";0;0;0;0;NA;47252;0;2020-07-12;-53014
2020-07-11;"Trenčiansky kraj";0;0;0;0;NA;47252;0;2020-07-11;-53014
2020-07-10;"Trenčiansky kraj";3;0;0;0;NA;47252;3;2020-07-10;-53014
2020-07-09;"Trenčiansky kraj";2;0;0;0;NA;47252;2;2020-07-09;-53017
2020-07-08;"Trenčiansky kraj";1;0;0;0;NA;47252;1;2020-07-08;-53019
2020-07-07;"Trenčiansky kraj";9;0;0;0;NA;47252;9;2020-07-07;-53020
2020-07-06;"Trenčiansky kraj";1;0;0;0;NA;47252;1;2020-07-06;-53029
2020-07-05;"Trenčiansky kraj";1;0;0;0;NA;47252;1;2020-07-05;-53030
2020-07-04;"Trenčiansky kraj";0;0;0;0;NA;47252;0;2020-07-04;-53031
2020-07-03;"Trenčiansky kraj";2;0;0;0;NA;47252;2;2020-07-03;-53031
2020-07-02;"Trenčiansky kraj";10;0;0;0;NA;47252;10;2020-07-02;-53033
2020-07-01;"Trenčiansky kraj";1;0;0;0;NA;47252;1;2020-07-01;-53043
2020-06-30;"Trenčiansky kraj";6;0;0;0;NA;47252;6;2020-06-30;-53044
2020-06-29;"Trenčiansky kraj";1;0;0;0;NA;47252;1;2020-06-29;-53050
2020-06-28;"Trenčiansky kraj";0;0;0;0;NA;47252;0;2020-06-28;-53051
2020-06-27;"Trenčiansky kraj";0;0;0;0;NA;47252;0;2020-06-27;-53051
2020-06-26;"Trenčiansky kraj";0;0;0;0;NA;47252;0;2020-06-26;-53051
2020-06-25;"Trenčiansky kraj";2;0;0;0;NA;47252;2;2020-06-25;-53051
2020-06-24;"Trenčiansky kraj";1;0;0;0;NA;47252;1;2020-06-24;-53053
2020-06-23;"Trenčiansky kraj";0;0;0;0;NA;47252;0;2020-06-23;-53054
2020-06-22;"Trenčiansky kraj";0;0;0;0;NA;47252;0;2020-06-22;-53054
2020-06-21;"Trenčiansky kraj";0;0;0;0;NA;47252;0;2020-06-21;-53054
2020-06-20;"Trenčiansky kraj";0;0;0;0;NA;47252;0;2020-06-20;-53054
2020-06-19;"Trenčiansky kraj";0;0;0;0;NA;47252;0;2020-06-19;-53054
2020-06-18;"Trenčiansky kraj";0;0;0;0;NA;47252;0;2020-06-18;-53054
2020-06-17;"Trenčiansky kraj";0;0;0;0;NA;47252;0;2020-06-17;-53054
2020-06-16;"Trenčiansky kraj";0;0;0;0;NA;47252;0;2020-06-16;-53054
2020-06-14;"Trenčiansky kraj";0;0;0;0;NA;47252;0;2020-06-14;-53054
2020-06-13;"Trenčiansky kraj";0;0;0;0;NA;47252;0;2020-06-13;-53054
2020-06-12;"Trenčiansky kraj";0;0;0;0;NA;47252;0;2020-06-12;-53054
2020-06-11;"Trenčiansky kraj";0;0;0;0;NA;47252;0;2020-06-11;-53054
2020-06-10;"Trenčiansky kraj";1;0;0;0;NA;47252;1;2020-06-10;-53054
2020-06-09;"Trenčiansky kraj";0;0;0;0;NA;47252;0;2020-06-09;-53055
2020-06-08;"Trenčiansky kraj";0;0;0;0;NA;47252;0;2020-06-08;-53055
2020-06-07;"Trenčiansky kraj";0;0;0;0;NA;47252;0;2020-06-07;-53055
2020-06-05;"Trenčiansky kraj";0;0;0;0;NA;47252;0;2020-06-05;-53055
2020-06-03;"Trenčiansky kraj";0;0;0;0;NA;47252;0;2020-06-03;-53055
2020-06-02;"Trenčiansky kraj";0;0;0;0;NA;47252;0;2020-06-02;-53055
2020-05-31;"Trenčiansky kraj";0;0;0;0;NA;47252;0;2020-05-31;-53055
2020-05-29;"Trenčiansky kraj";0;0;0;0;NA;47252;0;2020-05-29;-53055
2020-05-27;"Trenčiansky kraj";2;0;0;0;NA;47252;2;2020-05-27;-53055
2020-05-26;"Trenčiansky kraj";0;0;0;0;NA;47252;0;2020-05-26;-53057
2020-05-25;"Trenčiansky kraj";0;0;0;0;NA;47252;0;2020-05-25;-53057
2020-05-24;"Trenčiansky kraj";0;0;0;0;NA;47252;0;2020-05-24;-53057
2020-05-23;"Trenčiansky kraj";0;0;0;0;NA;47252;0;2020-05-23;-53057
2020-05-22;"Trenčiansky kraj";0;0;0;0;NA;47252;0;2020-05-22;-53057
2020-05-21;"Trenčiansky kraj";0;0;0;0;NA;47252;0;2020-05-21;-53057
2020-05-20;"Trenčiansky kraj";0;0;0;0;NA;47252;0;2020-05-20;-53057
2020-05-19;"Trenčiansky kraj";0;0;0;0;NA;47252;0;2020-05-19;-53057
2020-05-17;"Trenčiansky kraj";0;0;0;0;NA;47252;0;2020-05-17;-53057
2020-05-16;"Trenčiansky kraj";0;0;0;0;NA;47252;0;2020-05-16;-53057
2020-05-15;"Trenčiansky kraj";1;0;0;0;NA;47252;1;2020-05-15;-53057
2020-05-14;"Trenčiansky kraj";2;0;0;0;NA;47252;2;2020-05-14;-53058
2020-05-13;"Trenčiansky kraj";1;0;0;0;NA;47252;1;2020-05-13;-53060
2020-05-12;"Trenčiansky kraj";1;0;0;0;NA;47252;1;2020-05-12;-53061
2020-05-11;"Trenčiansky kraj";3;0;0;0;NA;47252;3;2020-05-11;-53062
2020-05-09;"Trenčiansky kraj";2;0;0;0;NA;47252;2;2020-05-09;-53065
2020-05-07;"Trenčiansky kraj";6;0;0;0;NA;47252;6;2020-05-07;-53067
2020-05-06;"Trenčiansky kraj";0;0;0;0;NA;47252;0;2020-05-06;-53073
2020-05-05;"Trenčiansky kraj";2;0;0;0;NA;47252;2;2020-05-05;-53073
2020-05-04;"Trenčiansky kraj";0;0;0;0;NA;47252;0;2020-05-04;-53075
2020-05-03;"Trenčiansky kraj";0;0;0;0;NA;47252;0;2020-05-03;-53075
2020-05-02;"Trenčiansky kraj";0;0;0;0;NA;47252;0;2020-05-02;-53075
2020-05-01;"Trenčiansky kraj";0;0;0;0;NA;47252;0;2020-05-01;-53075
2020-04-30;"Trenčiansky kraj";0;0;0;0;NA;47252;0;2020-04-30;-53075
2020-04-29;"Trenčiansky kraj";2;0;0;0;NA;47252;2;2020-04-29;-53075
2020-04-28;"Trenčiansky kraj";1;0;0;0;NA;47252;1;2020-04-28;-53077
2020-04-27;"Trenčiansky kraj";0;0;0;0;NA;47252;0;2020-04-27;-53078
2020-04-26;"Trenčiansky kraj";1;0;0;0;NA;47252;1;2020-04-26;-53078
2020-04-25;"Trenčiansky kraj";0;0;0;0;NA;47252;0;2020-04-25;-53079
2020-04-24;"Trenčiansky kraj";0;0;0;0;NA;47252;0;2020-04-24;-53079
2020-04-23;"Trenčiansky kraj";11;0;0;0;NA;47252;11;2020-04-23;-53079
2020-04-22;"Trenčiansky kraj";1;0;0;0;NA;47252;1;2020-04-22;-53090
2020-04-21;"Trenčiansky kraj";11;0;0;0;NA;47252;11;2020-04-21;-53091
2020-04-20;"Trenčiansky kraj";15;0;0;0;NA;47252;15;2020-04-20;-53102
2020-04-19;"Trenčiansky kraj";2;0;0;0;NA;47252;2;2020-04-19;-53117
2020-04-18;"Trenčiansky kraj";3;0;0;0;NA;47252;3;2020-04-18;-53119
2020-04-17;"Trenčiansky kraj";4;0;0;0;NA;47252;4;2020-04-17;-53122
2020-04-16;"Trenčiansky kraj";10;0;0;0;NA;47252;10;2020-04-16;-53126
2020-04-15;"Trenčiansky kraj";4;0;0;0;NA;47252;4;2020-04-15;-53136
2020-04-14;"Trenčiansky kraj";0;0;0;0;NA;47252;0;2020-04-14;-53140
2020-04-13;"Trenčiansky kraj";1;0;0;0;NA;47252;1;2020-04-13;-53140
2020-04-12;"Trenčiansky kraj";2;0;0;0;NA;47252;2;2020-04-12;-53141
2020-04-11;"Trenčiansky kraj";3;0;0;0;NA;47252;3;2020-04-11;-53143
2020-04-10;"Trenčiansky kraj";0;0;0;0;NA;47252;0;2020-04-10;-53146
2020-04-09;"Trenčiansky kraj";0;0;0;0;NA;47252;0;2020-04-09;-53146
2020-04-08;"Trenčiansky kraj";2;0;0;0;NA;47252;2;2020-04-08;-53146
2020-04-07;"Trenčiansky kraj";18;0;0;0;NA;47252;18;2020-04-07;-53148
2020-04-06;"Trenčiansky kraj";0;0;0;0;NA;47252;0;2020-04-06;-53166
2020-04-05;"Trenčiansky kraj";3;0;0;0;NA;47252;3;2020-04-05;-53166
2020-04-04;"Trenčiansky kraj";5;0;0;0;NA;47252;5;2020-04-04;-53169
2020-04-03;"Trenčiansky kraj";4;0;0;0;NA;47252;4;2020-04-03;-53174
2020-04-02;"Trenčiansky kraj";1;0;0;0;NA;47252;1;2020-04-02;-53178
2020-04-01;"Trenčiansky kraj";3;0;0;0;NA;47252;3;2020-04-01;-53179
2020-03-31;"Trenčiansky kraj";1;0;0;0;NA;47252;1;2020-03-31;-53182
2020-03-30;"Trenčiansky kraj";3;0;0;0;NA;47252;3;2020-03-30;-53183
2020-03-29;"Trenčiansky kraj";6;0;0;0;NA;47252;6;2020-03-29;-53186
2020-03-28;"Trenčiansky kraj";9;0;0;0;NA;47252;9;2020-03-28;-53192
2020-03-27;"Trenčiansky kraj";2;0;0;0;NA;47252;2;2020-03-27;-53201
2020-03-26;"Trenčiansky kraj";6;0;0;0;NA;47252;6;2020-03-26;-53203
2020-03-25;"Trenčiansky kraj";3;0;0;0;NA;47252;3;2020-03-25;-53209
2020-03-24;"Trenčiansky kraj";1;0;0;0;NA;47252;1;2020-03-24;-53212
2020-03-23;"Trenčiansky kraj";0;0;0;0;NA;47252;0;2020-03-23;-53213
2020-03-22;"Trenčiansky kraj";0;0;0;0;NA;47252;0;2020-03-22;-53213
2020-03-21;"Trenčiansky kraj";2;0;0;0;NA;47252;2;2020-03-21;-53213
2020-03-20;"Trenčiansky kraj";2;0;0;0;NA;47252;2;2020-03-20;-53215
2020-03-19;"Trenčiansky kraj";8;0;0;0;NA;47252;8;2020-03-19;-53217
2020-03-18;"Trenčiansky kraj";0;0;0;0;NA;47252;0;2020-03-18;-53225
2020-03-17;"Trenčiansky kraj";0;0;0;0;NA;47252;0;2020-03-17;-53225
2020-03-16;"Trenčiansky kraj";1;0;0;0;NA;47252;1;2020-03-16;-53225
2020-03-15;"Trenčiansky kraj";5;0;0;0;NA;47252;5;2020-03-15;-53226
2020-03-14;"Trenčiansky kraj";0;0;0;0;NA;47252;0;2020-03-14;-53231
2020-03-13;"Trenčiansky kraj";0;0;0;0;NA;47252;0;2020-03-13;-53231
2020-03-12;"Trenčiansky kraj";1;0;0;0;NA;47252;1;2020-03-12;-53231
2020-03-11;"Trenčiansky kraj";0;0;0;0;NA;47252;0;2020-03-11;-53232
2020-03-09;"Trenčiansky kraj";0;0;0;0;NA;47252;0;2020-03-09;-53232
2020-03-08;"Trenčiansky kraj";0;0;0;0;NA;47252;0;2020-03-08;-53232
2020-03-07;"Trenčiansky kraj";0;0;0;0;NA;47252;0;2020-03-07;-53232
2020-03-06;"Trenčiansky kraj";0;0;0;0;NA;47252;0;2020-03-06;-53232
2021-06-22;"Trnavský kraj";2;1729;0;1729;0;44302;2;2021-06-22;44302
2021-06-21;"Trnavský kraj";6;2714;5;2719;NA;44302;11;2021-06-21;44300
2021-06-20;"Trnavský kraj";0;3955;1;3956;NA;44302;1;2021-06-20;44289
2021-06-19;"Trnavský kraj";3;4126;2;4128;NA;44302;5;2021-06-19;44288
2021-06-18;"Trnavský kraj";5;5314;4;5318;NA;44302;9;2021-06-18;44283
2021-06-17;"Trnavský kraj";3;3084;0;3084;NA;44302;3;2021-06-17;44274
2021-06-16;"Trnavský kraj";6;2632;3;2635;NA;44302;9;2021-06-16;44271
2021-06-15;"Trnavský kraj";8;2974;2;2976;NA;44302;10;2021-06-15;44262
2021-06-14;"Trnavský kraj";2;3521;1;3522;NA;44302;3;2021-06-14;44252
2021-06-13;"Trnavský kraj";0;5003;6;5009;NA;44302;6;2021-06-13;44249
2021-06-12;"Trnavský kraj";11;5536;1;5537;NA;44302;12;2021-06-12;44243
2021-06-11;"Trnavský kraj";17;5557;4;5561;NA;44302;21;2021-06-11;44231
2021-06-10;"Trnavský kraj";14;3336;1;3337;NA;44302;15;2021-06-10;44210
2021-06-09;"Trnavský kraj";10;3495;1;3496;NA;44302;11;2021-06-09;44195
2021-06-08;"Trnavský kraj";8;2887;4;2891;NA;44302;12;2021-06-08;44184
2021-06-07;"Trnavský kraj";12;4163;8;4171;NA;44302;20;2021-06-07;44172
2021-06-06;"Trnavský kraj";0;5517;2;5519;NA;44302;2;2021-06-06;44152
2021-06-05;"Trnavský kraj";20;6779;6;6785;NA;44302;26;2021-06-05;44150
2021-06-04;"Trnavský kraj";9;6359;9;6368;NA;44302;18;2021-06-04;44124
2021-06-03;"Trnavský kraj";14;3963;11;3974;NA;44302;25;2021-06-03;44106
2021-06-02;"Trnavský kraj";4;4104;12;4116;NA;44302;16;2021-06-02;44081
2021-06-01;"Trnavský kraj";18;3394;4;3398;NA;44302;22;2021-06-01;44065
2021-05-31;"Trnavský kraj";14;5089;16;5105;NA;44302;30;2021-05-31;44043
2021-05-30;"Trnavský kraj";0;6283;6;6289;NA;44302;6;2021-05-30;44013
2021-05-29;"Trnavský kraj";11;8409;4;8413;NA;44302;15;2021-05-29;44007
2021-05-28;"Trnavský kraj";14;6720;11;6731;NA;44302;25;2021-05-28;43992
2021-05-27;"Trnavský kraj";22;4753;8;4761;NA;44302;30;2021-05-27;43967
2021-05-26;"Trnavský kraj";6;4503;8;4511;NA;44302;14;2021-05-26;43937
2021-05-25;"Trnavský kraj";19;4610;25;4635;NA;44302;44;2021-05-25;43923
2021-05-24;"Trnavský kraj";15;6520;22;6542;NA;44302;37;2021-05-24;43879
2021-05-23;"Trnavský kraj";0;7767;8;7775;NA;44302;8;2021-05-23;43842
2021-05-22;"Trnavský kraj";13;12767;18;12785;NA;44302;31;2021-05-22;43834
2021-05-21;"Trnavský kraj";16;8079;19;8098;NA;44302;35;2021-05-21;43803
2021-05-20;"Trnavský kraj";15;5223;9;5232;NA;44302;24;2021-05-20;43768
2021-05-19;"Trnavský kraj";18;5159;12;5171;NA;44302;30;2021-05-19;43744
2021-05-18;"Trnavský kraj";26;5686;15;5701;NA;44302;41;2021-05-18;43714
2021-05-17;"Trnavský kraj";17;5985;23;6008;NA;44302;40;2021-05-17;43673
2021-05-16;"Trnavský kraj";10;9725;8;9733;NA;44302;18;2021-05-16;43633
2021-05-15;"Trnavský kraj";11;18040;14;18054;NA;44302;25;2021-05-15;43615
2021-05-14;"Trnavský kraj";34;9846;20;9866;NA;44302;54;2021-05-14;43590
2021-05-13;"Trnavský kraj";26;6913;12;6925;NA;44302;38;2021-05-13;43536
2021-05-12;"Trnavský kraj";34;6621;26;6647;NA;44302;60;2021-05-12;43498
2021-05-11;"Trnavský kraj";32;6311;13;6324;NA;44302;45;2021-05-11;43438
2021-05-10;"Trnavský kraj";58;8458;24;8482;NA;44302;82;2021-05-10;43393
2021-05-09;"Trnavský kraj";21;12312;11;12323;NA;44302;32;2021-05-09;43311
2021-05-08;"Trnavský kraj";4;22539;21;22560;NA;44302;25;2021-05-08;43279
2021-05-07;"Trnavský kraj";26;14895;29;14924;NA;44302;55;2021-05-07;43254
2021-05-06;"Trnavský kraj";22;8397;22;8419;NA;44302;44;2021-05-06;43199
2021-05-05;"Trnavský kraj";34;6127;20;6147;NA;44302;54;2021-05-05;43155
2021-05-04;"Trnavský kraj";51;8538;17;8555;NA;44302;68;2021-05-04;43101
2021-05-03;"Trnavský kraj";20;8954;22;8976;NA;44302;42;2021-05-03;43033
2021-05-02;"Trnavský kraj";0;25657;29;25686;NA;44302;29;2021-05-02;42991
2021-05-01;"Trnavský kraj";30;81347;64;81411;NA;44302;94;2021-05-01;42962
2021-04-30;"Trnavský kraj";45;26843;35;26878;NA;44302;80;2021-04-30;42868
2021-04-29;"Trnavský kraj";25;20323;28;20351;NA;44302;53;2021-04-29;42788
2021-04-28;"Trnavský kraj";46;8867;28;8895;NA;44302;74;2021-04-28;42735
2021-04-27;"Trnavský kraj";54;8744;37;8781;NA;44302;91;2021-04-27;42661
2021-04-26;"Trnavský kraj";53;16113;42;16155;NA;44302;95;2021-04-26;42570
2021-04-25;"Trnavský kraj";0;30183;24;30207;NA;44302;24;2021-04-25;42475
2021-04-24;"Trnavský kraj";46;125410;82;125492;NA;44302;128;2021-04-24;42451
2021-04-23;"Trnavský kraj";71;25622;53;25675;NA;44302;124;2021-04-23;42323
2021-04-22;"Trnavský kraj";40;10901;25;10926;NA;44302;65;2021-04-22;42199
2021-04-21;"Trnavský kraj";60;10728;45;10773;NA;44302;105;2021-04-21;42134
2021-04-20;"Trnavský kraj";57;13499;28;13527;NA;44302;85;2021-04-20;42029
2021-04-19;"Trnavský kraj";46;14584;18;14602;NA;44302;64;2021-04-19;41944
2021-04-18;"Trnavský kraj";7;40843;43;40886;NA;44302;50;2021-04-18;41880
2021-04-17;"Trnavský kraj";58;118094;89;118183;NA;44302;147;2021-04-17;41830
2021-04-16;"Trnavský kraj";67;25962;48;26010;NA;44302;115;2021-04-16;41683
2021-04-15;"Trnavský kraj";65;11373;36;11409;NA;44302;101;2021-04-15;41568
2021-04-14;"Trnavský kraj";78;18442;53;18495;NA;44302;131;2021-04-14;41467
2021-04-13;"Trnavský kraj";126;9831;44;9875;NA;44302;170;2021-04-13;41336
2021-04-12;"Trnavský kraj";40;15575;40;15615;NA;44302;80;2021-04-12;41166
2021-04-11;"Trnavský kraj";3;44417;44;44461;NA;44302;47;2021-04-11;41086
2021-04-10;"Trnavský kraj";60;123822;107;123929;NA;44302;167;2021-04-10;41039
2021-04-09;"Trnavský kraj";95;26084;34;26118;NA;44302;129;2021-04-09;40872
2021-04-08;"Trnavský kraj";85;10893;52;10945;NA;44302;137;2021-04-08;40743
2021-04-07;"Trnavský kraj";131;15964;81;16045;NA;44302;212;2021-04-07;40606
2021-04-06;"Trnavský kraj";92;20579;90;20669;NA;44302;182;2021-04-06;40394
2021-04-05;"Trnavský kraj";91;7517;17;7534;NA;44302;108;2021-04-05;40212
2021-04-04;"Trnavský kraj";9;28831;49;28880;NA;44302;58;2021-04-04;40104
2021-04-03;"Trnavský kraj";29;144077;186;144263;NA;44302;215;2021-04-03;40046
2021-04-02;"Trnavský kraj";91;17538;33;17571;NA;44302;124;2021-04-02;39831
2021-04-01;"Trnavský kraj";118;22027;69;22096;NA;44302;187;2021-04-01;39707
2021-03-31;"Trnavský kraj";140;15819;82;15901;NA;44302;222;2021-03-31;39520
2021-03-30;"Trnavský kraj";182;10482;79;10561;NA;44302;261;2021-03-30;39298
2021-03-29;"Trnavský kraj";126;19249;122;19371;NA;44302;248;2021-03-29;39037
2021-03-28;"Trnavský kraj";26;50792;134;50926;NA;44302;160;2021-03-28;38789
2021-03-27;"Trnavský kraj";64;129602;245;129847;NA;44302;309;2021-03-27;38629
2021-03-26;"Trnavský kraj";139;30217;130;30347;NA;44302;269;2021-03-26;38320
2021-03-25;"Trnavský kraj";135;14212;80;14292;NA;44302;215;2021-03-25;38051
2021-03-24;"Trnavský kraj";159;10521;89;10610;NA;44302;248;2021-03-24;37836
2021-03-23;"Trnavský kraj";221;12735;104;12839;NA;44302;325;2021-03-23;37588
2021-03-22;"Trnavský kraj";103;17068;110;17178;NA;44302;213;2021-03-22;37263
2021-03-21;"Trnavský kraj";31;49119;150;49269;NA;44302;181;2021-03-21;37050
2021-03-20;"Trnavský kraj";112;136963;317;137280;NA;44302;429;2021-03-20;36869
2021-03-19;"Trnavský kraj";174;29071;137;29208;NA;44302;311;2021-03-19;36440
2021-03-18;"Trnavský kraj";158;12217;136;12353;NA;44302;294;2021-03-18;36129
2021-03-17;"Trnavský kraj";245;10434;103;10537;NA;44302;348;2021-03-17;35835
2021-03-16;"Trnavský kraj";311;12811;135;12946;NA;44302;446;2021-03-16;35487
2021-03-15;"Trnavský kraj";127;18678;146;18824;NA;44302;273;2021-03-15;35041
2021-03-14;"Trnavský kraj";14;47608;164;47772;NA;44302;178;2021-03-14;34768
2021-03-13;"Trnavský kraj";155;139224;409;139633;NA;44302;564;2021-03-13;34590
2021-03-12;"Trnavský kraj";201;28559;181;28740;NA;44302;382;2021-03-12;34026
2021-03-11;"Trnavský kraj";204;13285;140;13425;NA;44302;344;2021-03-11;33644
2021-03-10;"Trnavský kraj";242;10583;135;10718;NA;44302;377;2021-03-10;33300
2021-03-09;"Trnavský kraj";442;12820;155;12975;NA;44302;597;2021-03-09;32923
2021-03-08;"Trnavský kraj";182;21825;166;21991;NA;44302;348;2021-03-08;32326
2021-03-07;"Trnavský kraj";30;45463;227;45690;NA;44302;257;2021-03-07;31978
2021-03-06;"Trnavský kraj";154;135635;531;136166;NA;44302;685;2021-03-06;31721
2021-03-05;"Trnavský kraj";299;27951;239;28190;NA;44302;538;2021-03-05;31036
2021-03-04;"Trnavský kraj";238;14489;175;14664;NA;44302;413;2021-03-04;30498
2021-03-03;"Trnavský kraj";413;11566;246;11812;NA;44302;659;2021-03-03;30085
2021-03-02;"Trnavský kraj";477;12347;191;12538;NA;44302;668;2021-03-02;29426
2021-03-01;"Trnavský kraj";189;18581;234;18815;NA;44302;423;2021-03-01;28758
2021-02-28;"Trnavský kraj";87;47709;321;48030;NA;44302;408;2021-02-28;28335
2021-02-27;"Trnavský kraj";264;140224;800;141024;NA;44302;1064;2021-02-27;27927
2021-02-26;"Trnavský kraj";362;26815;286;27101;NA;44302;648;2021-02-26;26863
2021-02-25;"Trnavský kraj";433;10490;227;10717;NA;44302;660;2021-02-25;26215
2021-02-24;"Trnavský kraj";407;9110;290;9400;NA;44302;697;2021-02-24;25555
2021-02-23;"Trnavský kraj";469;11322;284;11606;NA;44302;753;2021-02-23;24858
2021-02-22;"Trnavský kraj";206;19896;330;20226;NA;44302;536;2021-02-22;24105
2021-02-21;"Trnavský kraj";38;48221;329;48550;NA;44302;367;2021-02-21;23569
2021-02-20;"Trnavský kraj";273;135835;859;136694;NA;44302;1132;2021-02-20;23202
2021-02-19;"Trnavský kraj";335;26339;347;26686;NA;44302;682;2021-02-19;22070
2021-02-18;"Trnavský kraj";344;11263;348;11611;NA;44302;692;2021-02-18;21388
2021-02-17;"Trnavský kraj";431;8781;416;9197;NA;44302;847;2021-02-17;20696
2021-02-16;"Trnavský kraj";426;11411;295;11706;NA;44302;721;2021-02-16;19849
2021-02-15;"Trnavský kraj";146;18075;291;18366;NA;44302;437;2021-02-15;19128
2021-02-14;"Trnavský kraj";51;57642;495;58137;NA;44302;546;2021-02-14;18691
2021-02-13;"Trnavský kraj";218;137051;994;138045;NA;44302;1212;2021-02-13;18145
2021-02-12;"Trnavský kraj";300;23682;336;24018;NA;44302;636;2021-02-12;16933
2021-02-11;"Trnavský kraj";422;9816;349;10165;NA;44302;771;2021-02-11;16297
2021-02-10;"Trnavský kraj";511;9334;344;9678;NA;44302;855;2021-02-10;15526
2021-02-09;"Trnavský kraj";544;12752;369;13121;NA;44302;913;2021-02-09;14671
2021-02-08;"Trnavský kraj";220;33539;498;34037;NA;44302;718;2021-02-08;13758
2021-02-07;"Trnavský kraj";140;68646;623;69269;NA;44302;763;2021-02-07;13040
2021-02-06;"Trnavský kraj";348;112687;1482;114169;NA;44302;1830;2021-02-06;12277
2021-02-05;"Trnavský kraj";377;16063;373;16436;NA;44302;750;2021-02-05;10447
2021-02-04;"Trnavský kraj";456;7317;456;7773;NA;44302;912;2021-02-04;9697
2021-02-03;"Trnavský kraj";472;6584;434;7018;NA;44302;906;2021-02-03;8785
2021-02-02;"Trnavský kraj";446;14240;424;14664;NA;44302;870;2021-02-02;7879
2021-02-01;"Trnavský kraj";198;38882;679;39561;NA;44302;877;2021-02-01;7009
2021-01-31;"Trnavský kraj";19;64673;817;65490;NA;44302;836;2021-01-31;6132
2021-01-30;"Trnavský kraj";323;111483;1288;112771;NA;44302;1611;2021-01-30;5296
2021-01-29;"Trnavský kraj";421;9690;290;9980;NA;44302;711;2021-01-29;3685
2021-01-28;"Trnavský kraj";389;5815;286;6101;NA;44302;675;2021-01-28;2974
2021-01-27;"Trnavský kraj";433;5300;219;5519;NA;44302;652;2021-01-27;2299
2021-01-26;"Trnavský kraj";565;25392;636;26028;NA;44302;1201;2021-01-26;1647
2021-01-25;"Trnavský kraj";210;41420;607;42027;NA;44302;817;2021-01-25;446
2021-01-24;"Trnavský kraj";91;66399;779;67178;NA;44302;870;2021-01-24;-371
2021-01-23;"Trnavský kraj";372;117640;1349;118989;NA;44302;1721;2021-01-23;-1241
2021-01-22;"Trnavský kraj";217;33122;507;33629;NA;44302;724;2021-01-22;-2962
2021-01-21;"Trnavský kraj";311;13922;378;14300;NA;44302;689;2021-01-21;-3686
2021-01-20;"Trnavský kraj";503;8118;274;8392;NA;44302;777;2021-01-20;-4375
2021-01-19;"Trnavský kraj";415;7013;347;7360;NA;44302;762;2021-01-19;-5152
2021-01-18;"Trnavský kraj";247;6234;484;6718;NA;44302;731;2021-01-18;-5914
2021-01-17;"Trnavský kraj";128;854;215;1069;NA;44302;343;2021-01-17;-6645
2021-01-16;"Trnavský kraj";103;898;24;922;NA;44302;127;2021-01-16;-6988
2021-01-15;"Trnavský kraj";278;5457;335;5792;NA;44302;613;2021-01-15;-7115
2021-01-14;"Trnavský kraj";452;4001;338;4339;NA;44302;790;2021-01-14;-7728
2021-01-13;"Trnavský kraj";457;4751;378;5129;NA;44302;835;2021-01-13;-8518
2021-01-12;"Trnavský kraj";469;7175;483;7658;NA;44302;952;2021-01-12;-9353
2021-01-11;"Trnavský kraj";370;5012;392;5404;NA;44302;762;2021-01-11;-10305
2021-01-10;"Trnavský kraj";71;13;0;13;NA;44302;71;2021-01-10;-11067
2021-01-09;"Trnavský kraj";417;1775;100;1875;NA;44302;517;2021-01-09;-11138
2021-01-08;"Trnavský kraj";381;6554;532;7086;NA;44302;913;2021-01-08;-11655
2021-01-07;"Trnavský kraj";501;4080;390;4470;NA;44302;891;2021-01-07;-12568
2021-01-06;"Trnavský kraj";179;758;132;890;NA;44302;311;2021-01-06;-13459
2021-01-05;"Trnavský kraj";611;5925;636;6561;NA;44302;1247;2021-01-05;-13770
2021-01-04;"Trnavský kraj";302;5239;689;5928;NA;44302;991;2021-01-04;-15017
2021-01-03;"Trnavský kraj";60;53;7;60;NA;44302;67;2021-01-03;-16008
2021-01-02;"Trnavský kraj";282;417;32;449;NA;44302;314;2021-01-02;-16075
2021-01-01;"Trnavský kraj";143;455;76;531;NA;44302;219;2021-01-01;-16389
2020-12-31;"Trnavský kraj";498;8488;858;9346;NA;44302;1356;2020-12-31;-16608
2020-12-30;"Trnavský kraj";785;5318;612;5930;NA;44302;1397;2020-12-30;-17964
2020-12-29;"Trnavský kraj";322;5364;639;6003;NA;44302;961;2020-12-29;-19361
2020-12-28;"Trnavský kraj";213;5334;615;5949;NA;44302;828;2020-12-28;-20322
2020-12-27;"Trnavský kraj";27;20;4;24;NA;44302;31;2020-12-27;-21150
2020-12-26;"Trnavský kraj";148;44;1;45;NA;44302;149;2020-12-26;-21181
2020-12-25;"Trnavský kraj";65;49;5;54;NA;44302;70;2020-12-25;-21330
2020-12-24;"Trnavský kraj";333;1359;117;1476;NA;44302;450;2020-12-24;-21400
2020-12-23;"Trnavský kraj";210;7259;414;7673;NA;44302;624;2020-12-23;-21850
2020-12-22;"Trnavský kraj";311;5590;491;6081;NA;44302;802;2020-12-22;-22474
2020-12-21;"Trnavský kraj";328;4527;399;4926;NA;44302;727;2020-12-21;-23276
2020-12-20;"Trnavský kraj";134;133;12;145;NA;44302;146;2020-12-20;-24003
2020-12-19;"Trnavský kraj";201;1407;103;1510;NA;44302;304;2020-12-19;-24149
2020-12-18;"Trnavský kraj";341;4898;378;5276;NA;44302;719;2020-12-18;-24453
2020-12-17;"Trnavský kraj";375;5271;443;5714;NA;44302;818;2020-12-17;-25172
2020-12-16;"Trnavský kraj";312;5249;405;5654;NA;44302;717;2020-12-16;-25990
2020-12-15;"Trnavský kraj";492;6623;632;7255;NA;44302;1124;2020-12-15;-26707
2020-12-14;"Trnavský kraj";161;3505;292;3797;NA;44302;453;2020-12-14;-27831
2020-12-13;"Trnavský kraj";7;7;0;7;NA;44302;7;2020-12-13;-28284
2020-12-12;"Trnavský kraj";254;1456;114;1570;NA;44302;368;2020-12-12;-28291
2020-12-11;"Trnavský kraj";384;4683;262;4945;NA;44302;646;2020-12-11;-28659
2020-12-10;"Trnavský kraj";183;5194;320;5514;NA;44302;503;2020-12-10;-29305
2020-12-09;"Trnavský kraj";521;4283;321;4604;NA;44302;842;2020-12-09;-29808
2020-12-08;"Trnavský kraj";281;4090;304;4394;NA;44302;585;2020-12-08;-30650
2020-12-07;"Trnavský kraj";178;2895;199;3094;NA;44302;377;2020-12-07;-31235
2020-12-06;"Trnavský kraj";46;0;0;0;NA;44302;46;2020-12-06;-31612
2020-12-05;"Trnavský kraj";129;2218;41;2259;NA;44302;170;2020-12-05;-31658
2020-12-04;"Trnavský kraj";242;3948;158;4106;NA;44302;400;2020-12-04;-31828
2020-12-03;"Trnavský kraj";248;2770;190;2960;NA;44302;438;2020-12-03;-32228
2020-12-02;"Trnavský kraj";284;4516;176;4692;NA;44302;460;2020-12-02;-32666
2020-12-01;"Trnavský kraj";253;3190;205;3395;NA;44302;458;2020-12-01;-33126
2020-11-30;"Trnavský kraj";200;7360;186;7546;NA;44302;386;2020-11-30;-33584
2020-11-29;"Trnavský kraj";17;738;36;774;NA;44302;53;2020-11-29;-33970
2020-11-28;"Trnavský kraj";83;1453;77;1530;NA;44302;160;2020-11-28;-34023
2020-11-27;"Trnavský kraj";148;1779;85;1864;NA;44302;233;2020-11-27;-34183
2020-11-26;"Trnavský kraj";234;1123;68;1191;NA;44302;302;2020-11-26;-34416
2020-11-25;"Trnavský kraj";232;1168;74;1242;NA;44302;306;2020-11-25;-34718
2020-11-24;"Trnavský kraj";295;1909;96;2005;NA;44302;391;2020-11-24;-35024
2020-11-23;"Trnavský kraj";242;7393;129;7522;NA;44302;371;2020-11-23;-35415
2020-11-22;"Trnavský kraj";10;82;9;91;NA;44302;19;2020-11-22;-35786
2020-11-21;"Trnavský kraj";129;1354;36;1390;NA;44302;165;2020-11-21;-35805
2020-11-20;"Trnavský kraj";246;1154;64;1218;NA;44302;310;2020-11-20;-35970
2020-11-19;"Trnavský kraj";157;823;64;887;NA;44302;221;2020-11-19;-36280
2020-11-18;"Trnavský kraj";235;822;82;904;NA;44302;317;2020-11-18;-36501
2020-11-17;"Trnavský kraj";129;705;74;779;NA;44302;203;2020-11-17;-36818
2020-11-16;"Trnavský kraj";187;732;32;764;NA;44302;219;2020-11-16;-37021
2020-11-15;"Trnavský kraj";23;73;4;77;NA;44302;27;2020-11-15;-37240
2020-11-14;"Trnavský kraj";86;397;12;409;NA;44302;98;2020-11-14;-37267
2020-11-13;"Trnavský kraj";219;1312;21;1333;NA;44302;240;2020-11-13;-37365
2020-11-12;"Trnavský kraj";162;420;18;438;NA;44302;180;2020-11-12;-37605
2020-11-11;"Trnavský kraj";257;392;15;407;NA;44302;272;2020-11-11;-37785
2020-11-10;"Trnavský kraj";189;889;30;919;NA;44302;219;2020-11-10;-38057
2020-11-09;"Trnavský kraj";196;369;23;392;NA;44302;219;2020-11-09;-38276
2020-11-08;"Trnavský kraj";55;400;4;404;NA;44302;59;2020-11-08;-38495
2020-11-07;"Trnavský kraj";207;6070;74;6144;NA;44302;281;2020-11-07;-38554
2020-11-06;"Trnavský kraj";260;1531;19;1550;NA;44302;279;2020-11-06;-38835
2020-11-05;"Trnavský kraj";150;220;27;247;NA;44302;177;2020-11-05;-39114
2020-11-04;"Trnavský kraj";188;212;10;222;NA;44302;198;2020-11-04;-39291
2020-11-03;"Trnavský kraj";317;127;8;135;NA;44302;325;2020-11-03;-39489
2020-11-02;"Trnavský kraj";281;1728;31;1759;NA;44302;312;2020-11-02;-39814
2020-11-01;"Trnavský kraj";87;494;27;521;NA;44302;114;2020-11-01;-40126
2020-10-31;"Trnavský kraj";259;5024;41;5065;NA;44302;300;2020-10-31;-40240
2020-10-30;"Trnavský kraj";198;3784;27;3811;NA;44302;225;2020-10-30;-40540
2020-10-29;"Trnavský kraj";273;1461;16;1477;NA;44302;289;2020-10-29;-40765
2020-10-28;"Trnavský kraj";319;117;16;133;NA;44302;335;2020-10-28;-41054
2020-10-27;"Trnavský kraj";199;461;36;497;NA;44302;235;2020-10-27;-41389
2020-10-26;"Trnavský kraj";153;29;2;31;NA;44302;155;2020-10-26;-41624
2020-10-25;"Trnavský kraj";95;19;1;20;NA;44302;96;2020-10-25;-41779
2020-10-24;"Trnavský kraj";158;109;2;111;NA;44302;160;2020-10-24;-41875
2020-10-23;"Trnavský kraj";201;89;4;93;NA;44302;205;2020-10-23;-42035
2020-10-22;"Trnavský kraj";195;55;2;57;NA;44302;197;2020-10-22;-42240
2020-10-21;"Trnavský kraj";134;73;3;76;NA;44302;137;2020-10-21;-42437
2020-10-20;"Trnavský kraj";202;82;3;85;NA;44302;205;2020-10-20;-42574
2020-10-19;"Trnavský kraj";67;55;0;55;NA;44302;67;2020-10-19;-42779
2020-10-18;"Trnavský kraj";84;0;0;0;NA;44302;84;2020-10-18;-42846
2020-10-17;"Trnavský kraj";123;0;0;0;NA;44302;123;2020-10-17;-42930
2020-10-16;"Trnavský kraj";86;45;2;47;NA;44302;88;2020-10-16;-43053
2020-10-15;"Trnavský kraj";155;66;2;68;NA;44302;157;2020-10-15;-43141
2020-10-14;"Trnavský kraj";236;468;3;471;NA;44302;239;2020-10-14;-43298
2020-10-13;"Trnavský kraj";138;16;2;18;NA;44302;140;2020-10-13;-43537
2020-10-12;"Trnavský kraj";33;41;1;42;NA;44302;34;2020-10-12;-43677
2020-10-11;"Trnavský kraj";31;0;0;0;NA;44302;31;2020-10-11;-43711
2020-10-10;"Trnavský kraj";128;0;0;0;NA;44302;128;2020-10-10;-43742
2020-10-09;"Trnavský kraj";156;0;0;0;NA;44302;156;2020-10-09;-43870
2020-10-08;"Trnavský kraj";153;0;0;0;NA;44302;153;2020-10-08;-44026
2020-10-07;"Trnavský kraj";80;0;0;0;NA;44302;80;2020-10-07;-44179
2020-10-06;"Trnavský kraj";112;0;0;0;NA;44302;112;2020-10-06;-44259
2020-10-05;"Trnavský kraj";33;0;0;0;NA;44302;33;2020-10-05;-44371
2020-10-04;"Trnavský kraj";44;0;0;0;NA;44302;44;2020-10-04;-44404
2020-10-03;"Trnavský kraj";60;0;0;0;NA;44302;60;2020-10-03;-44448
2020-10-02;"Trnavský kraj";41;0;0;0;NA;44302;41;2020-10-02;-44508
2020-10-01;"Trnavský kraj";53;0;0;0;NA;44302;53;2020-10-01;-44549
2020-09-30;"Trnavský kraj";91;0;0;0;NA;44302;91;2020-09-30;-44602
2020-09-29;"Trnavský kraj";40;0;0;0;NA;44302;40;2020-09-29;-44693
2020-09-28;"Trnavský kraj";69;0;0;0;NA;44302;69;2020-09-28;-44733
2020-09-27;"Trnavský kraj";30;0;0;0;NA;44302;30;2020-09-27;-44802
2020-09-26;"Trnavský kraj";46;0;0;0;NA;44302;46;2020-09-26;-44832
2020-09-25;"Trnavský kraj";32;0;0;0;NA;44302;32;2020-09-25;-44878
2020-09-24;"Trnavský kraj";42;0;0;0;NA;44302;42;2020-09-24;-44910
2020-09-23;"Trnavský kraj";43;0;0;0;NA;44302;43;2020-09-23;-44952
2020-09-22;"Trnavský kraj";55;0;0;0;NA;44302;55;2020-09-22;-44995
2020-09-21;"Trnavský kraj";41;0;0;0;NA;44302;41;2020-09-21;-45050
2020-09-20;"Trnavský kraj";17;0;0;0;NA;44302;17;2020-09-20;-45091
2020-09-19;"Trnavský kraj";4;0;0;0;NA;44302;4;2020-09-19;-45108
2020-09-18;"Trnavský kraj";33;0;0;0;NA;44302;33;2020-09-18;-45112
2020-09-17;"Trnavský kraj";42;0;0;0;NA;44302;42;2020-09-17;-45145
2020-09-16;"Trnavský kraj";49;0;0;0;NA;44302;49;2020-09-16;-45187
2020-09-15;"Trnavský kraj";5;0;0;0;NA;44302;5;2020-09-15;-45236
2020-09-14;"Trnavský kraj";26;0;0;0;NA;44302;26;2020-09-14;-45241
2020-09-13;"Trnavský kraj";9;0;0;0;NA;44302;9;2020-09-13;-45267
2020-09-12;"Trnavský kraj";12;0;0;0;NA;44302;12;2020-09-12;-45276
2020-09-11;"Trnavský kraj";16;0;0;0;NA;44302;16;2020-09-11;-45288
2020-09-10;"Trnavský kraj";32;0;0;0;NA;44302;32;2020-09-10;-45304
2020-09-09;"Trnavský kraj";14;0;0;0;NA;44302;14;2020-09-09;-45336
2020-09-08;"Trnavský kraj";11;0;0;0;NA;44302;11;2020-09-08;-45350
2020-09-07;"Trnavský kraj";7;0;0;0;NA;44302;7;2020-09-07;-45361
2020-09-06;"Trnavský kraj";5;0;0;0;NA;44302;5;2020-09-06;-45368
2020-09-05;"Trnavský kraj";7;0;0;0;NA;44302;7;2020-09-05;-45373
2020-09-04;"Trnavský kraj";16;0;0;0;NA;44302;16;2020-09-04;-45380
2020-09-03;"Trnavský kraj";8;0;0;0;NA;44302;8;2020-09-03;-45396
2020-09-02;"Trnavský kraj";7;0;0;0;NA;44302;7;2020-09-02;-45404
2020-09-01;"Trnavský kraj";1;0;0;0;NA;44302;1;2020-09-01;-45411
2020-08-31;"Trnavský kraj";6;0;0;0;NA;44302;6;2020-08-31;-45412
2020-08-30;"Trnavský kraj";1;0;0;0;NA;44302;1;2020-08-30;-45418
2020-08-29;"Trnavský kraj";3;0;0;0;NA;44302;3;2020-08-29;-45419
2020-08-28;"Trnavský kraj";14;0;0;0;NA;44302;14;2020-08-28;-45422
2020-08-27;"Trnavský kraj";6;0;0;0;NA;44302;6;2020-08-27;-45436
2020-08-26;"Trnavský kraj";4;0;0;0;NA;44302;4;2020-08-26;-45442
2020-08-25;"Trnavský kraj";7;0;0;0;NA;44302;7;2020-08-25;-45446
2020-08-24;"Trnavský kraj";1;0;0;0;NA;44302;1;2020-08-24;-45453
2020-08-23;"Trnavský kraj";6;0;0;0;NA;44302;6;2020-08-23;-45454
2020-08-22;"Trnavský kraj";3;0;0;0;NA;44302;3;2020-08-22;-45460
2020-08-21;"Trnavský kraj";4;0;0;0;NA;44302;4;2020-08-21;-45463
2020-08-20;"Trnavský kraj";23;0;0;0;NA;44302;23;2020-08-20;-45467
2020-08-19;"Trnavský kraj";13;0;0;0;NA;44302;13;2020-08-19;-45490
2020-08-18;"Trnavský kraj";20;0;0;0;NA;44302;20;2020-08-18;-45503
2020-08-17;"Trnavský kraj";3;0;0;0;NA;44302;3;2020-08-17;-45523
2020-08-16;"Trnavský kraj";0;0;0;0;NA;44302;0;2020-08-16;-45526
2020-08-15;"Trnavský kraj";7;0;0;0;NA;44302;7;2020-08-15;-45526
2020-08-14;"Trnavský kraj";6;0;0;0;NA;44302;6;2020-08-14;-45533
2020-08-13;"Trnavský kraj";10;0;0;0;NA;44302;10;2020-08-13;-45539
2020-08-12;"Trnavský kraj";2;0;0;0;NA;44302;2;2020-08-12;-45549
2020-08-11;"Trnavský kraj";30;0;0;0;NA;44302;30;2020-08-11;-45551
2020-08-10;"Trnavský kraj";0;0;0;0;NA;44302;0;2020-08-10;-45581
2020-08-09;"Trnavský kraj";0;0;0;0;NA;44302;0;2020-08-09;-45581
2020-08-08;"Trnavský kraj";13;0;0;0;NA;44302;13;2020-08-08;-45581
2020-08-07;"Trnavský kraj";4;0;0;0;NA;44302;4;2020-08-07;-45594
2020-08-06;"Trnavský kraj";4;0;0;0;NA;44302;4;2020-08-06;-45598
2020-08-05;"Trnavský kraj";0;0;0;0;NA;44302;0;2020-08-05;-45602
2020-08-04;"Trnavský kraj";1;0;0;0;NA;44302;1;2020-08-04;-45602
2020-08-03;"Trnavský kraj";2;0;0;0;NA;44302;2;2020-08-03;-45603
2020-08-02;"Trnavský kraj";1;0;0;0;NA;44302;1;2020-08-02;-45605
2020-08-01;"Trnavský kraj";0;0;0;0;NA;44302;0;2020-08-01;-45606
2020-07-31;"Trnavský kraj";7;0;0;0;NA;44302;7;2020-07-31;-45606
2020-07-30;"Trnavský kraj";6;0;0;0;NA;44302;6;2020-07-30;-45613
2020-07-29;"Trnavský kraj";0;0;0;0;NA;44302;0;2020-07-29;-45619
2020-07-28;"Trnavský kraj";1;0;0;0;NA;44302;1;2020-07-28;-45619
2020-07-27;"Trnavský kraj";2;0;0;0;NA;44302;2;2020-07-27;-45620
2020-07-26;"Trnavský kraj";0;0;0;0;NA;44302;0;2020-07-26;-45622
2020-07-25;"Trnavský kraj";0;0;0;0;NA;44302;0;2020-07-25;-45622
2020-07-24;"Trnavský kraj";1;0;0;0;NA;44302;1;2020-07-24;-45622
2020-07-23;"Trnavský kraj";2;0;0;0;NA;44302;2;2020-07-23;-45623
2020-07-22;"Trnavský kraj";1;0;0;0;NA;44302;1;2020-07-22;-45625
2020-07-21;"Trnavský kraj";2;0;0;0;NA;44302;2;2020-07-21;-45626
2020-07-20;"Trnavský kraj";0;0;0;0;NA;44302;0;2020-07-20;-45628
2020-07-19;"Trnavský kraj";0;0;0;0;NA;44302;0;2020-07-19;-45628
2020-07-18;"Trnavský kraj";0;0;0;0;NA;44302;0;2020-07-18;-45628
2020-07-17;"Trnavský kraj";0;0;0;0;NA;44302;0;2020-07-17;-45628
2020-07-16;"Trnavský kraj";0;0;0;0;NA;44302;0;2020-07-16;-45628
2020-07-15;"Trnavský kraj";1;0;0;0;NA;44302;1;2020-07-15;-45628
2020-07-14;"Trnavský kraj";0;0;0;0;NA;44302;0;2020-07-14;-45629
2020-07-13;"Trnavský kraj";0;0;0;0;NA;44302;0;2020-07-13;-45629
2020-07-12;"Trnavský kraj";0;0;0;0;NA;44302;0;2020-07-12;-45629
2020-07-11;"Trnavský kraj";0;0;0;0;NA;44302;0;2020-07-11;-45629
2020-07-10;"Trnavský kraj";0;0;0;0;NA;44302;0;2020-07-10;-45629
2020-07-09;"Trnavský kraj";0;0;0;0;NA;44302;0;2020-07-09;-45629
2020-07-08;"Trnavský kraj";3;0;0;0;NA;44302;3;2020-07-08;-45629
2020-07-07;"Trnavský kraj";4;0;0;0;NA;44302;4;2020-07-07;-45632
2020-07-06;"Trnavský kraj";0;0;0;0;NA;44302;0;2020-07-06;-45636
2020-07-05;"Trnavský kraj";0;0;0;0;NA;44302;0;2020-07-05;-45636
2020-07-04;"Trnavský kraj";0;0;0;0;NA;44302;0;2020-07-04;-45636
2020-07-03;"Trnavský kraj";0;0;0;0;NA;44302;0;2020-07-03;-45636
2020-07-02;"Trnavský kraj";3;0;0;0;NA;44302;3;2020-07-02;-45636
2020-07-01;"Trnavský kraj";0;0;0;0;NA;44302;0;2020-07-01;-45639
2020-06-30;"Trnavský kraj";0;0;0;0;NA;44302;0;2020-06-30;-45639
2020-06-29;"Trnavský kraj";0;0;0;0;NA;44302;0;2020-06-29;-45639
2020-06-28;"Trnavský kraj";0;0;0;0;NA;44302;0;2020-06-28;-45639
2020-06-27;"Trnavský kraj";0;0;0;0;NA;44302;0;2020-06-27;-45639
2020-06-26;"Trnavský kraj";0;0;0;0;NA;44302;0;2020-06-26;-45639
2020-06-25;"Trnavský kraj";0;0;0;0;NA;44302;0;2020-06-25;-45639
2020-06-24;"Trnavský kraj";0;0;0;0;NA;44302;0;2020-06-24;-45639
2020-06-23;"Trnavský kraj";0;0;0;0;NA;44302;0;2020-06-23;-45639
2020-06-22;"Trnavský kraj";0;0;0;0;NA;44302;0;2020-06-22;-45639
2020-06-21;"Trnavský kraj";0;0;0;0;NA;44302;0;2020-06-21;-45639
2020-06-20;"Trnavský kraj";0;0;0;0;NA;44302;0;2020-06-20;-45639
2020-06-19;"Trnavský kraj";0;0;0;0;NA;44302;0;2020-06-19;-45639
2020-06-18;"Trnavský kraj";2;0;0;0;NA;44302;2;2020-06-18;-45639
2020-06-17;"Trnavský kraj";0;0;0;0;NA;44302;0;2020-06-17;-45641
2020-06-16;"Trnavský kraj";0;0;0;0;NA;44302;0;2020-06-16;-45641
2020-06-14;"Trnavský kraj";0;0;0;0;NA;44302;0;2020-06-14;-45641
2020-06-13;"Trnavský kraj";0;0;0;0;NA;44302;0;2020-06-13;-45641
2020-06-12;"Trnavský kraj";0;0;0;0;NA;44302;0;2020-06-12;-45641
2020-06-11;"Trnavský kraj";0;0;0;0;NA;44302;0;2020-06-11;-45641
2020-06-10;"Trnavský kraj";0;0;0;0;NA;44302;0;2020-06-10;-45641
2020-06-09;"Trnavský kraj";0;0;0;0;NA;44302;0;2020-06-09;-45641
2020-06-08;"Trnavský kraj";0;0;0;0;NA;44302;0;2020-06-08;-45641
2020-06-07;"Trnavský kraj";0;0;0;0;NA;44302;0;2020-06-07;-45641
2020-06-05;"Trnavský kraj";0;0;0;0;NA;44302;0;2020-06-05;-45641
2020-06-03;"Trnavský kraj";0;0;0;0;NA;44302;0;2020-06-03;-45641
2020-06-02;"Trnavský kraj";0;0;0;0;NA;44302;0;2020-06-02;-45641
2020-05-31;"Trnavský kraj";0;0;0;0;NA;44302;0;2020-05-31;-45641
2020-05-29;"Trnavský kraj";0;0;0;0;NA;44302;0;2020-05-29;-45641
2020-05-27;"Trnavský kraj";0;0;0;0;NA;44302;0;2020-05-27;-45641
2020-05-26;"Trnavský kraj";0;0;0;0;NA;44302;0;2020-05-26;-45641
2020-05-25;"Trnavský kraj";1;0;0;0;NA;44302;1;2020-05-25;-45641
2020-05-24;"Trnavský kraj";0;0;0;0;NA;44302;0;2020-05-24;-45642
2020-05-23;"Trnavský kraj";2;0;0;0;NA;44302;2;2020-05-23;-45642
2020-05-22;"Trnavský kraj";0;0;0;0;NA;44302;0;2020-05-22;-45644
2020-05-21;"Trnavský kraj";0;0;0;0;NA;44302;0;2020-05-21;-45644
2020-05-20;"Trnavský kraj";2;0;0;0;NA;44302;2;2020-05-20;-45644
2020-05-19;"Trnavský kraj";0;0;0;0;NA;44302;0;2020-05-19;-45646
2020-05-17;"Trnavský kraj";0;0;0;0;NA;44302;0;2020-05-17;-45646
2020-05-16;"Trnavský kraj";0;0;0;0;NA;44302;0;2020-05-16;-45646
2020-05-15;"Trnavský kraj";1;0;0;0;NA;44302;1;2020-05-15;-45646
2020-05-14;"Trnavský kraj";0;0;0;0;NA;44302;0;2020-05-14;-45647
2020-05-13;"Trnavský kraj";0;0;0;0;NA;44302;0;2020-05-13;-45647
2020-05-12;"Trnavský kraj";0;0;0;0;NA;44302;0;2020-05-12;-45647
2020-05-11;"Trnavský kraj";2;0;0;0;NA;44302;2;2020-05-11;-45647
2020-05-09;"Trnavský kraj";0;0;0;0;NA;44302;0;2020-05-09;-45649
2020-05-07;"Trnavský kraj";0;0;0;0;NA;44302;0;2020-05-07;-45649
2020-05-06;"Trnavský kraj";0;0;0;0;NA;44302;0;2020-05-06;-45649
2020-05-05;"Trnavský kraj";0;0;0;0;NA;44302;0;2020-05-05;-45649
2020-05-04;"Trnavský kraj";0;0;0;0;NA;44302;0;2020-05-04;-45649
2020-05-03;"Trnavský kraj";0;0;0;0;NA;44302;0;2020-05-03;-45649
2020-05-02;"Trnavský kraj";0;0;0;0;NA;44302;0;2020-05-02;-45649
2020-05-01;"Trnavský kraj";0;0;0;0;NA;44302;0;2020-05-01;-45649
2020-04-30;"Trnavský kraj";0;0;0;0;NA;44302;0;2020-04-30;-45649
2020-04-29;"Trnavský kraj";0;0;0;0;NA;44302;0;2020-04-29;-45649
2020-04-28;"Trnavský kraj";1;0;0;0;NA;44302;1;2020-04-28;-45649
2020-04-27;"Trnavský kraj";0;0;0;0;NA;44302;0;2020-04-27;-45650
2020-04-26;"Trnavský kraj";0;0;0;0;NA;44302;0;2020-04-26;-45650
2020-04-25;"Trnavský kraj";2;0;0;0;NA;44302;2;2020-04-25;-45650
2020-04-24;"Trnavský kraj";4;0;0;0;NA;44302;4;2020-04-24;-45652
2020-04-23;"Trnavský kraj";5;0;0;0;NA;44302;5;2020-04-23;-45656
2020-04-22;"Trnavský kraj";10;0;0;0;NA;44302;10;2020-04-22;-45661
2020-04-21;"Trnavský kraj";5;0;0;0;NA;44302;5;2020-04-21;-45671
2020-04-20;"Trnavský kraj";0;0;0;0;NA;44302;0;2020-04-20;-45676
2020-04-19;"Trnavský kraj";1;0;0;0;NA;44302;1;2020-04-19;-45676
2020-04-18;"Trnavský kraj";4;0;0;0;NA;44302;4;2020-04-18;-45677
2020-04-17;"Trnavský kraj";7;0;0;0;NA;44302;7;2020-04-17;-45681
2020-04-16;"Trnavský kraj";5;0;0;0;NA;44302;5;2020-04-16;-45688
2020-04-15;"Trnavský kraj";5;0;0;0;NA;44302;5;2020-04-15;-45693
2020-04-14;"Trnavský kraj";1;0;0;0;NA;44302;1;2020-04-14;-45698
2020-04-13;"Trnavský kraj";0;0;0;0;NA;44302;0;2020-04-13;-45699
2020-04-12;"Trnavský kraj";0;0;0;0;NA;44302;0;2020-04-12;-45699
2020-04-11;"Trnavský kraj";0;0;0;0;NA;44302;0;2020-04-11;-45699
2020-04-10;"Trnavský kraj";2;0;0;0;NA;44302;2;2020-04-10;-45699
2020-04-09;"Trnavský kraj";3;0;0;0;NA;44302;3;2020-04-09;-45701
2020-04-08;"Trnavský kraj";4;0;0;0;NA;44302;4;2020-04-08;-45704
2020-04-07;"Trnavský kraj";6;0;0;0;NA;44302;6;2020-04-07;-45708
2020-04-06;"Trnavský kraj";6;0;0;0;NA;44302;6;2020-04-06;-45714
2020-04-05;"Trnavský kraj";1;0;0;0;NA;44302;1;2020-04-05;-45720
2020-04-04;"Trnavský kraj";1;0;0;0;NA;44302;1;2020-04-04;-45721
2020-04-03;"Trnavský kraj";3;0;0;0;NA;44302;3;2020-04-03;-45722
2020-04-02;"Trnavský kraj";4;0;0;0;NA;44302;4;2020-04-02;-45725
2020-04-01;"Trnavský kraj";0;0;0;0;NA;44302;0;2020-04-01;-45729
2020-03-31;"Trnavský kraj";3;0;0;0;NA;44302;3;2020-03-31;-45729
2020-03-30;"Trnavský kraj";4;0;0;0;NA;44302;4;2020-03-30;-45732
2020-03-29;"Trnavský kraj";1;0;0;0;NA;44302;1;2020-03-29;-45736
2020-03-28;"Trnavský kraj";3;0;0;0;NA;44302;3;2020-03-28;-45737
2020-03-27;"Trnavský kraj";5;0;0;0;NA;44302;5;2020-03-27;-45740
2020-03-26;"Trnavský kraj";5;0;0;0;NA;44302;5;2020-03-26;-45745
2020-03-25;"Trnavský kraj";1;0;0;0;NA;44302;1;2020-03-25;-45750
2020-03-24;"Trnavský kraj";0;0;0;0;NA;44302;0;2020-03-24;-45751
2020-03-23;"Trnavský kraj";2;0;0;0;NA;44302;2;2020-03-23;-45751
2020-03-22;"Trnavský kraj";1;0;0;0;NA;44302;1;2020-03-22;-45753
2020-03-21;"Trnavský kraj";5;0;0;0;NA;44302;5;2020-03-21;-45754
2020-03-20;"Trnavský kraj";0;0;0;0;NA;44302;0;2020-03-20;-45759
2020-03-19;"Trnavský kraj";0;0;0;0;NA;44302;0;2020-03-19;-45759
2020-03-18;"Trnavský kraj";0;0;0;0;NA;44302;0;2020-03-18;-45759
2020-03-17;"Trnavský kraj";3;0;0;0;NA;44302;3;2020-03-17;-45759
2020-03-16;"Trnavský kraj";1;0;0;0;NA;44302;1;2020-03-16;-45762
2020-03-15;"Trnavský kraj";0;0;0;0;NA;44302;0;2020-03-15;-45763
2020-03-14;"Trnavský kraj";0;0;0;0;NA;44302;0;2020-03-14;-45763
2020-03-13;"Trnavský kraj";1;0;0;0;NA;44302;1;2020-03-13;-45763
2020-03-12;"Trnavský kraj";1;0;0;0;NA;44302;1;2020-03-12;-45764
2020-03-11;"Trnavský kraj";0;0;0;0;NA;44302;0;2020-03-11;-45765
2020-03-09;"Trnavský kraj";0;0;0;0;NA;44302;0;2020-03-09;-45765
2020-03-08;"Trnavský kraj";0;0;0;0;NA;44302;0;2020-03-08;-45765
2020-03-07;"Trnavský kraj";0;0;0;0;NA;44302;0;2020-03-07;-45765
2020-03-06;"Trnavský kraj";0;0;0;0;NA;44302;0;2020-03-06;-45765
2021-06-22;"Žilinský kraj";6;3910;5;3915;0;50565;11;2021-06-22;50565
2021-06-21;"Žilinský kraj";6;5347;8;5355;NA;50565;14;2021-06-21;50554
2021-06-20;"Žilinský kraj";1;5305;5;5310;NA;50565;6;2021-06-20;50540
2021-06-19;"Žilinský kraj";9;7183;2;7185;NA;50565;11;2021-06-19;50534
2021-06-18;"Žilinský kraj";11;9274;10;9284;NA;50565;21;2021-06-18;50523
2021-06-17;"Žilinský kraj";10;5326;11;5337;NA;50565;21;2021-06-17;50502
2021-06-16;"Žilinský kraj";17;5043;10;5053;NA;50565;27;2021-06-16;50481
2021-06-15;"Žilinský kraj";13;5546;12;5558;NA;50565;25;2021-06-15;50454
2021-06-14;"Žilinský kraj";10;6711;16;6727;NA;50565;26;2021-06-14;50429
2021-06-13;"Žilinský kraj";2;6179;8;6187;NA;50565;10;2021-06-13;50403
2021-06-12;"Žilinský kraj";9;7469;8;7477;NA;50565;17;2021-06-12;50393
2021-06-11;"Žilinský kraj";11;10370;12;10382;NA;50565;23;2021-06-11;50376
2021-06-10;"Žilinský kraj";14;6093;10;6103;NA;50565;24;2021-06-10;50353
2021-06-09;"Žilinský kraj";23;5222;10;5232;NA;50565;33;2021-06-09;50329
2021-06-08;"Žilinský kraj";18;6170;15;6185;NA;50565;33;2021-06-08;50296
2021-06-07;"Žilinský kraj";25;7659;21;7680;NA;50565;46;2021-06-07;50263
2021-06-06;"Žilinský kraj";10;7359;24;7383;NA;50565;34;2021-06-06;50217
2021-06-05;"Žilinský kraj";8;8035;9;8044;NA;50565;17;2021-06-05;50183
2021-06-04;"Žilinský kraj";19;11033;26;11059;NA;50565;45;2021-06-04;50166
2021-06-03;"Žilinský kraj";12;6094;30;6124;NA;50565;42;2021-06-03;50121
2021-06-02;"Žilinský kraj";17;6900;28;6928;NA;50565;45;2021-06-02;50079
2021-06-01;"Žilinský kraj";38;7591;39;7630;NA;50565;77;2021-06-01;50034
2021-05-31;"Žilinský kraj";31;8534;55;8589;NA;50565;86;2021-05-31;49957
2021-05-30;"Žilinský kraj";21;8533;30;8563;NA;50565;51;2021-05-30;49871
2021-05-29;"Žilinský kraj";13;9956;18;9974;NA;50565;31;2021-05-29;49820
2021-05-28;"Žilinský kraj";28;12113;30;12143;NA;50565;58;2021-05-28;49789
2021-05-27;"Žilinský kraj";17;8267;39;8306;NA;50565;56;2021-05-27;49731
2021-05-26;"Žilinský kraj";20;7324;21;7345;NA;50565;41;2021-05-26;49675
2021-05-25;"Žilinský kraj";21;9027;36;9063;NA;50565;57;2021-05-25;49634
2021-05-24;"Žilinský kraj";36;11437;57;11494;NA;50565;93;2021-05-24;49577
2021-05-23;"Žilinský kraj";4;10300;52;10352;NA;50565;56;2021-05-23;49484
2021-05-22;"Žilinský kraj";21;10580;26;10606;NA;50565;47;2021-05-22;49428
2021-05-21;"Žilinský kraj";28;14377;46;14423;NA;50565;74;2021-05-21;49381
2021-05-20;"Žilinský kraj";30;8544;30;8574;NA;50565;60;2021-05-20;49307
2021-05-19;"Žilinský kraj";46;8010;40;8050;NA;50565;86;2021-05-19;49247
2021-05-18;"Žilinský kraj";52;10365;43;10408;NA;50565;95;2021-05-18;49161
2021-05-17;"Žilinský kraj";51;11859;77;11936;NA;50565;128;2021-05-17;49066
2021-05-16;"Žilinský kraj";13;13429;37;13466;NA;50565;50;2021-05-16;48938
2021-05-15;"Žilinský kraj";30;16574;32;16606;NA;50565;62;2021-05-15;48888
2021-05-14;"Žilinský kraj";34;19200;72;19272;NA;50565;106;2021-05-14;48826
2021-05-13;"Žilinský kraj";64;11865;51;11916;NA;50565;115;2021-05-13;48720
2021-05-12;"Žilinský kraj";57;10337;51;10388;NA;50565;108;2021-05-12;48605
2021-05-11;"Žilinský kraj";70;11601;48;11649;NA;50565;118;2021-05-11;48497
2021-05-10;"Žilinský kraj";69;14664;70;14734;NA;50565;139;2021-05-10;48379
2021-05-09;"Žilinský kraj";58;19295;72;19367;NA;50565;130;2021-05-09;48240
2021-05-08;"Žilinský kraj";0;22132;58;22190;NA;50565;58;2021-05-08;48110
2021-05-07;"Žilinský kraj";65;23787;78;23865;NA;50565;143;2021-05-07;48052
2021-05-06;"Žilinský kraj";67;16605;72;16677;NA;50565;139;2021-05-06;47909
2021-05-05;"Žilinský kraj";71;12152;71;12223;NA;50565;142;2021-05-05;47770
2021-05-04;"Žilinský kraj";81;16309;79;16388;NA;50565;160;2021-05-04;47628
2021-05-03;"Žilinský kraj";97;19768;110;19878;NA;50565;207;2021-05-03;47468
2021-05-02;"Žilinský kraj";8;28886;64;28950;NA;50565;72;2021-05-02;47261
2021-05-01;"Žilinský kraj";65;54670;103;54773;NA;50565;168;2021-05-01;47189
2021-04-30;"Žilinský kraj";84;43812;117;43929;NA;50565;201;2021-04-30;47021
2021-04-29;"Žilinský kraj";77;24553;101;24654;NA;50565;178;2021-04-29;46820
2021-04-28;"Žilinský kraj";76;19205;91;19296;NA;50565;167;2021-04-28;46642
2021-04-27;"Žilinský kraj";97;21795;110;21905;NA;50565;207;2021-04-27;46475
2021-04-26;"Žilinský kraj";114;27412;136;27548;NA;50565;250;2021-04-26;46268
2021-04-25;"Žilinský kraj";38;35750;82;35832;NA;50565;120;2021-04-25;46018
2021-04-24;"Žilinský kraj";93;78854;157;79011;NA;50565;250;2021-04-24;45898
2021-04-23;"Žilinský kraj";144;49219;153;49372;NA;50565;297;2021-04-23;45648
2021-04-22;"Žilinský kraj";110;25209;132;25341;NA;50565;242;2021-04-22;45351
2021-04-21;"Žilinský kraj";118;20616;145;20761;NA;50565;263;2021-04-21;45109
2021-04-20;"Žilinský kraj";128;23778;136;23914;NA;50565;264;2021-04-20;44846
2021-04-19;"Žilinský kraj";164;32773;210;32983;NA;50565;374;2021-04-19;44582
2021-04-18;"Žilinský kraj";18;36767;91;36858;NA;50565;109;2021-04-18;44208
2021-04-17;"Žilinský kraj";108;89377;156;89533;NA;50565;264;2021-04-17;44099
2021-04-16;"Žilinský kraj";185;46876;207;47083;NA;50565;392;2021-04-16;43835
2021-04-15;"Žilinský kraj";108;24825;130;24955;NA;50565;238;2021-04-15;43443
2021-04-14;"Žilinský kraj";135;23108;145;23253;NA;50565;280;2021-04-14;43205
2021-04-13;"Žilinský kraj";171;25050;135;25185;NA;50565;306;2021-04-13;42925
2021-04-12;"Žilinský kraj";266;30726;189;30915;NA;50565;455;2021-04-12;42619
2021-04-11;"Žilinský kraj";19;37126;107;37233;NA;50565;126;2021-04-11;42164
2021-04-10;"Žilinský kraj";111;86284;237;86521;NA;50565;348;2021-04-10;42038
2021-04-09;"Žilinský kraj";195;41752;205;41957;NA;50565;400;2021-04-09;41690
2021-04-08;"Žilinský kraj";179;24382;141;24523;NA;50565;320;2021-04-08;41290
2021-04-07;"Žilinský kraj";309;28651;174;28825;NA;50565;483;2021-04-07;40970
2021-04-06;"Žilinský kraj";308;38818;294;39112;NA;50565;602;2021-04-06;40487
2021-04-05;"Žilinský kraj";17;14747;140;14887;NA;50565;157;2021-04-05;39885
2021-04-04;"Žilinský kraj";17;16284;69;16353;NA;50565;86;2021-04-04;39728
2021-04-03;"Žilinský kraj";180;100430;401;100831;NA;50565;581;2021-04-03;39642
2021-04-02;"Žilinský kraj";73;22411;83;22494;NA;50565;156;2021-04-02;39061
2021-04-01;"Žilinský kraj";334;43264;240;43504;NA;50565;574;2021-04-01;38905
2021-03-31;"Žilinský kraj";170;31632;247;31879;NA;50565;417;2021-03-31;38331
2021-03-30;"Žilinský kraj";406;26323;243;26566;NA;50565;649;2021-03-30;37914
2021-03-29;"Žilinský kraj";297;28022;268;28290;NA;50565;565;2021-03-29;37265
2021-03-28;"Žilinský kraj";21;36206;239;36445;NA;50565;260;2021-03-28;36700
2021-03-27;"Žilinský kraj";151;89107;353;89460;NA;50565;504;2021-03-27;36440
2021-03-26;"Žilinský kraj";312;51705;330;52035;NA;50565;642;2021-03-26;35936
2021-03-25;"Žilinský kraj";281;27620;214;27834;NA;50565;495;2021-03-25;35294
2021-03-24;"Žilinský kraj";280;21268;260;21528;NA;50565;540;2021-03-24;34799
2021-03-23;"Žilinský kraj";418;23187;278;23465;NA;50565;696;2021-03-23;34259
2021-03-22;"Žilinský kraj";293;29289;314;29603;NA;50565;607;2021-03-22;33563
2021-03-21;"Žilinský kraj";32;33705;227;33932;NA;50565;259;2021-03-21;32956
2021-03-20;"Žilinský kraj";165;93015;497;93512;NA;50565;662;2021-03-20;32697
2021-03-19;"Žilinský kraj";357;51982;413;52395;NA;50565;770;2021-03-19;32035
2021-03-18;"Žilinský kraj";329;28451;294;28745;NA;50565;623;2021-03-18;31265
2021-03-17;"Žilinský kraj";395;21916;269;22185;NA;50565;664;2021-03-17;30642
2021-03-16;"Žilinský kraj";514;24341;317;24658;NA;50565;831;2021-03-16;29978
2021-03-15;"Žilinský kraj";341;29607;419;30026;NA;50565;760;2021-03-15;29147
2021-03-14;"Žilinský kraj";87;34121;267;34388;NA;50565;354;2021-03-14;28387
2021-03-13;"Žilinský kraj";113;93386;581;93967;NA;50565;694;2021-03-13;28033
2021-03-12;"Žilinský kraj";520;52109;411;52520;NA;50565;931;2021-03-12;27339
2021-03-11;"Žilinský kraj";399;28189;302;28491;NA;50565;701;2021-03-11;26408
2021-03-10;"Žilinský kraj";368;22414;378;22792;NA;50565;746;2021-03-10;25707
2021-03-09;"Žilinský kraj";537;24857;316;25173;NA;50565;853;2021-03-09;24961
2021-03-08;"Žilinský kraj";387;30839;458;31297;NA;50565;845;2021-03-08;24108
2021-03-07;"Žilinský kraj";48;33469;290;33759;NA;50565;338;2021-03-07;23263
2021-03-06;"Žilinský kraj";173;92410;589;92999;NA;50565;762;2021-03-06;22925
2021-03-05;"Žilinský kraj";369;51748;483;52231;NA;50565;852;2021-03-05;22163
2021-03-04;"Žilinský kraj";467;30036;377;30413;NA;50565;844;2021-03-04;21311
2021-03-03;"Žilinský kraj";448;26261;394;26655;NA;50565;842;2021-03-03;20467
2021-03-02;"Žilinský kraj";551;25669;378;26047;NA;50565;929;2021-03-02;19625
2021-03-01;"Žilinský kraj";375;30493;441;30934;NA;50565;816;2021-03-01;18696
2021-02-28;"Žilinský kraj";61;34802;327;35129;NA;50565;388;2021-02-28;17880
2021-02-27;"Žilinský kraj";159;83781;639;84420;NA;50565;798;2021-02-27;17492
2021-02-26;"Žilinský kraj";459;47494;508;48002;NA;50565;967;2021-02-26;16694
2021-02-25;"Žilinský kraj";347;30879;393;31272;NA;50565;740;2021-02-25;15727
2021-02-24;"Žilinský kraj";339;18745;395;19140;NA;50565;734;2021-02-24;14987
2021-02-23;"Žilinský kraj";437;22418;418;22836;NA;50565;855;2021-02-23;14253
2021-02-22;"Žilinský kraj";345;29288;438;29726;NA;50565;783;2021-02-22;13398
2021-02-21;"Žilinský kraj";36;28686;322;29008;NA;50565;358;2021-02-21;12615
2021-02-20;"Žilinský kraj";152;89085;669;89754;NA;50565;821;2021-02-20;12257
2021-02-19;"Žilinský kraj";337;44806;415;45221;NA;50565;752;2021-02-19;11436
2021-02-18;"Žilinský kraj";263;24679;339;25018;NA;50565;602;2021-02-18;10684
2021-02-17;"Žilinský kraj";269;17932;355;18287;NA;50565;624;2021-02-17;10082
2021-02-16;"Žilinský kraj";321;24298;325;24623;NA;50565;646;2021-02-16;9458
2021-02-15;"Žilinský kraj";230;30420;311;30731;NA;50565;541;2021-02-15;8812
2021-02-14;"Žilinský kraj";30;28574;231;28805;NA;50565;261;2021-02-14;8271
2021-02-13;"Žilinský kraj";91;69659;454;70113;NA;50565;545;2021-02-13;8010
2021-02-12;"Žilinský kraj";242;42689;335;43024;NA;50565;577;2021-02-12;7465
2021-02-11;"Žilinský kraj";228;23521;300;23821;NA;50565;528;2021-02-11;6888
2021-02-10;"Žilinský kraj";259;17875;267;18142;NA;50565;526;2021-02-10;6360
2021-02-09;"Žilinský kraj";377;24784;274;25058;NA;50565;651;2021-02-09;5834
2021-02-08;"Žilinský kraj";160;41375;390;41765;NA;50565;550;2021-02-08;5183
2021-02-07;"Žilinský kraj";24;46446;252;46698;NA;50565;276;2021-02-07;4633
2021-02-06;"Žilinský kraj";71;72880;367;73247;NA;50565;438;2021-02-06;4357
2021-02-05;"Žilinský kraj";248;31868;323;32191;NA;50565;571;2021-02-05;3919
2021-02-04;"Žilinský kraj";238;13242;258;13500;NA;50565;496;2021-02-04;3348
2021-02-03;"Žilinský kraj";194;9187;255;9442;NA;50565;449;2021-02-03;2852
2021-02-02;"Žilinský kraj";216;9280;272;9552;NA;50565;488;2021-02-02;2403
2021-02-01;"Žilinský kraj";220;19688;370;20058;NA;50565;590;2021-02-01;1915
2021-01-31;"Žilinský kraj";11;2652;27;2679;NA;50565;38;2021-01-31;1325
2021-01-30;"Žilinský kraj";85;18447;187;18634;NA;50565;272;2021-01-30;1287
2021-01-29;"Žilinský kraj";209;22892;304;23196;NA;50565;513;2021-01-29;1015
2021-01-28;"Žilinský kraj";240;5623;174;5797;NA;50565;414;2021-01-28;502
2021-01-27;"Žilinský kraj";256;7065;121;7186;NA;50565;377;2021-01-27;88
2021-01-26;"Žilinský kraj";245;49441;346;49787;NA;50565;591;2021-01-26;-289
2021-01-25;"Žilinský kraj";159;21147;150;21297;NA;50565;309;2021-01-25;-880
2021-01-24;"Žilinský kraj";22;67309;305;67614;NA;50565;327;2021-01-24;-1189
2021-01-23;"Žilinský kraj";91;90991;408;91399;NA;50565;499;2021-01-23;-1516
2021-01-22;"Žilinský kraj";163;31997;239;32236;NA;50565;402;2021-01-22;-2015
2021-01-21;"Žilinský kraj";116;19874;181;20055;NA;50565;297;2021-01-21;-2417
2021-01-20;"Žilinský kraj";236;17089;165;17254;NA;50565;401;2021-01-20;-2714
2021-01-19;"Žilinský kraj";245;15578;283;15861;NA;50565;528;2021-01-19;-3115
2021-01-18;"Žilinský kraj";236;12506;327;12833;NA;50565;563;2021-01-18;-3643
2021-01-17;"Žilinský kraj";95;147;8;155;NA;50565;103;2021-01-17;-4206
2021-01-16;"Žilinský kraj";14;758;35;793;NA;50565;49;2021-01-16;-4309
2021-01-15;"Žilinský kraj";248;7244;205;7449;NA;50565;453;2021-01-15;-4358
2021-01-14;"Žilinský kraj";166;5572;248;5820;NA;50565;414;2021-01-14;-4811
2021-01-13;"Žilinský kraj";247;11316;555;11871;NA;50565;802;2021-01-13;-5225
2021-01-12;"Žilinský kraj";376;8754;413;9167;NA;50565;789;2021-01-12;-6027
2021-01-11;"Žilinský kraj";351;10385;513;10898;NA;50565;864;2021-01-11;-6816
2021-01-10;"Žilinský kraj";38;229;6;235;NA;50565;44;2021-01-10;-7680
2021-01-09;"Žilinský kraj";192;1983;85;2068;NA;50565;277;2021-01-09;-7724
2021-01-08;"Žilinský kraj";413;9245;497;9742;NA;50565;910;2021-01-08;-8001
2021-01-07;"Žilinský kraj";438;23485;1881;25366;NA;50565;2319;2021-01-07;-8911
2021-01-06;"Žilinský kraj";145;1412;96;1508;NA;50565;241;2021-01-06;-11230
2021-01-05;"Žilinský kraj";717;10702;845;11547;NA;50565;1562;2021-01-05;-11471
2021-01-04;"Žilinský kraj";479;9739;1012;10751;NA;50565;1491;2021-01-04;-13033
2021-01-03;"Žilinský kraj";13;1006;107;1113;NA;50565;120;2021-01-03;-14524
2021-01-02;"Žilinský kraj";98;789;91;880;NA;50565;189;2021-01-02;-14644
2021-01-01;"Žilinský kraj";118;615;37;652;NA;50565;155;2021-01-01;-14833
2020-12-31;"Žilinský kraj";395;10008;809;10817;NA;50565;1204;2020-12-31;-14988
2020-12-30;"Žilinský kraj";1038;12030;849;12879;NA;50565;1887;2020-12-30;-16192
2020-12-29;"Žilinský kraj";256;10584;1041;11625;NA;50565;1297;2020-12-29;-18079
2020-12-28;"Žilinský kraj";406;11177;1048;12225;NA;50565;1454;2020-12-28;-19376
2020-12-27;"Žilinský kraj";40;684;94;778;NA;50565;134;2020-12-27;-20830
2020-12-26;"Žilinský kraj";135;593;48;641;NA;50565;183;2020-12-26;-20964
2020-12-25;"Žilinský kraj";66;83;9;92;NA;50565;75;2020-12-25;-21147
2020-12-24;"Žilinský kraj";643;1060;80;1140;NA;50565;723;2020-12-24;-21222
2020-12-23;"Žilinský kraj";228;17281;1031;18312;NA;50565;1259;2020-12-23;-21945
2020-12-22;"Žilinský kraj";519;13746;1031;14777;NA;50565;1550;2020-12-22;-23204
2020-12-21;"Žilinský kraj";444;12608;1096;13704;NA;50565;1540;2020-12-21;-24754
2020-12-20;"Žilinský kraj";36;598;80;678;NA;50565;116;2020-12-20;-26294
2020-12-19;"Žilinský kraj";208;2076;145;2221;NA;50565;353;2020-12-19;-26410
2020-12-18;"Žilinský kraj";333;6925;400;7325;NA;50565;733;2020-12-18;-26763
2020-12-17;"Žilinský kraj";500;4243;279;4522;NA;50565;779;2020-12-17;-27496
2020-12-16;"Žilinský kraj";333;3999;280;4279;NA;50565;613;2020-12-16;-28275
2020-12-15;"Žilinský kraj";528;4139;378;4517;NA;50565;906;2020-12-15;-28888
2020-12-14;"Žilinský kraj";321;4300;355;4655;NA;50565;676;2020-12-14;-29794
2020-12-13;"Žilinský kraj";26;494;66;560;NA;50565;92;2020-12-13;-30470
2020-12-12;"Žilinský kraj";95;1116;61;1177;NA;50565;156;2020-12-12;-30562
2020-12-11;"Žilinský kraj";455;4507;269;4776;NA;50565;724;2020-12-11;-30718
2020-12-10;"Žilinský kraj";166;9341;838;10179;NA;50565;1004;2020-12-10;-31442
2020-12-09;"Žilinský kraj";392;2200;131;2331;NA;50565;523;2020-12-09;-32446
2020-12-08;"Žilinský kraj";331;3248;123;3371;NA;50565;454;2020-12-08;-32969
2020-12-07;"Žilinský kraj";348;2254;127;2381;NA;50565;475;2020-12-07;-33423
2020-12-06;"Žilinský kraj";15;128;6;134;NA;50565;21;2020-12-06;-33898
2020-12-05;"Žilinský kraj";98;1500;53;1553;NA;50565;151;2020-12-05;-33919
2020-12-04;"Žilinský kraj";228;2891;122;3013;NA;50565;350;2020-12-04;-34070
2020-12-03;"Žilinský kraj";237;1424;117;1541;NA;50565;354;2020-12-03;-34420
2020-12-02;"Žilinský kraj";181;1396;69;1465;NA;50565;250;2020-12-02;-34774
2020-12-01;"Žilinský kraj";209;6239;284;6523;NA;50565;493;2020-12-01;-35024
2020-11-30;"Žilinský kraj";203;5326;305;5631;NA;50565;508;2020-11-30;-35517
2020-11-29;"Žilinský kraj";18;81;7;88;NA;50565;25;2020-11-29;-36025
2020-11-28;"Žilinský kraj";99;349;15;364;NA;50565;114;2020-11-28;-36050
2020-11-27;"Žilinský kraj";218;904;46;950;NA;50565;264;2020-11-27;-36164
2020-11-26;"Žilinský kraj";190;1041;54;1095;NA;50565;244;2020-11-26;-36428
2020-11-25;"Žilinský kraj";225;1217;49;1266;NA;50565;274;2020-11-25;-36672
2020-11-24;"Žilinský kraj";213;2139;67;2206;NA;50565;280;2020-11-24;-36946
2020-11-23;"Žilinský kraj";170;759;44;803;NA;50565;214;2020-11-23;-37226
2020-11-22;"Žilinský kraj";11;67;2;69;NA;50565;13;2020-11-22;-37440
2020-11-21;"Žilinský kraj";61;505;20;525;NA;50565;81;2020-11-21;-37453
2020-11-20;"Žilinský kraj";251;1074;45;1119;NA;50565;296;2020-11-20;-37534
2020-11-19;"Žilinský kraj";252;752;61;813;NA;50565;313;2020-11-19;-37830
2020-11-18;"Žilinský kraj";346;348;15;363;NA;50565;361;2020-11-18;-38143
2020-11-17;"Žilinský kraj";123;490;15;505;NA;50565;138;2020-11-17;-38504
2020-11-16;"Žilinský kraj";227;247;15;262;NA;50565;242;2020-11-16;-38642
2020-11-15;"Žilinský kraj";63;13;0;13;NA;50565;63;2020-11-15;-38884
2020-11-14;"Žilinský kraj";189;1038;11;1049;NA;50565;200;2020-11-14;-38947
2020-11-13;"Žilinský kraj";181;125;9;134;NA;50565;190;2020-11-13;-39147
2020-11-12;"Žilinský kraj";334;79;2;81;NA;50565;336;2020-11-12;-39337
2020-11-11;"Žilinský kraj";489;147;10;157;NA;50565;499;2020-11-11;-39673
2020-11-10;"Žilinský kraj";374;519;9;528;NA;50565;383;2020-11-10;-40172
2020-11-09;"Žilinský kraj";143;2335;30;2365;NA;50565;173;2020-11-09;-40555
2020-11-08;"Žilinský kraj";59;2538;37;2575;NA;50565;96;2020-11-08;-40728
2020-11-07;"Žilinský kraj";312;8175;88;8263;NA;50565;400;2020-11-07;-40824
2020-11-06;"Žilinský kraj";503;4090;38;4128;NA;50565;541;2020-11-06;-41224
2020-11-05;"Žilinský kraj";473;64;4;68;NA;50565;477;2020-11-05;-41765
2020-11-04;"Žilinský kraj";423;178;10;188;NA;50565;433;2020-11-04;-42242
2020-11-03;"Žilinský kraj";688;889;16;905;NA;50565;704;2020-11-03;-42675
2020-11-02;"Žilinský kraj";472;1043;39;1082;NA;50565;511;2020-11-02;-43379
2020-11-01;"Žilinský kraj";349;5096;130;5226;NA;50565;479;2020-11-01;-43890
2020-10-31;"Žilinský kraj";661;7963;203;8166;NA;50565;864;2020-10-31;-44369
2020-10-30;"Žilinský kraj";529;2575;61;2636;NA;50565;590;2020-10-30;-45233
2020-10-29;"Žilinský kraj";740;503;17;520;NA;50565;757;2020-10-29;-45823
2020-10-28;"Žilinský kraj";635;105;11;116;NA;50565;646;2020-10-28;-46580
2020-10-27;"Žilinský kraj";355;154;24;178;NA;50565;379;2020-10-27;-47226
2020-10-26;"Žilinský kraj";148;117;28;145;NA;50565;176;2020-10-26;-47605
2020-10-25;"Žilinský kraj";436;0;0;0;NA;50565;436;2020-10-25;-47781
2020-10-24;"Žilinský kraj";803;0;0;0;NA;50565;803;2020-10-24;-48217
2020-10-23;"Žilinský kraj";659;102;13;115;NA;50565;672;2020-10-23;-49020
2020-10-22;"Žilinský kraj";525;33;3;36;NA;50565;528;2020-10-22;-49692
2020-10-21;"Žilinský kraj";478;74;14;88;NA;50565;492;2020-10-21;-50220
2020-10-20;"Žilinský kraj";524;127;8;135;NA;50565;532;2020-10-20;-50712
2020-10-19;"Žilinský kraj";70;80;12;92;NA;50565;82;2020-10-19;-51244
2020-10-18;"Žilinský kraj";159;0;0;0;NA;50565;159;2020-10-18;-51326
2020-10-17;"Žilinský kraj";509;0;0;0;NA;50565;509;2020-10-17;-51485
2020-10-16;"Žilinský kraj";603;51;9;60;NA;50565;612;2020-10-16;-51994
2020-10-15;"Žilinský kraj";679;61;3;64;NA;50565;682;2020-10-15;-52606
2020-10-14;"Žilinský kraj";523;269;6;275;NA;50565;529;2020-10-14;-53288
2020-10-13;"Žilinský kraj";367;458;40;498;NA;50565;407;2020-10-13;-53817
2020-10-12;"Žilinský kraj";62;0;0;0;NA;50565;62;2020-10-12;-54224
2020-10-11;"Žilinský kraj";50;0;0;0;NA;50565;50;2020-10-11;-54286
2020-10-10;"Žilinský kraj";213;0;0;0;NA;50565;213;2020-10-10;-54336
2020-10-09;"Žilinský kraj";543;0;0;0;NA;50565;543;2020-10-09;-54549
2020-10-08;"Žilinský kraj";238;0;0;0;NA;50565;238;2020-10-08;-55092
2020-10-07;"Žilinský kraj";168;0;0;0;NA;50565;168;2020-10-07;-55330
2020-10-06;"Žilinský kraj";233;0;0;0;NA;50565;233;2020-10-06;-55498
2020-10-05;"Žilinský kraj";33;0;0;0;NA;50565;33;2020-10-05;-55731
2020-10-04;"Žilinský kraj";35;0;0;0;NA;50565;35;2020-10-04;-55764
2020-10-03;"Žilinský kraj";155;0;0;0;NA;50565;155;2020-10-03;-55799
2020-10-02;"Žilinský kraj";105;0;0;0;NA;50565;105;2020-10-02;-55954
2020-10-01;"Žilinský kraj";147;0;0;0;NA;50565;147;2020-10-01;-56059
2020-09-30;"Žilinský kraj";163;0;0;0;NA;50565;163;2020-09-30;-56206
2020-09-29;"Žilinský kraj";105;0;0;0;NA;50565;105;2020-09-29;-56369
2020-09-28;"Žilinský kraj";34;0;0;0;NA;50565;34;2020-09-28;-56474
2020-09-27;"Žilinský kraj";108;0;0;0;NA;50565;108;2020-09-27;-56508
2020-09-26;"Žilinský kraj";96;0;0;0;NA;50565;96;2020-09-26;-56616
2020-09-25;"Žilinský kraj";69;0;0;0;NA;50565;69;2020-09-25;-56712
2020-09-24;"Žilinský kraj";100;0;0;0;NA;50565;100;2020-09-24;-56781
2020-09-23;"Žilinský kraj";65;0;0;0;NA;50565;65;2020-09-23;-56881
2020-09-22;"Žilinský kraj";65;0;0;0;NA;50565;65;2020-09-22;-56946
2020-09-21;"Žilinský kraj";47;0;0;0;NA;50565;47;2020-09-21;-57011
2020-09-20;"Žilinský kraj";4;0;0;0;NA;50565;4;2020-09-20;-57058
2020-09-19;"Žilinský kraj";6;0;0;0;NA;50565;6;2020-09-19;-57062
2020-09-18;"Žilinský kraj";82;0;0;0;NA;50565;82;2020-09-18;-57068
2020-09-17;"Žilinský kraj";30;0;0;0;NA;50565;30;2020-09-17;-57150
2020-09-16;"Žilinský kraj";34;0;0;0;NA;50565;34;2020-09-16;-57180
2020-09-15;"Žilinský kraj";12;0;0;0;NA;50565;12;2020-09-15;-57214
2020-09-14;"Žilinský kraj";39;0;0;0;NA;50565;39;2020-09-14;-57226
2020-09-13;"Žilinský kraj";6;0;0;0;NA;50565;6;2020-09-13;-57265
2020-09-12;"Žilinský kraj";4;0;0;0;NA;50565;4;2020-09-12;-57271
2020-09-11;"Žilinský kraj";31;0;0;0;NA;50565;31;2020-09-11;-57275
2020-09-10;"Žilinský kraj";31;0;0;0;NA;50565;31;2020-09-10;-57306
2020-09-09;"Žilinský kraj";23;0;0;0;NA;50565;23;2020-09-09;-57337
2020-09-08;"Žilinský kraj";25;0;0;0;NA;50565;25;2020-09-08;-57360
2020-09-07;"Žilinský kraj";11;0;0;0;NA;50565;11;2020-09-07;-57385
2020-09-06;"Žilinský kraj";0;0;0;0;NA;50565;0;2020-09-06;-57396
2020-09-05;"Žilinský kraj";2;0;0;0;NA;50565;2;2020-09-05;-57396
2020-09-04;"Žilinský kraj";33;0;0;0;NA;50565;33;2020-09-04;-57398
2020-09-03;"Žilinský kraj";18;0;0;0;NA;50565;18;2020-09-03;-57431
2020-09-02;"Žilinský kraj";16;0;0;0;NA;50565;16;2020-09-02;-57449
2020-09-01;"Žilinský kraj";4;0;0;0;NA;50565;4;2020-09-01;-57465
2020-08-31;"Žilinský kraj";5;0;0;0;NA;50565;5;2020-08-31;-57469
2020-08-30;"Žilinský kraj";3;0;0;0;NA;50565;3;2020-08-30;-57474
2020-08-29;"Žilinský kraj";5;0;0;0;NA;50565;5;2020-08-29;-57477
2020-08-28;"Žilinský kraj";13;0;0;0;NA;50565;13;2020-08-28;-57482
2020-08-27;"Žilinský kraj";18;0;0;0;NA;50565;18;2020-08-27;-57495
2020-08-26;"Žilinský kraj";8;0;0;0;NA;50565;8;2020-08-26;-57513
2020-08-25;"Žilinský kraj";2;0;0;0;NA;50565;2;2020-08-25;-57521
2020-08-24;"Žilinský kraj";5;0;0;0;NA;50565;5;2020-08-24;-57523
2020-08-23;"Žilinský kraj";0;0;0;0;NA;50565;0;2020-08-23;-57528
2020-08-22;"Žilinský kraj";0;0;0;0;NA;50565;0;2020-08-22;-57528
2020-08-21;"Žilinský kraj";10;0;0;0;NA;50565;10;2020-08-21;-57528
2020-08-20;"Žilinský kraj";13;0;0;0;NA;50565;13;2020-08-20;-57538
2020-08-19;"Žilinský kraj";7;0;0;0;NA;50565;7;2020-08-19;-57551
2020-08-18;"Žilinský kraj";9;0;0;0;NA;50565;9;2020-08-18;-57558
2020-08-17;"Žilinský kraj";1;0;0;0;NA;50565;1;2020-08-17;-57567
2020-08-16;"Žilinský kraj";0;0;0;0;NA;50565;0;2020-08-16;-57568
2020-08-15;"Žilinský kraj";0;0;0;0;NA;50565;0;2020-08-15;-57568
2020-08-14;"Žilinský kraj";4;0;0;0;NA;50565;4;2020-08-14;-57568
2020-08-13;"Žilinský kraj";2;0;0;0;NA;50565;2;2020-08-13;-57572
2020-08-12;"Žilinský kraj";0;0;0;0;NA;50565;0;2020-08-12;-57574
2020-08-11;"Žilinský kraj";4;0;0;0;NA;50565;4;2020-08-11;-57574
2020-08-10;"Žilinský kraj";1;0;0;0;NA;50565;1;2020-08-10;-57578
2020-08-09;"Žilinský kraj";0;0;0;0;NA;50565;0;2020-08-09;-57579
2020-08-08;"Žilinský kraj";3;0;0;0;NA;50565;3;2020-08-08;-57579
2020-08-07;"Žilinský kraj";8;0;0;0;NA;50565;8;2020-08-07;-57582
2020-08-06;"Žilinský kraj";1;0;0;0;NA;50565;1;2020-08-06;-57590
2020-08-05;"Žilinský kraj";1;0;0;0;NA;50565;1;2020-08-05;-57591
2020-08-04;"Žilinský kraj";2;0;0;0;NA;50565;2;2020-08-04;-57592
2020-08-03;"Žilinský kraj";0;0;0;0;NA;50565;0;2020-08-03;-57594
2020-08-02;"Žilinský kraj";1;0;0;0;NA;50565;1;2020-08-02;-57594
2020-08-01;"Žilinský kraj";0;0;0;0;NA;50565;0;2020-08-01;-57595
2020-07-31;"Žilinský kraj";4;0;0;0;NA;50565;4;2020-07-31;-57595
2020-07-30;"Žilinský kraj";2;0;0;0;NA;50565;2;2020-07-30;-57599
2020-07-29;"Žilinský kraj";2;0;0;0;NA;50565;2;2020-07-29;-57601
2020-07-28;"Žilinský kraj";4;0;0;0;NA;50565;4;2020-07-28;-57603
2020-07-27;"Žilinský kraj";6;0;0;0;NA;50565;6;2020-07-27;-57607
2020-07-26;"Žilinský kraj";0;0;0;0;NA;50565;0;2020-07-26;-57613
2020-07-25;"Žilinský kraj";0;0;0;0;NA;50565;0;2020-07-25;-57613
2020-07-24;"Žilinský kraj";2;0;0;0;NA;50565;2;2020-07-24;-57613
2020-07-23;"Žilinský kraj";0;0;0;0;NA;50565;0;2020-07-23;-57615
2020-07-22;"Žilinský kraj";1;0;0;0;NA;50565;1;2020-07-22;-57615
2020-07-21;"Žilinský kraj";2;0;0;0;NA;50565;2;2020-07-21;-57616
2020-07-20;"Žilinský kraj";3;0;0;0;NA;50565;3;2020-07-20;-57618
2020-07-19;"Žilinský kraj";0;0;0;0;NA;50565;0;2020-07-19;-57621
2020-07-18;"Žilinský kraj";0;0;0;0;NA;50565;0;2020-07-18;-57621
2020-07-17;"Žilinský kraj";2;0;0;0;NA;50565;2;2020-07-17;-57621
2020-07-16;"Žilinský kraj";2;0;0;0;NA;50565;2;2020-07-16;-57623
2020-07-15;"Žilinský kraj";2;0;0;0;NA;50565;2;2020-07-15;-57625
2020-07-14;"Žilinský kraj";1;0;0;0;NA;50565;1;2020-07-14;-57627
2020-07-13;"Žilinský kraj";0;0;0;0;NA;50565;0;2020-07-13;-57628
2020-07-12;"Žilinský kraj";0;0;0;0;NA;50565;0;2020-07-12;-57628
2020-07-11;"Žilinský kraj";2;0;0;0;NA;50565;2;2020-07-11;-57628
2020-07-10;"Žilinský kraj";3;0;0;0;NA;50565;3;2020-07-10;-57630
2020-07-09;"Žilinský kraj";2;0;0;0;NA;50565;2;2020-07-09;-57633
2020-07-08;"Žilinský kraj";10;0;0;0;NA;50565;10;2020-07-08;-57635
2020-07-07;"Žilinský kraj";7;0;0;0;NA;50565;7;2020-07-07;-57645
2020-07-06;"Žilinský kraj";0;0;0;0;NA;50565;0;2020-07-06;-57652
2020-07-05;"Žilinský kraj";0;0;0;0;NA;50565;0;2020-07-05;-57652
2020-07-04;"Žilinský kraj";10;0;0;0;NA;50565;10;2020-07-04;-57652
2020-07-03;"Žilinský kraj";18;0;0;0;NA;50565;18;2020-07-03;-57662
2020-07-02;"Žilinský kraj";7;0;0;0;NA;50565;7;2020-07-02;-57680
2020-07-01;"Žilinský kraj";0;0;0;0;NA;50565;0;2020-07-01;-57687
2020-06-30;"Žilinský kraj";4;0;0;0;NA;50565;4;2020-06-30;-57687
2020-06-29;"Žilinský kraj";0;0;0;0;NA;50565;0;2020-06-29;-57691
2020-06-28;"Žilinský kraj";1;0;0;0;NA;50565;1;2020-06-28;-57691
2020-06-27;"Žilinský kraj";3;0;0;0;NA;50565;3;2020-06-27;-57692
2020-06-26;"Žilinský kraj";5;0;0;0;NA;50565;5;2020-06-26;-57695
2020-06-25;"Žilinský kraj";7;0;0;0;NA;50565;7;2020-06-25;-57700
2020-06-24;"Žilinský kraj";11;0;0;0;NA;50565;11;2020-06-24;-57707
2020-06-23;"Žilinský kraj";9;0;0;0;NA;50565;9;2020-06-23;-57718
2020-06-22;"Žilinský kraj";0;0;0;0;NA;50565;0;2020-06-22;-57727
2020-06-21;"Žilinský kraj";1;0;0;0;NA;50565;1;2020-06-21;-57727
2020-06-20;"Žilinský kraj";1;0;0;0;NA;50565;1;2020-06-20;-57728
2020-06-19;"Žilinský kraj";4;0;0;0;NA;50565;4;2020-06-19;-57729
2020-06-18;"Žilinský kraj";1;0;0;0;NA;50565;1;2020-06-18;-57733
2020-06-17;"Žilinský kraj";0;0;0;0;NA;50565;0;2020-06-17;-57734
2020-06-16;"Žilinský kraj";1;0;0;0;NA;50565;1;2020-06-16;-57734
2020-06-14;"Žilinský kraj";0;0;0;0;NA;50565;0;2020-06-14;-57735
2020-06-13;"Žilinský kraj";0;0;0;0;NA;50565;0;2020-06-13;-57735
2020-06-12;"Žilinský kraj";0;0;0;0;NA;50565;0;2020-06-12;-57735
2020-06-11;"Žilinský kraj";0;0;0;0;NA;50565;0;2020-06-11;-57735
2020-06-10;"Žilinský kraj";0;0;0;0;NA;50565;0;2020-06-10;-57735
2020-06-09;"Žilinský kraj";1;0;0;0;NA;50565;1;2020-06-09;-57735
2020-06-08;"Žilinský kraj";0;0;0;0;NA;50565;0;2020-06-08;-57736
2020-06-07;"Žilinský kraj";0;0;0;0;NA;50565;0;2020-06-07;-57736
2020-06-05;"Žilinský kraj";0;0;0;0;NA;50565;0;2020-06-05;-57736
2020-06-03;"Žilinský kraj";0;0;0;0;NA;50565;0;2020-06-03;-57736
2020-06-02;"Žilinský kraj";0;0;0;0;NA;50565;0;2020-06-02;-57736
2020-05-31;"Žilinský kraj";0;0;0;0;NA;50565;0;2020-05-31;-57736
2020-05-29;"Žilinský kraj";0;0;0;0;NA;50565;0;2020-05-29;-57736
2020-05-27;"Žilinský kraj";1;0;0;0;NA;50565;1;2020-05-27;-57736
2020-05-26;"Žilinský kraj";1;0;0;0;NA;50565;1;2020-05-26;-57737
2020-05-25;"Žilinský kraj";0;0;0;0;NA;50565;0;2020-05-25;-57738
2020-05-24;"Žilinský kraj";0;0;0;0;NA;50565;0;2020-05-24;-57738
2020-05-23;"Žilinský kraj";0;0;0;0;NA;50565;0;2020-05-23;-57738
2020-05-22;"Žilinský kraj";0;0;0;0;NA;50565;0;2020-05-22;-57738
2020-05-21;"Žilinský kraj";0;0;0;0;NA;50565;0;2020-05-21;-57738
2020-05-20;"Žilinský kraj";0;0;0;0;NA;50565;0;2020-05-20;-57738
2020-05-19;"Žilinský kraj";1;0;0;0;NA;50565;1;2020-05-19;-57738
2020-05-17;"Žilinský kraj";0;0;0;0;NA;50565;0;2020-05-17;-57739
2020-05-16;"Žilinský kraj";0;0;0;0;NA;50565;0;2020-05-16;-57739
2020-05-15;"Žilinský kraj";0;0;0;0;NA;50565;0;2020-05-15;-57739
2020-05-14;"Žilinský kraj";0;0;0;0;NA;50565;0;2020-05-14;-57739
2020-05-13;"Žilinský kraj";0;0;0;0;NA;50565;0;2020-05-13;-57739
2020-05-12;"Žilinský kraj";0;0;0;0;NA;50565;0;2020-05-12;-57739
2020-05-11;"Žilinský kraj";0;0;0;0;NA;50565;0;2020-05-11;-57739
2020-05-09;"Žilinský kraj";0;0;0;0;NA;50565;0;2020-05-09;-57739
2020-05-07;"Žilinský kraj";0;0;0;0;NA;50565;0;2020-05-07;-57739
2020-05-06;"Žilinský kraj";2;0;0;0;NA;50565;2;2020-05-06;-57739
2020-05-05;"Žilinský kraj";3;0;0;0;NA;50565;3;2020-05-05;-57741
2020-05-04;"Žilinský kraj";3;0;0;0;NA;50565;3;2020-05-04;-57744
2020-05-03;"Žilinský kraj";1;0;0;0;NA;50565;1;2020-05-03;-57747
2020-05-02;"Žilinský kraj";0;0;0;0;NA;50565;0;2020-05-02;-57748
2020-05-01;"Žilinský kraj";1;0;0;0;NA;50565;1;2020-05-01;-57748
2020-04-30;"Žilinský kraj";0;0;0;0;NA;50565;0;2020-04-30;-57749
2020-04-29;"Žilinský kraj";0;0;0;0;NA;50565;0;2020-04-29;-57749
2020-04-28;"Žilinský kraj";0;0;0;0;NA;50565;0;2020-04-28;-57749
2020-04-27;"Žilinský kraj";0;0;0;0;NA;50565;0;2020-04-27;-57749
2020-04-26;"Žilinský kraj";0;0;0;0;NA;50565;0;2020-04-26;-57749
2020-04-25;"Žilinský kraj";2;0;0;0;NA;50565;2;2020-04-25;-57749
2020-04-24;"Žilinský kraj";1;0;0;0;NA;50565;1;2020-04-24;-57751
2020-04-23;"Žilinský kraj";2;0;0;0;NA;50565;2;2020-04-23;-57752
2020-04-22;"Žilinský kraj";9;0;0;0;NA;50565;9;2020-04-22;-57754
2020-04-21;"Žilinský kraj";1;0;0;0;NA;50565;1;2020-04-21;-57763
2020-04-20;"Žilinský kraj";4;0;0;0;NA;50565;4;2020-04-20;-57764
2020-04-19;"Žilinský kraj";0;0;0;0;NA;50565;0;2020-04-19;-57768
2020-04-18;"Žilinský kraj";49;0;0;0;NA;50565;49;2020-04-18;-57768
2020-04-17;"Žilinský kraj";3;0;0;0;NA;50565;3;2020-04-17;-57817
2020-04-16;"Žilinský kraj";4;0;0;0;NA;50565;4;2020-04-16;-57820
2020-04-15;"Žilinský kraj";7;0;0;0;NA;50565;7;2020-04-15;-57824
2020-04-14;"Žilinský kraj";1;0;0;0;NA;50565;1;2020-04-14;-57831
2020-04-13;"Žilinský kraj";2;0;0;0;NA;50565;2;2020-04-13;-57832
2020-04-12;"Žilinský kraj";5;0;0;0;NA;50565;5;2020-04-12;-57834
2020-04-11;"Žilinský kraj";2;0;0;0;NA;50565;2;2020-04-11;-57839
2020-04-10;"Žilinský kraj";1;0;0;0;NA;50565;1;2020-04-10;-57841
2020-04-09;"Žilinský kraj";1;0;0;0;NA;50565;1;2020-04-09;-57842
2020-04-08;"Žilinský kraj";3;0;0;0;NA;50565;3;2020-04-08;-57843
2020-04-07;"Žilinský kraj";5;0;0;0;NA;50565;5;2020-04-07;-57846
2020-04-06;"Žilinský kraj";6;0;0;0;NA;50565;6;2020-04-06;-57851
2020-04-05;"Žilinský kraj";8;0;0;0;NA;50565;8;2020-04-05;-57857
2020-04-04;"Žilinský kraj";0;0;0;0;NA;50565;0;2020-04-04;-57865
2020-04-03;"Žilinský kraj";3;0;0;0;NA;50565;3;2020-04-03;-57865
2020-04-02;"Žilinský kraj";5;0;0;0;NA;50565;5;2020-04-02;-57868
2020-04-01;"Žilinský kraj";4;0;0;0;NA;50565;4;2020-04-01;-57873
2020-03-31;"Žilinský kraj";1;0;0;0;NA;50565;1;2020-03-31;-57877
2020-03-30;"Žilinský kraj";3;0;0;0;NA;50565;3;2020-03-30;-57878
2020-03-29;"Žilinský kraj";0;0;0;0;NA;50565;0;2020-03-29;-57881
2020-03-28;"Žilinský kraj";1;0;0;0;NA;50565;1;2020-03-28;-57881
2020-03-27;"Žilinský kraj";9;0;0;0;NA;50565;9;2020-03-27;-57882
2020-03-26;"Žilinský kraj";4;0;0;0;NA;50565;4;2020-03-26;-57891
2020-03-25;"Žilinský kraj";1;0;0;0;NA;50565;1;2020-03-25;-57895
2020-03-24;"Žilinský kraj";2;0;0;0;NA;50565;2;2020-03-24;-57896
2020-03-23;"Žilinský kraj";3;0;0;0;NA;50565;3;2020-03-23;-57898
2020-03-22;"Žilinský kraj";1;0;0;0;NA;50565;1;2020-03-22;-57901
2020-03-21;"Žilinský kraj";2;0;0;0;NA;50565;2;2020-03-21;-57902
2020-03-20;"Žilinský kraj";4;0;0;0;NA;50565;4;2020-03-20;-57904
2020-03-19;"Žilinský kraj";2;0;0;0;NA;50565;2;2020-03-19;-57908
2020-03-18;"Žilinský kraj";1;0;0;0;NA;50565;1;2020-03-18;-57910
2020-03-17;"Žilinský kraj";5;0;0;0;NA;50565;5;2020-03-17;-57911
2020-03-16;"Žilinský kraj";1;0;0;0;NA;50565;1;2020-03-16;-57916
2020-03-15;"Žilinský kraj";2;0;0;0;NA;50565;2;2020-03-15;-57917
2020-03-14;"Žilinský kraj";1;0;0;0;NA;50565;1;2020-03-14;-57919
2020-03-13;"Žilinský kraj";5;0;0;0;NA;50565;5;2020-03-13;-57920
2020-03-12;"Žilinský kraj";1;0;0;0;NA;50565;1;2020-03-12;-57925
2020-03-11;"Žilinský kraj";0;0;0;0;NA;50565;0;2020-03-11;-57926
2020-03-09;"Žilinský kraj";1;0;0;0;NA;50565;1;2020-03-09;-57926
2020-03-08;"Žilinský kraj";0;0;0;0;NA;50565;0;2020-03-08;-57927
2020-03-07;"Žilinský kraj";0;0;0;0;NA;50565;0;2020-03-07;-57927
2020-03-06;"Žilinský kraj";0;0;0;0;NA;50565;0;2020-03-06;-57927
